Chromosome,Start,End,Type,Patient_ID,target,AffectedGenes,VariationLength
13,106542688,115109852,dup,SP114986,1,,8567164
8,90067523,90940205,dup,SP114980,1,,872682
13,82892302,94651715,dup,SP114978,1,,11759413
10,116642982,116959246,del,SP114982,1,,316264
1,157319909,157774897,dup,SP114974,1,,454988
8,34710118,37730368,dup,SP114982,1,,3020250
7,47905124,49239135,dup,SP114976,1,,1334011
1,158192133,158641441,dup,SP114986,1,,449308
8,43589137,53341622,dup,SP114982,1,,9752485
6,81007699,82990844,dup,SP114982,1,,1983145
1,158760288,160096358,dup,SP114986,1,,1336070
13,113810014,115109852,dup,SP114974,1,,1299838
7,49265828,49775431,dup,SP114973,1,,509603
5,20399,84228467,dup,SP114978,1,,84208068
12,63674665,129651596,dup,SP114980,1,,65976931
14,38304539,107289436,dup,SP114978,1,,68984897
1,162297946,164071520,dup,SP114980,1,,1773574
3,141772040,142855988,dup,SP114986,1,,1083948
2,187112773,233570204,dup,SP114978,1,,46457431
1,157319909,157774897,dup,SP114980,1,,454988
5,162553690,162788834,dup,SP114984,1,,235144
8,53410451,76054904,dup,SP114971,1,,22644453
6,78042764,79993763,dup,SP114971,1,,1950999
8,53410451,76209733,dup,SP114986,1,,22799282
6,14349627,14637470,dup,SP114986,1,,287843
15,98072046,102444095,dup,SP114978,1,,4372049
15,32899920,95509717,dup,SP114978,1,,62609797
2,8372992,12292046,dup,SP114980,1,,3919054
13,113799385,115109852,dup,SP114976,1,,1310467
7,112906437,153148726,dup,SP114984,1,,40242289
11,100717190,101581636,del,SP114982,1,,864446
9,8092109,9213334,dup,SP114974,1,,1121225
6,78042764,80835919,dup,SP114976,1,,2793155
3,142857875,181057264,dup,SP114986,1,,38199389
1,143491312,157021272,dup,SP114986,1,,13529960
10,12151240,12193066,del,SP114976,1,,41826
1,164004969,166191783,dup,SP114971,1,,2186814
5,162553690,180687907,dup,SP114978,1,,18134217
13,84279610,94652322,dup,SP114974,1,,10372712
10,116962869,118594289,dup,SP114976,1,,1631420
8,85615247,89023357,dup,SP114973,1,,3408110
6,81009736,82990844,dup,SP114980,1,,1981108
13,82892302,84243842,dup,SP114976,1,,1351540
10,44078656,44127840,del,SP114971,1,,49184
1,162294094,163964066,dup,SP114973,1,,1669972
6,32692227,77815912,dup,SP114984,1,,45123685
4,122671315,127181348,dup,SP114973,1,,4510033
8,79412698,85209244,dup,SP114986,1,,5796546
10,68639036,69465551,dup,SP114971,1,,826515
4,104442709,104762313,dup,SP114978,1,,319604
8,37730456,40511828,dup,SP114982,1,,2781372
8,37730456,43742109,dup,SP114984,1,,6011653
2,12442285,13909662,dup,SP114986,1,,1467377
11,51519416,54795000,dup,SP114986,1,,3275584
8,53342616,76054904,dup,SP114973,1,,22712288
7,82771395,85865050,dup,SP114980,1,,3093655
1,176479178,249208772,dup,SP114974,1,,72729594
12,131337793,133832310,dup,SP114982,1,,2494517
16,86120530,86369685,dup,SP114976,1,,249155
2,12499715,13889772,dup,SP114976,1,,1390057
1,176479178,249208772,dup,SP114973,1,,72729594
2,143496442,143612736,del,SP114978,1,,116294
10,129012406,135511765,dup,SP114982,1,,6499359
6,171716,29828660,dup,SP114978,1,,29656944
7,39231219,47819104,dup,SP114980,1,,8587885
7,91398179,153148355,dup,SP114973,1,,61750176
7,153173300,159125187,dup,SP114980,1,,5951887
2,143496985,143625922,del,SP114980,1,,128937
2,12292482,13889772,dup,SP114980,1,,1597290
7,153671147,159125187,dup,SP114984,1,,5454040
7,56842127,76741788,dup,SP114976,1,,19899661
2,82073360,85895338,dup,SP114978,1,,3821978
13,113799385,115109852,dup,SP114980,1,,1310467
3,156266880,161676114,dup,SP114982,1,,5409234
12,131400181,133832310,dup,SP114986,1,,2432129
10,49908784,52234904,dup,SP114978,1,,2326120
8,43597021,53395857,dup,SP114971,1,,9798836
3,181307468,197901564,dup,SP114973,1,,16594096
4,63464367,65877473,dup,SP114978,1,,2413106
8,89334910,91685814,dup,SP114984,1,,2350904
8,76581240,89013301,dup,SP114984,1,,12432061
1,173976989,176475180,dup,SP114976,1,,2498191
7,47905124,49887018,dup,SP114978,1,,1981894
8,83203433,103876183,dup,SP114978,1,,20672750
8,34656690,35473108,dup,SP114978,1,,816418
6,171716,14349114,dup,SP114986,1,,14177398
5,161353854,161480935,del,SP114973,1,,127081
13,94653518,95601516,dup,SP114982,1,,947998
2,143496442,143625922,del,SP114973,1,,129480
13,94653518,95601516,dup,SP114986,1,,947998
7,56842127,153148433,dup,SP114974,1,,96306306
7,56650260,56743520,dup,SP114982,1,,93260
1,145463047,157021272,dup,SP114982,1,,11558225
6,80837239,81007699,del,SP114978,1,,170460
2,20807,8372589,dup,SP114986,1,,8351782
4,60235212,60742971,del,SP114986,1,,507759
13,113799385,115109852,dup,SP114982,1,,1310467
3,61495,62212067,dup,SP114986,1,,62150572
3,173934249,197901564,dup,SP114978,1,,23967315
6,55914451,77819267,dup,SP114978,1,,21904816
2,133912328,134014187,del,SP114986,1,,101859
13,84279610,94401214,dup,SP114976,1,,10121604
12,107864650,129637308,dup,SP114978,1,,21772658
7,153173300,153670760,dup,SP114984,1,,497460
10,55169541,55664601,dup,SP114980,1,,495060
1,145463047,157774897,dup,SP114976,1,,12311850
4,106285876,107104699,dup,SP114976,1,,818823
1,167454312,174293220,dup,SP114986,1,,6838908
2,133907141,133983526,del,SP114971,1,,76385
13,106542688,113562425,dup,SP114982,1,,7019737
6,78042764,78230893,dup,SP114982,1,,188129
13,113799385,115109852,dup,SP114978,1,,1310467
4,106285876,127078301,dup,SP114978,1,,20792425
8,93659288,128372172,dup,SP114974,1,,34712884
8,128373027,129075832,dup,SP114984,1,,702805
1,144954117,157021272,dup,SP114973,1,,12067155
1,160102702,162292586,dup,SP114984,1,,2189884
13,106542688,110840418,dup,SP114980,1,,4297730
3,98126766,141771341,dup,SP114971,1,,43644575
10,49908397,52234904,dup,SP114980,1,,2326507
8,76581240,85208405,dup,SP114982,1,,8627165
17,78685626,81151920,dup,SP114974,1,,2466294
9,9213893,44899374,dup,SP114974,1,,35685481
5,103284917,103809919,dup,SP114980,1,,525002
13,82892302,84243842,dup,SP114980,1,,1351540
10,84133789,106936149,dup,SP114978,1,,22802360
10,77585,11464106,dup,SP114971,1,,11386521
3,161680398,181057264,dup,SP114982,1,,19376866
14,19252199,38103034,dup,SP114971,1,,18850835
1,158192133,158641441,dup,SP114971,1,,449308
1,160122826,162299041,dup,SP114982,1,,2176215
10,111741494,113439126,dup,SP114986,1,,1697632
8,34645694,37730368,dup,SP114986,1,,3084674
6,78042764,80835919,dup,SP114980,1,,2793155
1,162291850,164071520,dup,SP114976,1,,1779670
7,47905124,49239135,dup,SP114973,1,,1334011
7,56842127,76739462,dup,SP114973,1,,19897335
13,82892302,84218130,dup,SP114982,1,,1325828
16,83802,61029772,dup,SP114978,1,,60945970
13,106542688,113568334,dup,SP114973,1,,7025646
1,164080895,166204081,dup,SP114980,1,,2123186
9,48515,141107896,dup,SP114978,1,,141059381
7,50612,32202786,dup,SP114971,1,,32152174
8,37730456,40511481,dup,SP114986,1,,2781025
1,164082478,166201152,dup,SP114974,1,,2118674
8,76580284,79387060,dup,SP114986,1,,2806776
13,106542688,113562425,dup,SP114974,1,,7019737
2,143496442,143627838,del,SP114974,1,,131396
3,156285365,161618924,dup,SP114973,1,,5333559
8,93911445,128372172,dup,SP114980,1,,34460727
5,103284158,104815556,dup,SP114984,1,,1531398
11,100717190,101581636,del,SP114978,1,,864446
1,30545515,31084180,del,SP114976,1,,538665
7,56650191,56743520,dup,SP114980,1,,93329
3,84528626,97267755,dup,SP114978,1,,12739129
12,16419405,17212881,dup,SP114978,1,,793476
13,82892302,84243842,dup,SP114984,1,,1351540
13,113799385,115109852,dup,SP114973,1,,1310467
14,19088927,38103034,dup,SP114986,1,,19014107
13,106542688,110872156,dup,SP114978,1,,4329468
10,52306053,52815684,dup,SP114978,1,,509631
8,85615247,89017568,dup,SP114976,1,,3402321
6,78042764,80835919,dup,SP114978,1,,2793155
9,9214700,38919080,dup,SP114982,1,,29704380
6,32665167,77819267,dup,SP114982,1,,45154100
6,171716,29614627,dup,SP114971,1,,29442911
7,49265828,49775431,dup,SP114974,1,,509603
11,51518624,54795000,dup,SP114984,1,,3276376
8,53342616,76054904,dup,SP114974,1,,22712288
1,160102702,162296956,dup,SP114978,1,,2194254
1,121371233,157021272,dup,SP114978,1,,35650039
2,143501626,143627838,del,SP114976,1,,126212
12,63675857,129637308,dup,SP114982,1,,65961451
7,39231219,47819104,dup,SP114982,1,,8587885
1,160105367,162318989,dup,SP114971,1,,2213622
10,129012406,129546195,dup,SP114980,1,,533789
9,48515,8090631,dup,SP114974,1,,8042116
11,51518677,54795000,dup,SP114974,1,,3276323
9,69558518,141107896,dup,SP114984,1,,71549378
12,131400181,133832310,dup,SP114984,1,,2432129
11,100721462,101583598,del,SP114976,1,,862136
12,18242604,107863775,dup,SP114978,1,,89621171
17,31567287,81151920,dup,SP114978,1,,49584633
9,68790540,141107896,dup,SP114986,1,,72317356
4,30248707,42773137,dup,SP114978,1,,12524430
4,60746759,62076769,dup,SP114978,1,,1330010
12,131400181,133832310,dup,SP114973,1,,2432129
8,129076284,146279735,dup,SP114984,1,,17203451
12,131400181,133832310,dup,SP114976,1,,2432129
9,48515,8090631,dup,SP114982,1,,8042116
1,176473083,249208772,dup,SP114984,1,,72735689
2,133920241,133983526,del,SP114984,1,,63285
8,43226602,50719365,dup,SP114978,1,,7492763
10,110006762,110316985,dup,SP114978,1,,310223
7,39231219,47817879,dup,SP114971,1,,8586660
1,164080895,166201152,dup,SP114984,1,,2120257
9,48515,8090631,dup,SP114980,1,,8042116
9,48515,8090430,dup,SP114976,1,,8041915
5,162553690,162793527,dup,SP114986,1,,239837
13,84279610,94650948,dup,SP114980,1,,10371338
11,100760519,101579761,del,SP114984,1,,819242
12,63675857,107873490,dup,SP114986,1,,44197633
3,61495,82808259,dup,SP114978,1,,82746764
13,85000262,94652322,dup,SP114971,1,,9652060
10,116962869,118594289,dup,SP114978,1,,1631420
10,113625749,114272160,dup,SP114978,1,,646411
2,139230824,139322005,del,SP114980,1,,91181
1,158760288,160121899,dup,SP114982,1,,1361611
13,77103335,79592510,dup,SP114982,1,,2489175
8,89335647,91199515,dup,SP114976,1,,1863868
1,158192133,158641441,dup,SP114984,1,,449308
8,85615247,89013301,dup,SP114974,1,,3398054
5,103284917,104779188,dup,SP114986,1,,1494271
13,84243842,94652322,dup,SP114982,1,,10408480
13,94651715,95605708,dup,SP114980,1,,953993
10,116962869,118594289,dup,SP114973,1,,1631420
8,35490964,37707792,del,SP114978,1,,2216828
9,48515,8090631,dup,SP114973,1,,8042116
7,111675156,112906321,dup,SP114984,1,,1231165
1,166204973,167172438,dup,SP114980,1,,967465
3,161686760,180943426,dup,SP114976,1,,19256666
13,94653518,95605708,dup,SP114984,1,,952190
14,19088927,38103034,dup,SP114984,1,,19014107
6,81009736,82990844,dup,SP114978,1,,1981108
8,37730456,40504267,dup,SP114971,1,,2773811
6,171716,29036303,dup,SP114973,1,,28864587
13,84332401,94651715,dup,SP114973,1,,10319314
2,149896804,152687821,dup,SP114978,1,,2791017
9,9213893,45436789,dup,SP114980,1,,36222896
10,69601378,72683780,dup,SP114971,1,,3082402
12,18249575,63674665,dup,SP114986,1,,45425090
10,52240137,52305082,del,SP114974,1,,64945
6,171716,29837036,dup,SP114982,1,,29665320
3,113974991,150738755,dup,SP114980,1,,36763764
6,171716,29830706,dup,SP114984,1,,29658990
4,169269932,172963342,dup,SP114978,1,,3693410
2,139216869,139325556,del,SP114976,1,,108687
8,93911445,128372172,dup,SP114973,1,,34460727
4,95486990,102966419,dup,SP114978,1,,7479429
7,39231219,47817083,dup,SP114978,1,,8585864
11,186458,50782777,dup,SP114978,1,,50596319
10,118603228,120999638,del,SP114980,1,,2396410
10,62105912,64200828,dup,SP114971,1,,2094916
13,110909089,112681303,dup,SP114978,1,,1772214
2,195365,8369744,dup,SP114973,1,,8174379
21,9491334,48072628,dup,SP114986,1,,38581294
8,162218,7782571,dup,SP114986,1,,7620353
7,47905849,49239135,dup,SP114971,1,,1333286
2,133912328,133984882,del,SP114980,1,,72554
10,11569824,12150872,dup,SP114971,1,,581048
11,100708980,101581636,del,SP114980,1,,872656
11,100708980,101576285,del,SP114974,1,,867305
5,161381278,161480091,del,SP114974,1,,98813
8,85649743,89013301,dup,SP114980,1,,3363558
8,91798663,92634171,dup,SP114971,1,,835508
2,11045277,11401719,dup,SP114974,1,,356442
13,19028335,40616769,dup,SP114984,1,,21588434
2,139215868,139320762,del,SP114986,1,,104894
7,50612,32202786,dup,SP114982,1,,32152174
1,173792910,176476203,dup,SP114982,1,,2683293
10,52306053,54696803,dup,SP114974,1,,2390750
14,19088927,38103034,dup,SP114978,1,,19014107
7,50612,32202786,dup,SP114984,1,,32152174
7,39231219,47817879,dup,SP114973,1,,8586660
2,92074183,103524931,dup,SP114978,1,,11450748
8,129075832,146279735,dup,SP114982,1,,17203903
11,133531628,134944751,dup,SP114978,1,,1413123
4,95486094,102581878,dup,SP114980,1,,7095784
6,81005509,82993680,dup,SP114974,1,,1988171
6,78042764,80835919,dup,SP114974,1,,2793155
1,176477105,249208772,dup,SP114971,1,,72731667
9,46306353,141107896,dup,SP114973,1,,94801543
8,128373027,129074902,dup,SP114980,1,,701875
10,107101519,110316985,dup,SP114976,1,,3215466
13,82892302,84243842,dup,SP114974,1,,1351540
5,104176823,104815556,dup,SP114973,1,,638733
12,9113511,10017519,dup,SP114978,1,,904008
13,95607621,106413398,dup,SP114980,1,,10805777
6,171716,29777911,dup,SP114976,1,,29606195
5,161315769,161480091,del,SP114971,1,,164322
3,113979721,150880908,dup,SP114973,1,,36901187
5,103284917,104815556,dup,SP114974,1,,1530639
8,76581240,81440788,dup,SP114978,1,,4859548
11,51518624,51575951,dup,SP114978,1,,57327
2,8372992,12404708,dup,SP114986,1,,4031716
7,91398179,153147715,dup,SP114982,1,,61749536
6,32762484,77819267,dup,SP114976,1,,45056783
12,63673968,107872729,dup,SP114984,1,,44198761
7,82772101,85865050,dup,SP114976,1,,3092949
9,9214833,46404265,dup,SP114976,1,,37189432
5,162553690,162793527,dup,SP114973,1,,239837
1,158760288,160096358,dup,SP114978,1,,1336070
9,8092109,9213334,dup,SP114980,1,,1121225
17,50814794,54662249,dup,SP114974,1,,3847455
1,158192133,158641441,dup,SP114976,1,,449308
4,65916763,93451160,dup,SP114978,1,,27534397
2,20807,80233129,dup,SP114978,1,,80212322
8,53342616,76054904,dup,SP114982,1,,22712288
1,164080895,173971933,dup,SP114976,1,,9891038
12,131285264,133832310,dup,SP114974,1,,2547046
8,76580284,85209244,dup,SP114980,1,,8628960
7,111168847,111668623,dup,SP114984,1,,499776
17,25270079,27715199,dup,SP114978,1,,2445120
1,158192133,158634421,dup,SP114982,1,,442288
1,167454312,173976989,dup,SP114974,1,,6522677
13,110866738,110900995,del,SP114980,1,,34257
13,113563147,113792390,del,SP114971,1,,229243
1,164004969,166201152,dup,SP114978,1,,2196183
16,86100144,86370720,dup,SP114980,1,,270576
7,153173300,159125187,dup,SP114974,1,,5951887
5,98125372,99631903,del,SP114973,1,,1506531
3,97355029,98126640,dup,SP114971,1,,771611
3,97213487,181054636,dup,SP114984,1,,83841149
8,90067426,91215178,dup,SP114982,1,,1147752
7,56832629,111166165,dup,SP114984,1,,54333536
7,82771395,85865050,dup,SP114973,1,,3093655
2,104583937,125870905,dup,SP114978,1,,21286968
7,86248253,87835469,dup,SP114980,1,,1587216
8,128373027,129074450,dup,SP114974,1,,701423
13,95607621,106413398,dup,SP114978,1,,10805777
7,47905124,51123343,dup,SP114986,1,,3218219
4,179160006,181333249,dup,SP114978,1,,2173243
10,12193644,23339450,dup,SP114971,1,,11145806
8,34774613,37730368,dup,SP114980,1,,2955755
3,98152800,142029919,dup,SP114974,1,,43877119
8,128373027,129074902,dup,SP114978,1,,701875
10,112104180,113439126,dup,SP114978,1,,1334946
13,95607621,115109852,dup,SP114984,1,,19502231
2,20807,8375089,dup,SP114974,1,,8354282
13,77101905,79623711,dup,SP114980,1,,2521806
4,63464367,65878200,dup,SP114973,1,,2413833
4,143353560,168769765,dup,SP114978,1,,25416205
11,100708980,101581636,del,SP114986,1,,872656
4,173527080,173902259,dup,SP114971,1,,375179
11,100708980,101577791,del,SP114973,1,,868811
17,57415920,61334783,dup,SP114974,1,,3918863
7,55698165,56343323,dup,SP114978,1,,645158
11,66090307,97054703,dup,SP114978,1,,30964396
3,181303702,197901564,dup,SP114980,1,,16597862
8,93645091,128372172,dup,SP114982,1,,34727081
10,12194279,43406680,dup,SP114978,1,,31212401
9,8092109,9213893,dup,SP114982,1,,1121784
1,157212792,157774897,dup,SP114978,1,,562105
8,128376801,129074902,dup,SP114976,1,,698101
1,158192133,158641441,dup,SP114980,1,,449308
1,158760288,160095446,dup,SP114980,1,,1335158
7,50612,32202786,dup,SP114978,1,,32152174
10,77585,11464106,dup,SP114978,1,,11386521
10,55164487,83784157,dup,SP114978,1,,28619670
13,112797284,113562425,dup,SP114978,1,,765141
17,35035940,43072907,dup,SP114974,1,,8036967
8,34710118,37730368,dup,SP114976,1,,3020250
1,30545515,31090461,del,SP114973,1,,544946
8,43748619,53393618,dup,SP114984,1,,9644999
1,174306256,176476203,dup,SP114986,1,,2169947
7,56709597,56743520,dup,SP114974,1,,33923
7,108811589,159125187,dup,SP114978,1,,50313598
8,76580284,85209244,dup,SP114971,1,,8628960
10,52306053,54696803,dup,SP114976,1,,2390750
3,150739050,156287185,dup,SP114980,1,,5548135
8,40511828,43523474,dup,SP114986,1,,3011646
7,39231219,47819104,dup,SP114974,1,,8587885
5,103284917,104815556,dup,SP114978,1,,1530639
1,157319909,157774897,dup,SP114973,1,,454988
3,97355029,173919009,dup,SP114978,1,,76563980
8,89334910,90000880,dup,SP114974,1,,665970
8,37730456,40511481,dup,SP114980,1,,2781025
8,53395857,76054904,dup,SP114984,1,,22659047
13,77101905,79599065,dup,SP114971,1,,2497160
16,86120530,86369685,dup,SP114971,1,,249155
9,8092109,9214700,dup,SP114973,1,,1122591
7,153171348,159125187,dup,SP114982,1,,5953839
1,158760288,160102702,dup,SP114974,1,,1342414
3,113978227,150785387,dup,SP114976,1,,36807160
9,46870177,141107896,dup,SP114976,1,,94237719
7,56842127,159125187,dup,SP114986,1,,102283060
4,53428,26649361,dup,SP114978,1,,26595933
13,95605708,106413216,dup,SP114986,1,,10807508
12,131285264,133832310,dup,SP114978,1,,2547046
7,47905849,49239135,dup,SP114982,1,,1333286
1,158192133,158641441,dup,SP114978,1,,449308
3,98259838,113974991,dup,SP114982,1,,15715153
8,43226602,53341622,dup,SP114976,1,,10115020
2,191395,8371950,dup,SP114976,1,,8180555
7,50612,32202786,dup,SP114980,1,,32152174
6,32663289,77819267,dup,SP114980,1,,45155978
7,86248253,87835469,dup,SP114982,1,,1587216
7,50612,32211433,dup,SP114986,1,,32160821
4,103506095,104219336,dup,SP114976,1,,713241
1,162319524,163968414,dup,SP114971,1,,1648890
6,78042764,80835919,dup,SP114973,1,,2793155
3,150737619,156263934,dup,SP114982,1,,5526315
2,12404697,13724098,dup,SP114974,1,,1319401
1,174126742,176472638,dup,SP114984,1,,2345896
1,166204081,167350323,dup,SP114984,1,,1146242
1,166199125,167453875,dup,SP114986,1,,1254750
4,52660488,60181354,dup,SP114978,1,,7520866
8,37966211,43195672,dup,SP114978,1,,5229461
6,78039562,82990844,dup,SP114986,1,,4951282
6,101739478,103798160,dup,SP114971,1,,2058682
12,16419405,17212881,dup,SP114974,1,,793476
10,115628218,116576056,dup,SP114978,1,,947838
13,94652322,95605708,dup,SP114978,1,,953386
13,94653518,95704225,dup,SP114974,1,,1050707
10,107101519,110316985,dup,SP114973,1,,3215466
10,60787802,61387144,dup,SP114971,1,,599342
6,103799161,104357100,dup,SP114971,1,,557939
10,128936884,129007881,del,SP114971,1,,70997
8,93911445,128376732,dup,SP114976,1,,34465287
12,131400181,133832310,dup,SP114971,1,,2432129
22,16051249,51237063,dup,SP114978,1,,35185814
12,16403381,17212881,dup,SP114986,1,,809500
8,81441012,83196116,dup,SP114978,1,,1755104
1,160078891,162292586,dup,SP114973,1,,2213695
8,37730456,43195672,dup,SP114976,1,,5465216
3,150851696,156266880,dup,SP114976,1,,5415184
7,153173300,159125187,dup,SP114973,1,,5951887
10,55677422,56673719,dup,SP114971,1,,996297
13,77101905,79592510,dup,SP114984,1,,2490605
1,176476203,249208772,dup,SP114976,1,,72732569
13,82892302,84293852,dup,SP114973,1,,1401550
3,141771808,142865094,dup,SP114971,1,,1093286
4,103506095,104219336,dup,SP114978,1,,713241
3,98259838,113973702,dup,SP114980,1,,15713864
10,65684472,68637638,dup,SP114971,1,,2953166
2,38547242,39180812,del,SP114976,1,,633570
8,50719957,51291744,dup,SP114978,1,,571787
1,158760288,160102702,dup,SP114976,1,,1342414
6,152610972,152706579,del,SP114986,1,,95607
3,181307468,197901564,dup,SP114971,1,,16594096
3,97213487,98126640,dup,SP114986,1,,913153
1,158192133,158641441,dup,SP114973,1,,449308
10,107101519,110316985,dup,SP114982,1,,3215466
1,174126742,176476203,dup,SP114971,1,,2349461
2,143508243,143624076,del,SP114984,1,,115833
4,106286465,107104699,dup,SP114973,1,,818234
6,78297394,80835919,dup,SP114982,1,,2538525
3,97355029,98257597,dup,SP114982,1,,902568
7,56829511,153148355,dup,SP114971,1,,96318844
8,91798663,92629886,dup,SP114980,1,,831223
16,70884224,71206836,dup,SP114971,1,,322612
1,32650895,121371173,dup,SP114978,1,,88720278
13,19028335,40655549,dup,SP114980,1,,21627214
1,167428380,173963249,dup,SP114978,1,,6534869
1,160096358,162297250,dup,SP114980,1,,2200892
13,19028335,40655549,dup,SP114986,1,,21627214
6,81009736,82990844,dup,SP114973,1,,1981108
7,39231219,47817879,dup,SP114976,1,,8586660
1,145075854,157774897,dup,SP114984,1,,12699043
8,43550968,53341622,dup,SP114974,1,,9790654
2,12442285,13724098,dup,SP114971,1,,1281813
13,19028335,40655549,dup,SP114971,1,,21627214
5,102072591,102085033,del,SP114971,1,,12442
12,63676004,129635711,dup,SP114976,1,,65959707
1,158760288,160078213,dup,SP114973,1,,1317925
7,91398179,153148355,dup,SP114980,1,,61750176
3,142865170,180943426,dup,SP114971,1,,38078256
2,40184602,40531976,dup,SP114976,1,,347374
3,156267292,161685470,dup,SP114976,1,,5418178
9,8090484,9214700,dup,SP114976,1,,1124216
13,110909089,113568334,dup,SP114980,1,,2659245
7,86248253,87835469,dup,SP114976,1,,1587216
10,43464586,44075698,dup,SP114986,1,,611112
2,134027352,139214346,del,SP114986,1,,5186994
4,183220371,184928980,del,SP114984,1,,1708609
1,158781619,160096358,dup,SP114984,1,,1314739
14,19088927,38102131,dup,SP114974,1,,19013204
13,106546094,113568334,dup,SP114976,1,,7022240
13,19028335,40752936,dup,SP114982,1,,21724601
2,80233320,82072446,dup,SP114978,1,,1839126
6,14637685,29823606,dup,SP114986,1,,15185921
1,160105367,162291438,dup,SP114976,1,,2186071
8,89334910,90000880,dup,SP114973,1,,665970
12,9113002,10018338,dup,SP114986,1,,905336
3,181055378,197901564,dup,SP114984,1,,16846186
4,104442709,104762313,dup,SP114973,1,,319604
3,97355029,98257597,dup,SP114980,1,,902568
11,133531628,134944751,dup,SP114986,1,,1413123
8,128373027,129074902,dup,SP114982,1,,701875
8,103876780,128372172,dup,SP114978,1,,24495392
10,114664543,115622375,dup,SP114978,1,,957832
1,163968414,166205504,dup,SP114982,1,,2237090
16,61452616,90168697,dup,SP114978,1,,28716081
13,77101905,79592028,dup,SP114973,1,,2490123
5,162841170,180687907,dup,SP114986,1,,17846737
1,166205728,167251016,dup,SP114982,1,,1045288
7,49265828,49775431,dup,SP114980,1,,509603
7,56832629,57915045,dup,SP114978,1,,1082416
6,98756333,110912864,dup,SP114978,1,,12156531
8,43656825,53341622,dup,SP114980,1,,9684797
7,55035860,55636636,dup,SP114980,1,,600776
16,86100144,86370720,dup,SP114973,1,,270576
14,38304539,107289436,dup,SP114984,1,,68984897
7,56842127,76739462,dup,SP114982,1,,19897335
3,156287414,161686907,dup,SP114980,1,,5399493
6,171716,29530868,dup,SP114980,1,,29359152
5,106125352,159629241,dup,SP114978,1,,53503889
1,173971933,176476203,dup,SP114978,1,,2504270
5,103284917,104815556,dup,SP114971,1,,1530639
8,51291801,53341622,dup,SP114978,1,,2049821
8,76580284,85209244,dup,SP114976,1,,8628960
8,89335647,90000880,dup,SP114980,1,,665233
1,157319909,157774897,dup,SP114971,1,,454988
8,90067426,91062794,dup,SP114971,1,,995368
4,42777142,49311049,dup,SP114978,1,,6533907
1,145215468,157021272,dup,SP114980,1,,11805804
3,142030710,142261997,dup,SP114974,1,,231287
7,49894181,51123343,dup,SP114980,1,,1229162
2,12293125,13709103,dup,SP114973,1,,1415978
3,97355029,98257597,dup,SP114973,1,,902568
21,9491334,48072628,dup,SP114978,1,,38581294
6,114589360,114987040,dup,SP114974,1,,397680
1,166192805,167350323,dup,SP114971,1,,1157518
3,181304172,197901564,dup,SP114986,1,,16597392
8,128373027,129074450,dup,SP114973,1,,701423
1,166204081,167410180,dup,SP114978,1,,1206099
1,176477105,249208772,dup,SP114978,1,,72731667
1,162297946,164064825,dup,SP114986,1,,1766879
2,194039,8371950,dup,SP114982,1,,8177911
8,129075832,146279735,dup,SP114978,1,,17203903
10,64202077,65633214,dup,SP114971,1,,1431137
13,77101905,79592510,dup,SP114974,1,,2490605
13,19028335,40655549,dup,SP114976,1,,21627214
20,61098,62940904,dup,SP114978,1,,62879806
5,161340051,161488748,del,SP114986,1,,148697
8,53342616,76392317,dup,SP114978,1,,23049701
1,162297246,163968414,dup,SP114978,1,,1671168
6,171716,29720997,dup,SP114974,1,,29549281
1,144946768,157021272,dup,SP114971,1,,12074504
11,56065039,66088802,dup,SP114978,1,,10023763
8,129074902,146279735,dup,SP114974,1,,17204833
13,95605708,106416994,dup,SP114976,1,,10811286
4,122671494,127078301,dup,SP114976,1,,4406807
8,91798663,92634171,dup,SP114974,1,,835508
13,95605708,106413398,dup,SP114982,1,,10807690
5,98451375,99514273,del,SP114980,1,,1062898
1,167303588,173791077,dup,SP114982,1,,6487489
13,77095636,79618137,dup,SP114986,1,,2522501
13,19028335,40655549,dup,SP114973,1,,21627214
4,184992969,190939082,dup,SP114978,1,,5946113
16,86120530,86368599,dup,SP114982,1,,248069
10,121052908,135511765,dup,SP114978,1,,14458857
9,45710708,141107896,dup,SP114980,1,,95397188
7,57917636,108804654,dup,SP114978,1,,50887018
13,77101905,79592510,dup,SP114978,1,,2490605
1,163964745,173976989,dup,SP114973,1,,10012244
17,25270079,30924981,dup,SP114974,1,,5654902
8,89335647,90000880,dup,SP114971,1,,665233
8,89335647,90000880,dup,SP114982,1,,665233
9,44907685,141107896,dup,SP114974,1,,96200211
7,50612,32204295,dup,SP114974,1,,32153683
10,52818389,54697623,dup,SP114978,1,,1879234
3,98259838,113978227,dup,SP114973,1,,15718389
6,151778325,151975285,del,SP114986,1,,196960
8,76580284,85209244,dup,SP114974,1,,8628960
13,82892302,84243842,dup,SP114986,1,,1351540
5,98187510,99514273,del,SP114982,1,,1326763
12,107873490,129635711,dup,SP114984,1,,21762221
7,49265828,49775431,dup,SP114982,1,,509603
11,100646982,101583273,del,SP114971,1,,936291
7,91398179,159125187,dup,SP114976,1,,67727008
8,53342616,76055622,dup,SP114980,1,,22713006
8,91804805,128372172,dup,SP114984,1,,36567367
6,77819267,82992460,dup,SP114984,1,,5173193
6,151778442,151975285,del,SP114984,1,,196843
6,81012183,82990844,dup,SP114976,1,,1978661
18,26073,77891346,dup,SP114978,1,,77865273
7,47905124,51123343,dup,SP114984,1,,3218219
3,98210975,113977361,dup,SP114976,1,,15766386
7,50612,32202786,dup,SP114973,1,,32152174
10,11569824,12106850,dup,SP114978,1,,537026
10,43464586,44075698,dup,SP114978,1,,611112
1,166204081,167453875,dup,SP114974,1,,1249794
12,63634929,129637308,dup,SP114973,1,,66002379
12,63673968,129637308,dup,SP114974,1,,65963340
11,50326942,50782777,dup,SP114984,1,,455835
16,86100144,86393677,dup,SP114974,1,,293533
10,12117364,12194279,del,SP114986,1,,76915
6,32756961,77819267,dup,SP114973,1,,45062306
8,34707432,37730368,dup,SP114984,1,,3022936
13,94402110,95601516,dup,SP114976,1,,1199406
13,95706099,106413398,dup,SP114974,1,,10707299
8,34646676,37730368,dup,SP114971,1,,3083692
13,94652322,95607621,dup,SP114973,1,,955299
7,50612,32202786,dup,SP114976,1,,32152174
3,150922638,156278785,dup,SP114973,1,,5356147
1,145215468,157021272,dup,SP114974,1,,11805804
8,93659288,103769678,dup,SP114971,1,,10110390
1,174126742,176476203,dup,SP114980,1,,2349461
7,47905124,49239135,dup,SP114980,1,,1334011
1,174126742,176477105,dup,SP114974,1,,2350363
6,32757080,77819267,dup,SP114986,1,,45062187
3,161688919,180943426,dup,SP114980,1,,19254507
4,103506095,104219336,dup,SP114973,1,,713241
3,113975424,150737510,dup,SP114982,1,,36762086
2,133916496,133984882,del,SP114976,1,,68386
2,12493049,13889772,dup,SP114982,1,,1396723
13,19028335,40861666,dup,SP114974,1,,21833331
4,173527080,173902259,dup,SP114986,1,,375179
8,37730456,43226602,dup,SP114973,1,,5496146
8,90067455,90940205,dup,SP114973,1,,872750
9,8092109,9213334,dup,SP114971,1,,1121225
9,9214833,45710708,dup,SP114973,1,,36495875
7,49265828,49775431,dup,SP114976,1,,509603
2,138165925,138183331,del,SP114982,1,,17406
7,49894181,51123343,dup,SP114978,1,,1229162
13,32802037,40655549,dup,SP114978,1,,7853512
8,43259261,53341622,dup,SP114973,1,,10082361
6,32663688,77820738,dup,SP114974,1,,45157050
1,176477105,249208772,dup,SP114986,1,,72731667
1,176477105,249208772,dup,SP114980,1,,72731667
9,68785102,141107896,dup,SP114971,1,,72322794
12,107876778,129637308,dup,SP114986,1,,21760530
14,38286524,107289436,dup,SP114986,1,,69002912
3,98126766,141771808,dup,SP114986,1,,43645042
8,91804805,92634171,dup,SP114982,1,,829366
2,143496442,143627838,del,SP114982,1,,131396
1,164068786,166198670,dup,SP114986,1,,2129884
3,97355029,98210599,dup,SP114976,1,,855570
13,94653518,95605708,dup,SP114971,1,,952190
2,193882,8372589,dup,SP114980,1,,8178707
1,167173193,173976989,dup,SP114980,1,,6803796
15,20004352,32794053,dup,SP114978,1,,12789701
2,20807,8370841,dup,SP114971,1,,8350034
8,85615247,89017568,dup,SP114971,1,,3402321
2,8372589,12442285,dup,SP114982,1,,4069696
12,9113511,10016906,dup,SP114973,1,,903395
3,97355029,98151882,dup,SP114974,1,,796853
4,173527080,173902259,dup,SP114978,1,,375179
4,181334178,183183955,dup,SP114978,1,,1849777
8,43550968,53395857,dup,SP114986,1,,9844889
8,37711398,37960185,dup,SP114978,1,,248787
12,62132,8675042,dup,SP114978,1,,8612910
10,12106850,12193066,del,SP114973,1,,86216
8,34734455,37730368,dup,SP114974,1,,2995913
10,44137007,49875425,dup,SP114978,1,,5738418
2,143496442,143627061,del,SP114986,1,,130619
7,39297155,47819104,dup,SP114984,1,,8521949
8,34646132,37730368,dup,SP114973,1,,3084236
10,12117364,12194279,del,SP114984,1,,76915
8,91807448,114614730,dup,SP114986,1,,22807282
1,157273165,157779183,dup,SP114982,1,,506018
1,162294094,164071520,dup,SP114984,1,,1777426
2,143513608,143625922,del,SP114971,1,,112314
2,155965861,186712509,dup,SP114978,1,,30746648
1,174126742,176477105,dup,SP114973,1,,2350363
6,32780470,55913867,dup,SP114978,1,,23133397
8,76580284,85208405,dup,SP114973,1,,8628121
12,131291508,133832310,dup,SP114980,1,,2540802
1,176477105,249208772,dup,SP114982,1,,72731667
8,91798663,92370877,dup,SP114976,1,,572214
1,167373146,173976989,dup,SP114984,1,,6603843
3,181307468,197901564,dup,SP114974,1,,16594096
7,82771395,85865050,dup,SP114982,1,,3093655
1,167373146,173976989,dup,SP114971,1,,6603843
1,160105367,162296956,dup,SP114974,1,,2191589
1,162297246,164080895,dup,SP114974,1,,1783649
12,4966214,6061491,dup,SP114976,1,,1095277
3,181307468,197901564,dup,SP114982,1,,16594096
1,157319909,157774897,dup,SP114986,1,,454988
13,19028335,32800315,dup,SP114978,1,,13771980
9,38923974,141107896,dup,SP114982,1,,102183922
7,49265828,49775431,dup,SP114971,1,,509603
4,127717384,143352065,dup,SP114978,1,,15634681
1,160102702,162297250,dup,SP114986,1,,2194548
8,53342616,76055622,dup,SP114976,1,,22713006
7,49883138,51123343,dup,SP114982,1,,1240205
8,90067395,91583023,dup,SP114974,1,,1515628
8,129074902,146279735,dup,SP114973,1,,17204833
13,84279610,94652322,dup,SP114984,1,,10372712
8,89334910,91685814,dup,SP114986,1,,2350904
7,56842127,76739462,dup,SP114980,1,,19897335
8,129075832,146279735,dup,SP114976,1,,17203903
7,39231219,47817879,dup,SP114986,1,,8586660
3,181307468,197901564,dup,SP114976,1,,16594096
13,77101905,79625955,dup,SP114976,1,,2524050
3,142263372,180943426,dup,SP114974,1,,38680054
8,129075832,146279735,dup,SP114980,1,,17203903
7,86248253,87833581,dup,SP114973,1,,1585328
8,85615247,89017568,dup,SP114982,1,,3402321
1,162299197,163967394,dup,SP114982,1,,1668197
16,70884224,71199125,dup,SP114980,1,,314901
10,61387281,62099814,dup,SP114971,1,,712533
6,32809223,77819267,dup,SP114971,1,,45010044
14,38304539,107289436,dup,SP114971,1,,68984897
3,161620009,181011601,dup,SP114973,1,,19391592
13,95609235,106414944,dup,SP114973,1,,10805709
8,85339968,89013301,dup,SP114986,1,,3673333
13,84279610,94652322,dup,SP114986,1,,10372712
7,47905849,49239135,dup,SP114974,1,,1333286
12,63663877,129637308,dup,SP114971,1,,65973431
1,101605838,109943893,dup,SP114994,1,,8338055
18,59561312,60457304,dup,SP114996,1,,895992
21,34447739,34888940,dup,SP114996,1,,441201
5,178424340,179457898,dup,SP114996,1,,1033558
1,21069129,27160602,dup,SP114994,1,,6091473
4,37587504,37909495,dup,SP114987,1,,321991
18,59561312,60457304,dup,SP114994,1,,895992
8,56711267,57731917,dup,SP114987,1,,1020650
12,92261220,93035416,dup,SP114996,1,,774196
9,134317994,135270266,dup,SP114992,1,,952272
5,75606708,76952575,dup,SP114987,1,,1345867
1,63822911,65412940,dup,SP114991,1,,1590029
2,105481485,107730013,dup,SP114994,1,,2248528
10,113897746,115521699,dup,SP114992,1,,1623953
6,116827662,117361095,dup,SP114991,1,,533433
13,26493476,34014176,dup,SP114991,1,,7520700
18,23093219,41843502,dup,SP114992,1,,18750283
2,105490397,107730013,dup,SP114987,1,,2239616
13,51609403,59392773,dup,SP114987,1,,7783370
1,153553555,156557807,dup,SP114991,1,,3004252
2,23368,2998079,dup,SP114994,1,,2974711
18,60460276,72391740,dup,SP114994,1,,11931464
13,35652278,41982160,dup,SP114991,1,,6329882
7,43702835,44268785,dup,SP114987,1,,565950
7,12264687,33818126,dup,SP114996,1,,21553439
16,4830068,5176207,dup,SP114994,1,,346139
6,116831295,117363681,dup,SP114994,1,,532386
2,128980292,130740562,dup,SP114996,1,,1760270
2,3004209,25823613,dup,SP114992,1,,22819404
17,59999805,62017043,dup,SP114994,1,,2017238
8,9398647,9892775,del,SP114991,1,,494128
15,63269036,93246339,dup,SP114996,1,,29977303
15,20001861,23407301,dup,SP114987,1,,3405440
10,30626669,31177181,dup,SP114992,1,,550512
20,61795,7951997,dup,SP114992,1,,7890202
19,32176454,33802790,dup,SP114992,1,,1626336
13,95176364,95288188,del,SP114991,1,,111824
9,43395182,81763913,dup,SP114992,1,,38368731
3,22559801,22609529,del,SP114994,1,,49728
7,55172768,55515871,dup,SP114996,1,,343103
4,64985292,65612060,dup,SP114987,1,,626768
6,8337786,30573842,dup,SP114987,1,,22236056
3,20479637,20768011,del,SP114987,1,,288374
18,60460276,72391740,dup,SP114996,1,,11931464
7,55172768,55516878,dup,SP114991,1,,344110
11,80803005,102268603,dup,SP114992,1,,21465598
2,206543897,233594875,dup,SP114987,1,,27050978
20,29976949,50281290,dup,SP114994,1,,20304341
11,122849816,134946381,dup,SP114991,1,,12096565
4,4379663,4992367,dup,SP114991,1,,612704
19,32176454,33800006,dup,SP114996,1,,1623552
13,19020627,28534003,dup,SP114994,1,,9513376
17,30820506,31526044,dup,SP114992,1,,705538
10,15339390,18718585,dup,SP114987,1,,3379195
18,59561312,60457304,dup,SP114991,1,,895992
13,26494995,34044395,dup,SP114996,1,,7549400
5,75601181,76952575,dup,SP114994,1,,1351394
17,62017421,68247566,dup,SP114994,1,,6230145
1,21069129,22312850,dup,SP114991,1,,1243721
12,104437802,107896470,dup,SP114991,1,,3458668
1,13166205,21067095,dup,SP114992,1,,7900890
18,56828678,59559215,dup,SP114996,1,,2730537
18,56003763,56829493,dup,SP114987,1,,825730
7,74548647,76074342,dup,SP114996,1,,1525695
6,17811185,18084765,dup,SP114996,1,,273580
19,50588975,51413906,dup,SP114991,1,,824931
5,18256542,19837018,dup,SP114992,1,,1580476
12,65081495,65641985,dup,SP114996,1,,560490
6,18083552,30569489,dup,SP114991,1,,12485937
4,4379663,4994802,dup,SP114992,1,,615139
14,88429033,88498122,dup,SP114996,1,,69089
17,45870129,46156072,dup,SP114987,1,,285943
12,63722899,92261220,dup,SP114994,1,,28538321
5,146971585,158031593,dup,SP114996,1,,11060008
1,101605838,109944078,dup,SP114996,1,,8338240
12,104437802,107896470,dup,SP114994,1,,3458668
4,91574376,91586793,del,SP114994,1,,12417
13,95171411,95288608,del,SP114992,1,,117197
5,174663244,175326910,dup,SP114991,1,,663666
1,101605838,109944078,dup,SP114991,1,,8338240
14,106314912,107283598,dup,SP114987,1,,968686
2,189981212,202500116,dup,SP114996,1,,12518904
12,123254538,123595755,dup,SP114994,1,,341217
10,30624741,31177181,dup,SP114987,1,,552440
5,159622419,173570153,dup,SP114987,1,,13947734
8,120540876,127501076,dup,SP114992,1,,6960200
11,126320244,134946381,dup,SP114992,1,,8626137
17,62038496,68257738,dup,SP114991,1,,6219242
5,158107640,159621856,dup,SP114996,1,,1514216
10,1424938,1505573,dup,SP114996,1,,80635
7,9431031,25671576,dup,SP114994,1,,16240545
3,172202410,185624052,dup,SP114987,1,,13421642
7,75048320,76024085,dup,SP114991,1,,975765
13,35652278,41982160,dup,SP114992,1,,6329882
1,65835911,77736974,dup,SP114991,1,,11901063
10,30626669,31177181,dup,SP114996,1,,550512
15,55983787,57084365,dup,SP114994,1,,1100578
16,84170,1200232,dup,SP114987,1,,1116062
12,97731047,98683920,dup,SP114987,1,,952873
12,61014136,63721643,dup,SP114994,1,,2707507
1,153555418,155009871,dup,SP114994,1,,1454453
5,178411875,179457898,dup,SP114994,1,,1046023
1,153498976,155009871,dup,SP114992,1,,1510895
5,18256542,19870712,dup,SP114991,1,,1614170
5,70907230,71324075,dup,SP114994,1,,416845
1,22452714,27160602,dup,SP114991,1,,4707888
3,22559975,22610981,del,SP114996,1,,51006
10,113888821,115522585,dup,SP114994,1,,1633764
10,49728916,99419535,dup,SP114996,1,,49690619
22,24192081,25660704,del,SP114992,1,,1468623
3,22559801,22610981,del,SP114987,1,,51180
1,13143375,21067095,dup,SP114991,1,,7923720
12,61014136,63610295,dup,SP114996,1,,2596159
8,66954615,67870285,dup,SP114987,1,,915670
17,70581716,71233631,dup,SP114991,1,,651915
18,42320227,56001540,dup,SP114987,1,,13681313
10,30626669,31177181,dup,SP114994,1,,550512
6,116829323,117360737,dup,SP114987,1,,531414
1,184191716,184342912,dup,SP114991,1,,151196
13,95171411,95290212,del,SP114994,1,,118801
6,17798227,18082286,dup,SP114991,1,,284059
2,23368,3004209,dup,SP114996,1,,2980841
8,121241923,127571356,dup,SP114994,1,,6329433
14,88429033,88507661,dup,SP114994,1,,78628
10,59611428,73447555,dup,SP114987,1,,13836127
12,61014136,63610295,dup,SP114992,1,,2596159
21,45166979,45746337,dup,SP114991,1,,579358
5,158143296,159621856,dup,SP114987,1,,1478560
8,128437055,129089886,dup,SP114992,1,,652831
1,65415568,65830905,dup,SP114987,1,,415337
1,13127041,21067095,dup,SP114987,1,,7940054
1,55792728,56048802,dup,SP114987,1,,256074
11,122849816,123783226,dup,SP114992,1,,933410
9,93655385,95329655,dup,SP114996,1,,1674270
19,32153007,33800006,dup,SP114987,1,,1646999
5,6658003,7414438,dup,SP114996,1,,756435
11,58041208,59127306,dup,SP114987,1,,1086098
14,88428283,88498122,dup,SP114991,1,,69839
11,77613200,109339502,dup,SP114987,1,,31726302
18,60460995,72391740,dup,SP114992,1,,11930745
1,58880101,59784403,dup,SP114987,1,,904302
11,123783842,126320243,dup,SP114992,1,,2536401
1,56049035,56185826,dup,SP114991,1,,136791
3,122258056,123263241,dup,SP114996,1,,1005185
1,940005,13792656,dup,SP114994,1,,12852651
17,62041317,68257940,dup,SP114987,1,,6216623
1,58880496,59784403,dup,SP114996,1,,903907
8,56711267,57732311,dup,SP114996,1,,1021044
2,131154309,165744212,dup,SP114991,1,,34589903
2,23368,2998079,dup,SP114992,1,,2974711
19,47481682,48208155,dup,SP114987,1,,726473
4,3888924,4378347,dup,SP114994,1,,489423
2,138603291,139816820,dup,SP114987,1,,1213529
2,131455960,165984972,dup,SP114992,1,,34529012
12,63611353,92239253,dup,SP114991,1,,28627900
9,134317994,135270266,dup,SP114994,1,,952272
2,23368,3007395,dup,SP114991,1,,2984027
1,246392603,246691356,dup,SP114994,1,,298753
12,63611353,92299169,dup,SP114992,1,,28687816
17,70589244,71281352,dup,SP114987,1,,692108
1,101605838,109944078,dup,SP114992,1,,8338240
7,9431031,35503696,dup,SP114987,1,,26072665
5,18256278,19837018,dup,SP114994,1,,1580740
5,58297891,58626985,dup,SP114991,1,,329094
1,58880496,59784403,dup,SP114991,1,,903907
19,48467571,50359987,dup,SP114994,1,,1892416
1,55764564,56049035,dup,SP114996,1,,284471
12,92300531,93121738,dup,SP114992,1,,821207
10,27987273,28451524,dup,SP114994,1,,464251
13,19020627,26493476,dup,SP114996,1,,7472849
21,45169005,45848592,dup,SP114994,1,,679587
12,104437802,107896470,dup,SP114996,1,,3458668
8,68697834,106433123,dup,SP114987,1,,37735289
2,128290114,128971149,dup,SP114991,1,,681035
11,81451182,82206998,dup,SP114994,1,,755816
5,6657494,7492324,dup,SP114992,1,,834830
5,20615,1667704,dup,SP114992,1,,1647089
8,9398365,9892568,del,SP114987,1,,494203
8,68697834,106433123,dup,SP114994,1,,37735289
4,54169515,55037275,dup,SP114996,1,,867760
8,25318838,27308538,del,SP114987,1,,1989700
2,189981212,202500116,dup,SP114994,1,,12518904
5,19870712,58225899,dup,SP114987,1,,38355187
11,74905915,77613200,dup,SP114992,1,,2707285
19,47481682,48208155,dup,SP114991,1,,726473
7,35411,8790549,dup,SP114987,1,,8755138
21,34453191,34888940,dup,SP114991,1,,435749
1,22315738,22451845,dup,SP114991,1,,136107
4,101261,3888782,dup,SP114994,1,,3787521
18,42320227,56001540,dup,SP114991,1,,13681313
18,9918025,10262467,dup,SP114987,1,,344442
10,15339390,18878392,dup,SP114994,1,,3539002
17,40160742,42339672,del,SP114987,1,,2178930
12,92263602,93129267,dup,SP114994,1,,865665
18,42320227,56001540,dup,SP114992,1,,13681313
5,159622419,173570153,dup,SP114996,1,,13947734
2,167014828,174810893,dup,SP114991,1,,7796065
1,55792728,56048802,dup,SP114994,1,,256074
11,176444,2124269,dup,SP114991,1,,1947825
7,33819128,35503201,dup,SP114996,1,,1684073
18,59565054,60460276,dup,SP114992,1,,895222
19,47475838,48467484,dup,SP114996,1,,991646
1,153478054,155031376,dup,SP114987,1,,1553322
13,19020627,34014176,dup,SP114992,1,,14993549
9,117121050,117497141,dup,SP114992,1,,376091
6,123346919,123676397,dup,SP114987,1,,329478
9,90949981,110215366,dup,SP114992,1,,19265385
12,92241372,93035416,dup,SP114991,1,,794044
3,140109385,140453817,dup,SP114987,1,,344432
6,30573842,32598423,dup,SP114991,1,,2024581
15,35245178,48692612,dup,SP114996,1,,13447434
9,42204111,68324382,dup,SP114996,1,,26120271
12,63611353,92299169,dup,SP114987,1,,28687816
21,45169005,45724054,dup,SP114992,1,,555049
18,56003763,56795387,dup,SP114996,1,,791624
18,56828678,59559215,dup,SP114991,1,,2730537
18,23090640,41843502,dup,SP114991,1,,18752862
3,22559975,22610981,del,SP114991,1,,51006
3,22559801,22610981,del,SP114992,1,,51180
20,61795,7953248,dup,SP114996,1,,7891453
11,22387745,22712403,dup,SP114994,1,,324658
1,65415568,65830905,dup,SP114994,1,,415337
1,13703096,21067095,dup,SP114996,1,,7363999
1,55792728,56048802,dup,SP114991,1,,256074
5,147078638,158140969,dup,SP114994,1,,11062331
2,167086414,174810893,dup,SP114996,1,,7724479
17,60006022,62039355,dup,SP114987,1,,2033333
16,31014247,31673384,del,SP114987,1,,659137
15,93246339,93545934,dup,SP114991,1,,299595
18,60460276,72391740,dup,SP114991,1,,11931464
11,74905915,77613200,dup,SP114994,1,,2707285
3,20479637,20768011,del,SP114996,1,,288374
2,105490397,107730013,dup,SP114996,1,,2239616
18,23093219,41843502,dup,SP114987,1,,18750283
9,93567572,95329655,dup,SP114991,1,,1762083
5,159623784,173570847,dup,SP114991,1,,13947063
18,42320227,56001540,dup,SP114996,1,,13681313
5,146936661,158142399,dup,SP114987,1,,11205738
5,75568053,76952575,dup,SP114996,1,,1384522
15,20001861,23455652,dup,SP114994,1,,3453791
14,61630434,62435628,dup,SP114991,1,,805194
10,15339390,18614622,dup,SP114992,1,,3275232
5,174658209,175326910,dup,SP114996,1,,668701
1,58880101,59784403,dup,SP114994,1,,904302
7,25673018,35502371,dup,SP114994,1,,9829353
15,55983787,57100213,dup,SP114987,1,,1116426
5,20615,1769328,dup,SP114994,1,,1748713
5,174663604,175326910,dup,SP114987,1,,663306
7,118394107,121256765,dup,SP114987,1,,2862658
1,58880101,59784403,dup,SP114992,1,,904302
8,68697834,106433123,dup,SP114991,1,,37735289
8,25318639,27337896,del,SP114992,1,,2019257
2,130859144,165755832,dup,SP114996,1,,34896688
2,165996107,167010625,dup,SP114987,1,,1014518
7,118396313,121249593,dup,SP114991,1,,2853280
8,56711267,57732311,dup,SP114991,1,,1021044
7,88055441,90640150,dup,SP114992,1,,2584709
8,25363864,27338135,del,SP114996,1,,1974271
5,158141955,159621856,dup,SP114994,1,,1479901
20,61795,7953248,dup,SP114991,1,,7891453
2,165752007,167011418,dup,SP114991,1,,1259411
15,93246730,93528053,dup,SP114996,1,,281323
18,42320227,56001540,dup,SP114994,1,,13681313
11,58041208,59127306,dup,SP114991,1,,1086098
2,167011418,174810893,dup,SP114987,1,,7799475
8,66946079,67870285,dup,SP114992,1,,924206
12,126944634,126944945,dup,SP114987,1,,311
13,51609403,59392773,dup,SP114994,1,,7783370
10,99416303,121191186,del,SP114987,1,,21774883
1,63910657,65412940,dup,SP114996,1,,1502283
17,70589244,71288029,dup,SP114996,1,,698785
8,68697834,106433123,dup,SP114992,1,,37735289
7,8790549,9431848,dup,SP114992,1,,641299
11,58042402,59127306,dup,SP114992,1,,1084904
18,56828678,59564053,dup,SP114992,1,,2735375
1,62485147,63553899,dup,SP114996,1,,1068752
8,129090402,146282516,dup,SP114992,1,,17192114
1,235627429,246391017,dup,SP114987,1,,10763588
1,65415568,65830905,dup,SP114992,1,,415337
3,172202410,185659252,dup,SP114994,1,,13456842
1,246691356,249239130,dup,SP114991,1,,2547774
8,56711267,57732311,dup,SP114994,1,,1021044
20,61795,7953248,dup,SP114987,1,,7891453
1,246691606,249239130,dup,SP114987,1,,2547524
19,47475838,48467484,dup,SP114992,1,,991646
17,62039355,68257738,dup,SP114992,1,,6218383
13,19020627,26493312,dup,SP114991,1,,7472685
1,13793020,21067095,dup,SP114994,1,,7274075
5,178413816,179456155,dup,SP114991,1,,1042339
16,58837136,68714456,dup,SP114992,1,,9877320
19,41167251,44168281,del,SP114991,1,,3001030
9,93658854,94987686,dup,SP114987,1,,1328832
1,63852559,65412940,dup,SP114987,1,,1560381
19,47543998,48467484,dup,SP114994,1,,923486
1,62485450,63553899,dup,SP114987,1,,1068449
1,59785769,61308100,dup,SP114996,1,,1522331
6,8338278,23052593,dup,SP114992,1,,14714315
7,43703597,44268785,dup,SP114991,1,,565188
5,179458009,180719407,dup,SP114996,1,,1261398
4,168551309,174745607,dup,SP114992,1,,6194298
5,6658003,7414438,dup,SP114994,1,,756435
8,120549981,120913535,dup,SP114987,1,,363554
19,50360823,51463240,dup,SP114994,1,,1102417
12,65642763,92241372,dup,SP114996,1,,26598609
2,189981212,202500116,dup,SP114992,1,,12518904
1,55792728,56229451,dup,SP114992,1,,436723
2,128259423,128972206,dup,SP114992,1,,712783
1,4002498,13048633,dup,SP114987,1,,9046135
10,49752146,99419535,dup,SP114994,1,,49667389
9,134317994,135270266,dup,SP114987,1,,952272
2,131070539,165991766,dup,SP114994,1,,34921227
8,66954615,67870285,dup,SP114994,1,,915670
8,127574322,129089886,dup,SP114994,1,,1515564
14,61630434,62438612,dup,SP114996,1,,808178
5,158107640,159622546,dup,SP114991,1,,1514906
8,56711267,57750193,dup,SP114992,1,,1038926
18,41867582,42317790,dup,SP114987,1,,450208
2,165761803,167077137,dup,SP114996,1,,1315334
6,8337786,17796620,dup,SP114991,1,,9458834
9,79814137,81763913,dup,SP114987,1,,1949776
11,74993593,77613200,dup,SP114996,1,,2619607
5,147078638,158031593,dup,SP114991,1,,10952955
11,75000189,77610834,dup,SP114987,1,,2610645
19,32142837,33802790,dup,SP114994,1,,1659953
15,20001861,23701726,dup,SP114991,1,,3699865
9,134316279,135278468,dup,SP114991,1,,962189
1,184192828,184342912,dup,SP114992,1,,150084
7,118396313,121256765,dup,SP114994,1,,2860452
15,80597116,102467500,dup,SP114987,1,,21870384
17,70590522,71226761,dup,SP114994,1,,636239
14,88429304,88498122,dup,SP114992,1,,68818
8,68697834,106433123,dup,SP114996,1,,37735289
17,62039355,68256295,dup,SP114996,1,,6216940
1,56186190,58880101,dup,SP114991,1,,2693911
3,20479637,20768011,del,SP114992,1,,288374
10,73451376,75747319,dup,SP114987,1,,2295943
7,43703298,44222220,dup,SP114996,1,,518922
15,35270098,48692612,dup,SP114991,1,,13422514
13,35652278,41982160,dup,SP114987,1,,6329882
3,20479637,20768011,del,SP114994,1,,288374
17,70589244,71284412,dup,SP114992,1,,695168
14,88429033,88498122,dup,SP114987,1,,69089
8,120915162,121240646,dup,SP114987,1,,325484
19,41292676,44169738,del,SP114987,1,,2877062
21,45166979,45829778,dup,SP114987,1,,662799
8,127581487,129090402,dup,SP114987,1,,1508915
2,109156275,110806589,dup,SP114987,1,,1650314
2,189981212,202500116,dup,SP114991,1,,12518904
3,122262599,123380781,dup,SP114992,1,,1118182
13,51609403,59392773,dup,SP114996,1,,7783370
3,172202410,185612212,dup,SP114991,1,,13409802
8,120913535,121240646,dup,SP114994,1,,327111
4,65051919,65609863,dup,SP114991,1,,557944
11,82212679,102713046,dup,SP114994,1,,20500367
11,102713465,103485480,dup,SP114994,1,,772015
15,63269036,93246233,dup,SP114991,1,,29977197
7,8793212,9430193,dup,SP114991,1,,636981
15,20001861,23407301,dup,SP114992,1,,3405440
11,122849816,134946381,dup,SP114987,1,,12096565
17,55920723,59993746,dup,SP114991,1,,4073023
2,206543897,233599904,dup,SP114996,1,,27056007
9,117121050,117497141,dup,SP114994,1,,376091
14,106314680,107283598,dup,SP114996,1,,968918
10,30626669,31177181,dup,SP114991,1,,550512
10,15339390,17659131,dup,SP114996,1,,2319741
7,118396313,121256765,dup,SP114996,1,,2860452
4,54352768,55036053,dup,SP114987,1,,683285
8,66954615,67870285,dup,SP114996,1,,915670
1,65835911,77736974,dup,SP114987,1,,11901063
11,74905915,77610834,dup,SP114991,1,,2704919
7,43703597,44439595,dup,SP114994,1,,735998
2,206543897,233594875,dup,SP114992,1,,27050978
9,139776615,141107896,del,SP114987,1,,1331281
1,246391192,246691356,dup,SP114987,1,,300164
15,93546642,102467500,dup,SP114991,1,,8920858
5,159622419,173570153,dup,SP114994,1,,13947734
5,75601181,76952575,dup,SP114991,1,,1351394
6,65097595,66532513,dup,SP114991,1,,1434918
20,9112925,9539197,dup,SP114994,1,,426272
16,84170,1143428,dup,SP114994,1,,1059258
1,59785769,61308100,dup,SP114987,1,,1522331
3,118849233,119577868,dup,SP114992,1,,728635
1,65415568,65830905,dup,SP114996,1,,415337
6,30591014,32590990,dup,SP114994,1,,1999976
1,184191716,184342912,dup,SP114987,1,,151196
19,41167251,44168281,del,SP114992,1,,3001030
3,130722203,151842405,dup,SP114992,1,,21120202
5,20615,1664326,dup,SP114991,1,,1643711
2,206543897,233597965,dup,SP114991,1,,27054068
15,20001861,23459415,dup,SP114996,1,,3457554
7,118396313,121256765,dup,SP114992,1,,2860452
12,92300531,93035416,dup,SP114987,1,,734885
5,20615,1769025,dup,SP114996,1,,1748410
18,56828678,59559215,dup,SP114994,1,,2730537
2,167019091,174810893,dup,SP114994,1,,7791802
10,49752146,99351793,dup,SP114991,1,,49599647
10,15339390,18718585,dup,SP114991,1,,3379195
22,24192081,25660704,del,SP114987,1,,1468623
9,43394517,68298790,dup,SP114991,1,,24904273
8,129090402,146282516,dup,SP114994,1,,17192114
6,23092193,30569489,dup,SP114992,1,,7477296
17,55929337,59998734,dup,SP114994,1,,4069397
6,65241867,66520016,dup,SP114996,1,,1278149
8,127571356,128436061,dup,SP114992,1,,864705
3,20486013,20768011,del,SP114991,1,,281998
7,35411,8771302,dup,SP114996,1,,8735891
8,66954615,67870285,dup,SP114991,1,,915670
17,60024391,62038496,dup,SP114996,1,,2014105
1,21069129,27160602,dup,SP114987,1,,6091473
19,50358133,51449791,dup,SP114992,1,,1091658
2,139817085,165991766,dup,SP114987,1,,26174681
17,55925569,60039995,dup,SP114992,1,,4114426
14,106315353,107283598,dup,SP114991,1,,968245
1,56185826,58879823,dup,SP114994,1,,2693997
4,54183732,55036524,dup,SP114991,1,,852792
12,104432457,107896470,dup,SP114987,1,,3464013
9,93658854,94927892,dup,SP114994,1,,1269038
12,61014136,63610295,dup,SP114987,1,,2596159
10,77582,1423905,dup,SP114996,1,,1346323
2,165991766,167026920,dup,SP114992,1,,1035154
11,77659983,81449998,dup,SP114994,1,,3790015
3,122259640,123287806,dup,SP114987,1,,1028166
5,178370088,179456155,dup,SP114987,1,,1086067
3,122259606,123196819,dup,SP114991,1,,937213
11,114456604,114977051,del,SP114992,1,,520447
7,8771792,9430193,dup,SP114996,1,,658401
1,59785769,61308100,dup,SP114992,1,,1522331
11,122845360,134946381,dup,SP114996,1,,12101021
8,37568219,50197216,dup,SP114992,1,,12628997
2,105490397,107736114,dup,SP114991,1,,2245717
13,19020627,34014176,dup,SP114987,1,,14993549
1,65835911,77736974,dup,SP114992,1,,11901063
1,62485147,63553899,dup,SP114992,1,,1068752
13,95171411,95294193,del,SP114987,1,,122782
2,23368,2998079,dup,SP114987,1,,2974711
1,56051105,56183163,dup,SP114996,1,,132058
1,21069129,27160602,dup,SP114996,1,,6091473
2,3004209,25807011,dup,SP114994,1,,22802802
3,172201427,185642976,dup,SP114996,1,,13441549
5,58297891,58650003,dup,SP114996,1,,352112
11,102269679,109386672,dup,SP114992,1,,7116993
12,63611353,64993250,dup,SP114996,1,,1381897
11,176444,2116776,dup,SP114996,1,,1940332
7,35411,8790549,dup,SP114991,1,,8755138
7,35411,8786057,dup,SP114992,1,,8750646
17,55923480,59999805,dup,SP114987,1,,4076325
2,25821689,32713170,dup,SP114994,1,,6891481
15,93528476,102467500,dup,SP114996,1,,8939024
12,8866306,8947153,del,SP114987,1,,80847
18,41867582,42317790,dup,SP114994,1,,450208
5,6654416,7414438,dup,SP114987,1,,760022
18,59561312,60457304,dup,SP114987,1,,895992
18,56003763,56795387,dup,SP114994,1,,791624
19,32153007,33800006,dup,SP114991,1,,1646999
8,129090555,132323229,dup,SP114987,1,,3232674
5,6658003,7411383,dup,SP114991,1,,753380
14,106314912,107283598,dup,SP114992,1,,968686
2,128256887,128972206,dup,SP114987,1,,715319
18,41867582,42317790,dup,SP114991,1,,450208
1,246691606,249239130,dup,SP114994,1,,2547524
7,8786057,9430193,dup,SP114994,1,,644136
6,116829323,117361095,dup,SP114992,1,,531772
18,41867582,42317790,dup,SP114992,1,,450208
17,55929070,60015103,dup,SP114996,1,,4086033
1,219400703,235626696,dup,SP114987,1,,16225993
7,9432442,35502371,dup,SP114992,1,,26069929
1,56231008,58879823,dup,SP114992,1,,2648815
2,109156275,110524226,dup,SP114992,1,,1367951
13,28546766,34014176,dup,SP114994,1,,5467410
7,35411,8784440,dup,SP114994,1,,8749029
13,35661836,41982160,dup,SP114994,1,,6320324
5,58226915,58626985,dup,SP114987,1,,400070
6,18084919,30573842,dup,SP114996,1,,12488923
2,109156275,110806589,dup,SP114994,1,,1650314
18,56829590,59559215,dup,SP114987,1,,2729625
13,51600463,59392773,dup,SP114991,1,,7792310
2,131152105,138601036,dup,SP114987,1,,7448931
4,54352768,55036524,dup,SP114992,1,,683756
19,50368361,51451087,dup,SP114987,1,,1082726
14,106315353,107283598,dup,SP114994,1,,968245
16,70087637,70658252,dup,SP114994,1,,570615
18,60460276,72391740,dup,SP114987,1,,11931464
12,61012098,63610295,dup,SP114991,1,,2598197
7,8793212,9430193,dup,SP114987,1,,636981
12,8850066,8947476,del,SP114996,1,,97410
1,101605838,109944078,dup,SP114987,1,,8338240
6,8337786,17809997,dup,SP114996,1,,9472211
1,56185826,58880101,dup,SP114996,1,,2694275
4,4378652,4994802,dup,SP114994,1,,616150
8,120540876,120911357,dup,SP114994,1,,370481
1,184191716,184342912,dup,SP114996,1,,151196
16,84170,1138795,dup,SP114992,1,,1054625
1,22312826,27160602,dup,SP114992,1,,4847776
2,3007972,25821689,dup,SP114991,1,,22813717
21,45166979,45849135,dup,SP114996,1,,682156
18,41867582,42317790,dup,SP114996,1,,450208
1,940005,13385686,dup,SP114996,1,,12445681
2,189981212,202500116,dup,SP114987,1,,12518904
10,49728916,57682184,dup,SP114987,1,,7953268
2,167028149,174810893,dup,SP114992,1,,7782744
4,4378652,4997646,dup,SP114987,1,,618994
3,122259606,123357903,dup,SP114994,1,,1098297
5,18256278,19837018,dup,SP114987,1,,1580740
4,64715542,65609863,dup,SP114992,1,,894321
2,109156275,110495091,dup,SP114996,1,,1338816
10,113730427,115522585,dup,SP114991,1,,1792158
2,128201713,128972206,dup,SP114996,1,,770493
9,43395928,68510113,dup,SP114994,1,,25114185
5,18256542,19837018,dup,SP114996,1,,1580476
1,184191716,184343740,dup,SP114994,1,,152024
2,165996107,167016281,dup,SP114994,1,,1020174
10,115522585,120808619,dup,SP114992,1,,5286034
13,95173327,95290178,del,SP114996,1,,116851
1,56049035,56183163,dup,SP114987,1,,134128
2,109156275,110806589,dup,SP114991,1,,1650314
18,23093219,41843502,dup,SP114996,1,,18750283
1,65835911,77736974,dup,SP114996,1,,11901063
3,172199771,185645868,dup,SP114992,1,,13446097
1,56049035,56183163,dup,SP114994,1,,134128
1,153553555,156473935,dup,SP114996,1,,2920380
1,59785769,61308100,dup,SP114994,1,,1522331
11,77659983,80800343,dup,SP114992,1,,3140360
8,9398365,9892775,del,SP114994,1,,494410
1,246691606,249239130,dup,SP114996,1,,2547524
8,25318639,27335898,del,SP114991,1,,2017259
2,3004998,25807011,dup,SP114996,1,,22802013
5,174663604,175429862,dup,SP114994,1,,766258
2,128295319,128980292,dup,SP114994,1,,684973
11,58040621,59127306,dup,SP114994,1,,1086685
8,9398365,9892775,del,SP114992,1,,494410
2,105490397,107730013,dup,SP114992,1,,2239616
7,43703298,44268785,dup,SP114992,1,,565487
1,63910657,65412940,dup,SP114994,1,,1502283
8,9400496,9892775,del,SP114996,1,,492279
11,77613200,109339502,dup,SP114991,1,,31726302
7,151298246,159122659,del,SP114987,1,,7824413
18,23093219,41843502,dup,SP114994,1,,18750283
4,4378347,4994802,dup,SP114996,1,,616455
8,25318838,27338135,del,SP114994,1,,2019297
17,60040233,62038496,dup,SP114992,1,,1998263
11,103485646,109339502,dup,SP114994,1,,5853856
6,8350331,30573842,dup,SP114994,1,,22223511
16,2267877,31009588,dup,SP114991,1,,28741711
20,61795,7953248,dup,SP114994,1,,7891453
10,113899998,115522585,dup,SP114996,1,,1622587
10,115523236,120808619,dup,SP114994,1,,5285383
4,54352768,55036524,dup,SP114994,1,,683756
11,77659983,109386672,dup,SP114996,1,,31726689
1,59785769,61308100,dup,SP114991,1,,1522331
18,56003763,56795387,dup,SP114992,1,,791624
11,58038233,59127306,dup,SP114996,1,,1089073
18,56003763,56795387,dup,SP114991,1,,791624
19,50358133,51449664,dup,SP114996,1,,1091531
8,121241923,127580690,dup,SP114987,1,,6338767
1,236173381,249239130,dup,SP114992,1,,13065749
10,49727562,99416303,dup,SP114992,1,,49688741
1,62485147,63553899,dup,SP114994,1,,1068752
10,75750764,87673238,dup,SP114987,1,,11922474
7,9431031,35503201,dup,SP114991,1,,26072170
1,65415568,65830905,dup,SP114991,1,,415337
1,56185826,58879823,dup,SP114987,1,,2693997
7,9431031,12252083,dup,SP114996,1,,2821052
9,134317994,135270266,dup,SP114996,1,,952272
6,116829323,117363025,dup,SP114996,1,,533702
1,246391192,246691356,dup,SP114996,1,,300164
13,51609403,59392773,dup,SP114992,1,,7783370
1,63910657,65412940,dup,SP114992,1,,1502283
11,122845129,134946381,dup,SP114994,1,,12101252
10,57722398,59603470,dup,SP114987,1,,1881072
17,59994623,62037685,dup,SP114991,1,,2043062
1,62485147,63553899,dup,SP114991,1,,1068752
16,68716179,68791183,dup,SP114992,1,,75004
1,246391192,246691311,dup,SP114991,1,,300119
13,35652278,41981748,dup,SP114996,1,,6329470
2,3004209,25807011,dup,SP114987,1,,22802802
1,65835911,77736974,dup,SP114994,1,,11901063
1,941334,13127041,dup,SP114991,1,,12185707
5,58297891,58626985,dup,SP114994,1,,329094
8,103429637,103874814,dup,SP114960,1,,445177
1,114353324,249239130,dup,SP114958,1,,134885806
3,178397892,178652667,del,SP114957,1,,254775
13,50714998,51019282,dup,SP114960,1,,304284
14,88658559,89117214,dup,SP114958,1,,458655
5,171900075,180727169,dup,SP114960,1,,8827094
13,50714998,51006246,dup,SP114957,1,,291248
8,75219546,76336968,dup,SP114953,1,,1117422
7,35489,1667238,dup,SP114958,1,,1631749
2,109689954,111520743,dup,SP114958,1,,1830789
3,176923074,178323314,dup,SP114960,1,,1400240
2,203272691,207657741,dup,SP114958,1,,4385050
3,26691559,33622315,dup,SP114953,1,,6930756
9,140169571,141095345,dup,SP114960,1,,925774
21,17318039,18689874,del,SP114953,1,,1371835
3,135141289,171454266,dup,SP114960,1,,36312977
2,159738198,160270288,dup,SP114953,1,,532090
16,83802,34001694,dup,SP114957,1,,33917892
20,33424151,33592763,dup,SP114958,1,,168612
3,125391858,131631201,dup,SP114958,1,,6239343
2,191477642,191676059,dup,SP114958,1,,198417
10,100705650,100757603,del,SP114953,1,,51953
3,161905420,171454266,dup,SP114958,1,,9548846
21,17316031,18689984,del,SP114958,1,,1373953
5,171900075,180727169,dup,SP114958,1,,8827094
3,131631201,135139891,dup,SP114960,1,,3508690
3,52333671,69058783,dup,SP114960,1,,16725112
2,208735106,217895626,dup,SP114953,1,,9160520
2,200440820,203147281,dup,SP114958,1,,2706461
2,105757940,105878106,dup,SP114960,1,,120166
3,178643694,183028177,dup,SP114960,1,,4384483
14,67907117,68782604,dup,SP114958,1,,875487
9,138995153,140155783,dup,SP114960,1,,1160630
18,30167043,77985412,dup,SP114953,1,,47818369
7,35489,1667238,dup,SP114960,1,,1631749
8,127986466,128252993,dup,SP114957,1,,266527
3,60596,23043971,dup,SP114958,1,,22983375
4,79646530,79883086,dup,SP114960,1,,236556
3,178397892,178643591,del,SP114960,1,,245699
2,189411372,199972587,dup,SP114960,1,,10561215
2,181881025,182597125,dup,SP114957,1,,716100
3,60596,23043971,dup,SP114960,1,,22983375
2,208735237,217878209,dup,SP114960,1,,9142972
12,94697891,99229220,dup,SP114958,1,,4531329
7,35489,1667238,dup,SP114957,1,,1631749
2,187580694,188160948,dup,SP114960,1,,580254
3,52333671,69058783,dup,SP114958,1,,16725112
2,202454093,208732554,dup,SP114957,1,,6278461
13,66127077,79985821,dup,SP114957,1,,13858744
3,60596,23043971,dup,SP114957,1,,22983375
20,33287078,33593457,dup,SP114960,1,,306379
2,118647552,120442992,dup,SP114957,1,,1795440
3,176923074,178323314,dup,SP114958,1,,1400240
2,198789765,200413215,dup,SP114958,1,,1623450
16,83802,33937816,dup,SP114953,1,,33854014
2,160594578,160720538,dup,SP114957,1,,125960
2,217879696,219369851,dup,SP114960,1,,1490155
2,160862804,168958201,dup,SP114953,1,,8095397
2,217897341,219369851,dup,SP114957,1,,1472510
15,20001712,24378693,dup,SP114960,1,,4376981
8,127184,17920807,dup,SP114958,1,,17793623
6,147112215,149175122,dup,SP114958,1,,2062907
8,103428008,103879274,dup,SP114957,1,,451266
8,127981249,128252993,dup,SP114958,1,,271744
22,25003827,26697195,dup,SP114960,1,,1693368
3,178399433,178661045,del,SP114953,1,,261612
15,68094882,102520572,dup,SP114953,1,,34425690
4,79646530,79882492,dup,SP114957,1,,235962
7,2862891,61252619,dup,SP114953,1,,58389728
2,191477642,192639338,dup,SP114957,1,,1161696
3,131631924,135135440,dup,SP114957,1,,3503516
2,113013979,118536080,dup,SP114953,1,,5522101
8,127986466,128252993,dup,SP114960,1,,266527
13,51013008,88728052,dup,SP114953,1,,37715044
3,24166164,24247481,dup,SP114953,1,,81317
2,180614986,180937368,dup,SP114958,1,,322382
1,114353324,249239130,dup,SP114960,1,,134885806
7,2856177,61914134,dup,SP114960,1,,59057957
3,178397892,178646287,del,SP114958,1,,248395
2,180548625,181697443,dup,SP114953,1,,1148818
11,14844129,14980376,dup,SP114960,1,,136247
2,109689954,113013852,dup,SP114957,1,,3323898
5,171900075,180727169,dup,SP114957,1,,8827094
9,138995153,140141794,dup,SP114957,1,,1146641
3,131631924,135141785,dup,SP114958,1,,3509861
2,118646201,120442992,dup,SP114953,1,,1796791
5,147588167,171513874,dup,SP114953,1,,23925707
2,180956334,181697443,dup,SP114960,1,,741109
8,71954694,75214386,dup,SP114953,1,,3259692
2,159737376,160274103,dup,SP114960,1,,536727
3,73497689,125390948,dup,SP114958,1,,51893259
3,125394406,131631201,dup,SP114957,1,,6236795
3,24163773,24247481,dup,SP114958,1,,83708
2,160862804,168958201,dup,SP114960,1,,8095397
21,39883138,42864074,del,SP114953,1,,2980936
14,88658559,89118691,dup,SP114953,1,,460132
1,48184876,48937949,dup,SP114958,1,,753073
6,15684484,32453409,dup,SP114953,1,,16768925
8,33270850,60167514,dup,SP114957,1,,26896664
2,217897341,219369851,dup,SP114953,1,,1472510
8,33263162,60167514,dup,SP114953,1,,26904352
12,20054019,26495821,dup,SP114953,1,,6441802
14,67898130,68782604,dup,SP114960,1,,884474
10,100707860,100757603,del,SP114960,1,,49743
8,127184,17920623,dup,SP114957,1,,17793439
16,4737222,34001694,dup,SP114958,1,,29264472
8,33270850,60167514,dup,SP114960,1,,26896664
3,24166164,24247481,dup,SP114960,1,,81317
7,2856177,61914134,dup,SP114958,1,,59057957
8,76336962,79999240,dup,SP114960,1,,3662278
8,127184,17920807,dup,SP114953,1,,17793623
3,135143297,161524489,dup,SP114958,1,,26381192
8,66949338,75214386,dup,SP114958,1,,8265048
6,32553099,32593280,dup,SP114960,1,,40181
14,67898130,68782300,dup,SP114957,1,,884170
16,83802,34001694,dup,SP114960,1,,33917892
3,24166164,24247481,dup,SP114957,1,,81317
17,76056153,76264287,dup,SP114958,1,,208134
3,52333671,69056121,dup,SP114957,1,,16722450
8,75219546,76332258,dup,SP114960,1,,1112712
8,66949338,75214386,dup,SP114957,1,,8265048
22,26698892,26909750,dup,SP114953,1,,210858
15,68168627,102520572,dup,SP114957,1,,34351945
3,171973731,176701076,dup,SP114958,1,,4727345
4,87540123,91744236,dup,SP114953,1,,4204113
3,187540133,187924457,dup,SP114960,1,,384324
2,214810651,217895626,dup,SP114958,1,,3084975
3,73497689,125391858,dup,SP114960,1,,51894169
13,19020145,38908600,dup,SP114953,1,,19888455
3,26693002,49055788,dup,SP114960,1,,22362786
2,153588354,158156471,dup,SP114953,1,,4568117
10,14186139,18235101,dup,SP114953,1,,4048962
8,76336962,79999240,dup,SP114958,1,,3662278
3,178647946,182976382,dup,SP114958,1,,4328436
8,76336962,79999240,dup,SP114957,1,,3662278
3,73497689,125394333,dup,SP114957,1,,51896644
14,88644361,89118691,dup,SP114957,1,,474330
1,99185989,99605189,dup,SP114953,1,,419200
1,114348942,249239130,dup,SP114957,1,,134890188
17,44171207,44573974,dup,SP114960,1,,402767
2,159737376,159861852,dup,SP114958,1,,124476
20,76962,24970867,dup,SP114953,1,,24893905
11,39778067,44514903,dup,SP114957,1,,4736836
1,48184876,48930589,dup,SP114960,1,,745713
22,46888919,46917291,dup,SP114960,1,,28372
21,17314322,18689874,del,SP114960,1,,1375552
15,38106163,38240464,dup,SP114957,1,,134301
4,79645331,79883086,dup,SP114958,1,,237755
2,197526679,198789013,dup,SP114958,1,,1262334
8,76337080,79999240,dup,SP114953,1,,3662160
4,149306107,149461625,dup,SP114958,1,,155518
15,68168627,102520572,dup,SP114960,1,,34351945
8,75219546,76332258,dup,SP114958,1,,1112712
2,26029494,30397170,dup,SP114953,1,,4367676
8,66949338,75214386,dup,SP114960,1,,8265048
2,197528257,202450177,dup,SP114957,1,,4921920
8,75219546,76332258,dup,SP114957,1,,1112712
2,188150009,188916374,dup,SP114953,1,,766365
3,161525654,161901456,dup,SP114958,1,,375802
16,1871090,4709636,dup,SP114958,1,,2838546
15,68168627,102520572,dup,SP114958,1,,34351945
3,171973731,176701076,dup,SP114957,1,,4727345
10,100707860,100755922,del,SP114957,1,,48062
3,171973731,176701076,dup,SP114960,1,,4727345
2,199975304,208735106,dup,SP114960,1,,8759802
2,103268511,105523952,dup,SP114958,1,,2255441
13,50715734,51006246,dup,SP114958,1,,290512
2,191676600,192634126,dup,SP114958,1,,957526
2,187580694,188144972,dup,SP114953,1,,564278
2,207659606,208732554,dup,SP114958,1,,1072948
5,147588167,171513874,dup,SP114957,1,,23925707
13,38938269,50714998,dup,SP114953,1,,11776729
15,38098535,38293656,dup,SP114958,1,,195121
2,188150009,188916374,dup,SP114957,1,,766365
5,147588167,171513874,dup,SP114960,1,,23925707
6,171716,4798267,dup,SP114953,1,,4626551
14,67898130,68783274,dup,SP114953,1,,885144
2,180956334,181697443,dup,SP114958,1,,741109
12,14190077,20053097,dup,SP114953,1,,5863020
3,125394333,131629716,dup,SP114960,1,,6235383
7,61368188,99051375,dup,SP114953,1,,37683187
8,33263162,60167514,dup,SP114958,1,,26904352
2,160155416,160274103,dup,SP114958,1,,118687
3,178659725,182976382,dup,SP114957,1,,4316657
5,171900075,180727169,dup,SP114953,1,,8827094
3,176927519,178323314,dup,SP114957,1,,1395795
2,160862804,161965080,dup,SP114957,1,,1102276
2,26029494,30397170,dup,SP114960,1,,4367676
6,32554540,32591976,dup,SP114958,1,,37436
2,181881025,182597125,dup,SP114960,1,,716100
21,39815212,39881848,dup,SP114960,1,,66636
3,178665577,182797117,dup,SP114953,1,,4131540
7,101984753,159122682,dup,SP114953,1,,57137929
20,25020047,25262396,del,SP114953,1,,242349
3,33657998,49055788,dup,SP114953,1,,15397790
2,192635500,197522966,dup,SP114958,1,,4887466
3,176923074,178323314,dup,SP114953,1,,1400240
8,103418671,103874814,dup,SP114958,1,,456143
1,142893636,249239130,dup,SP114953,1,,106345494
13,50715734,51006246,dup,SP114953,1,,290512
6,32635904,32703591,dup,SP114953,1,,67687
16,63299361,63469209,dup,SP114953,1,,169848
2,160594578,160720538,dup,SP114958,1,,125960
3,187540133,187924457,dup,SP114958,1,,384324
21,39799126,39813955,del,SP114960,1,,14829
8,127184,17920807,dup,SP114960,1,,17793623
2,160594578,160720538,dup,SP114960,1,,125960
2,219371259,219845055,dup,SP114960,1,,473796
22,26698892,26909750,dup,SP114958,1,,210858
9,138994867,140155783,dup,SP114958,1,,1160916
1,48178900,48930589,dup,SP114957,1,,751689
14,88661798,89118691,dup,SP114960,1,,456893
10,100705650,100757603,del,SP114958,1,,51953
8,66948506,71847105,dup,SP114953,1,,4898599
2,153588354,158156471,dup,SP114960,1,,4568117
16,83802,1818138,dup,SP114958,1,,1734336
2,191477642,198898344,dup,SP114953,1,,7420702
7,2856177,61914134,dup,SP114957,1,,59057957
15,38098535,38300331,dup,SP114960,1,,201796
3,26693002,49055788,dup,SP114957,1,,22362786
6,32541506,32593280,dup,SP114953,1,,51774
13,79986036,115093767,dup,SP114957,1,,35107731
2,192640624,197527879,dup,SP114957,1,,4887255
2,217897341,219369851,dup,SP114958,1,,1472510
3,60596,23043971,dup,SP114953,1,,22983375
2,208735106,214556938,dup,SP114958,1,,5821832
2,161966346,165231415,dup,SP114957,1,,3265069
1,99185989,99602968,dup,SP114958,1,,416979
8,103425699,103874814,dup,SP114953,1,,449115
17,44171207,44573974,dup,SP114957,1,,402767
2,208735106,214584354,dup,SP114957,1,,5849248
16,70794031,71199125,dup,SP114958,1,,405094
2,118646948,120442992,dup,SP114960,1,,1796044
2,113013979,118646948,dup,SP114957,1,,5632969
2,181878770,182597125,dup,SP114953,1,,718355
2,219371259,219845055,dup,SP114957,1,,473796
3,135136227,171454266,dup,SP114957,1,,36318039
2,153588354,158156471,dup,SP114957,1,,4568117
22,26698892,26909750,dup,SP114960,1,,210858
3,187537451,187927165,dup,SP114957,1,,389714
22,26698892,26909750,dup,SP114957,1,,210858
7,66214010,66706444,dup,SP114960,1,,492434
2,198899275,208732554,dup,SP114953,1,,9833279
3,26693002,49055788,dup,SP114958,1,,22362786
5,147588167,171514639,dup,SP114958,1,,23926472
2,165246738,168959153,dup,SP114957,1,,3712415
1,114353324,142862990,dup,SP114953,1,,28509666
2,160589818,160720538,dup,SP114953,1,,130720
12,103312108,133832256,dup,SP114968,1,,30520148
8,54354494,54938088,dup,SP114968,1,,583594
2,193203727,198505266,dup,SP114968,1,,5301539
21,21545030,21891113,del,SP114966,1,,346083
2,193204840,198616891,dup,SP114966,1,,5412051
5,152861509,165877057,dup,SP114966,1,,13015548
6,11985499,32602231,dup,SP114966,1,,20616732
17,54572895,79905255,dup,SP114966,1,,25332360
8,18699820,20065362,dup,SP114966,1,,1365542
8,75483809,92514808,dup,SP114966,1,,17030999
8,96192855,101639576,dup,SP114966,1,,5446721
8,94952026,95460055,dup,SP114962,1,,508029
3,114050057,114314059,del,SP114970,1,,264002
11,39335697,49701411,dup,SP114966,1,,10365714
8,67583681,75480503,dup,SP114966,1,,7896822
16,79803894,79998552,del,SP114970,1,,194658
8,92559915,94718164,dup,SP114966,1,,2158249
1,65335323,67485453,del,SP114966,1,,2150130
5,17478777,33827374,dup,SP114966,1,,16348597
12,102154216,103312023,dup,SP114968,1,,1157807
1,154319756,157000716,dup,SP114966,1,,2680960
12,8824901,33564894,dup,SP114970,1,,24739993
8,3822916,4334769,dup,SP114968,1,,511853
6,118373039,150083787,dup,SP114968,1,,31710748
8,62198278,66985121,dup,SP114966,1,,4786843
2,192386971,192532890,dup,SP114966,1,,145919
4,105878638,155276863,dup,SP114962,1,,49398225
5,3522987,33823824,dup,SP114962,1,,30300837
8,95604669,96174718,dup,SP114966,1,,570049
3,113606229,114047286,dup,SP114962,1,,441057
8,95604669,96173294,dup,SP114968,1,,568625
14,19066116,57145495,dup,SP114970,1,,38079379
5,147301720,149489802,dup,SP114962,1,,2188082
8,58447999,59364941,dup,SP114962,1,,916942
17,44808902,49455756,dup,SP114966,1,,4646854
8,18699820,20065362,dup,SP114968,1,,1365542
1,149815323,154325411,dup,SP114968,1,,4510088
7,9584446,57804021,dup,SP114962,1,,48219575
2,198942568,199158816,dup,SP114962,1,,216248
8,18699820,20063137,dup,SP114970,1,,1363317
17,54572895,79905255,dup,SP114968,1,,25332360
2,192386971,192532890,dup,SP114968,1,,145919
6,57875219,58075040,del,SP114970,1,,199821
8,125455495,136758835,dup,SP114962,1,,11303340
8,108294080,120836663,dup,SP114968,1,,12542583
12,121119057,133832256,dup,SP114962,1,,12713199
2,192662611,193204046,dup,SP114966,1,,541435
8,20064771,20303960,dup,SP114970,1,,239189
11,20630361,20979979,dup,SP114962,1,,349618
8,104952057,108292355,dup,SP114968,1,,3340298
8,49257252,53581039,del,SP114968,1,,4323787
2,141558996,141582377,del,SP114968,1,,23381
2,144374281,147053296,dup,SP114968,1,,2679015
14,19066116,20406816,dup,SP114966,1,,1340700
14,74284430,91271981,dup,SP114968,1,,16987551
6,58139760,58773130,dup,SP114970,1,,633370
5,127237009,147301166,dup,SP114962,1,,20064157
8,125455992,128713173,dup,SP114966,1,,3257181
20,49634885,62954871,dup,SP114962,1,,13319986
8,125455495,128715817,dup,SP114968,1,,3260322
6,32648809,36607432,dup,SP114968,1,,3958623
14,19066116,20406816,dup,SP114968,1,,1340700
8,42896144,46956240,dup,SP114970,1,,4060096
8,7213713,16545500,dup,SP114968,1,,9331787
17,44485795,49448923,dup,SP114968,1,,4963128
7,9584446,61867682,dup,SP114968,1,,52283236
8,61860596,62189775,dup,SP114966,1,,329179
5,141080465,147869174,dup,SP114966,1,,6788709
8,61860596,62189775,dup,SP114968,1,,329179
18,40896617,47824546,dup,SP114970,1,,6927929
8,136757041,146175510,dup,SP114968,1,,9418469
13,32959534,33876962,del,SP114966,1,,917428
8,67583681,75480503,dup,SP114962,1,,7896822
3,59058876,59653540,dup,SP114966,1,,594664
1,154326366,156989811,dup,SP114968,1,,2663445
3,112278259,113605943,dup,SP114962,1,,1327684
5,141080465,150176501,dup,SP114968,1,,9096036
8,128715817,136761778,dup,SP114966,1,,8045961
8,3822916,4332061,dup,SP114966,1,,509145
8,94743292,95460055,dup,SP114968,1,,716763
20,51392774,53472421,dup,SP114966,1,,2079647
8,128743093,136762575,dup,SP114970,1,,8019482
8,136763200,146175510,dup,SP114970,1,,9412310
20,49636803,51381201,dup,SP114966,1,,1744398
1,14179898,20503710,dup,SP114966,1,,6323812
8,119944794,120836663,dup,SP114962,1,,891869
6,118365857,124807541,dup,SP114966,1,,6441684
2,199158911,199500000,del,SP114962,1,,341089
8,58447999,59364941,dup,SP114970,1,,916942
8,125455495,128740607,dup,SP114970,1,,3285112
8,101639576,104951259,dup,SP114968,1,,3311683
12,102150878,103312108,dup,SP114966,1,,1161230
8,94743292,95460055,dup,SP114966,1,,716763
1,65335323,67485453,del,SP114962,1,,2150130
12,58077416,121113847,dup,SP114962,1,,63036431
13,32957819,33876681,del,SP114962,1,,918862
2,139158265,139513373,del,SP114970,1,,355108
8,54349988,54938088,dup,SP114966,1,,588100
10,45449678,77683544,dup,SP114966,1,,32233866
3,59056912,59653540,dup,SP114962,1,,596628
10,21857241,45448327,dup,SP114966,1,,23591086
8,75483809,90697498,dup,SP114962,1,,15213689
8,17658473,18332245,dup,SP114968,1,,673772
12,103312430,133832256,dup,SP114966,1,,30519826
14,74724873,107268223,dup,SP114962,1,,32543350
10,45449678,77682815,dup,SP114968,1,,32233137
8,101671221,119821860,dup,SP114962,1,,18150639
8,95604669,96173379,dup,SP114962,1,,568710
5,3522987,33823824,dup,SP114968,1,,30300837
6,168333954,168598199,dup,SP114962,1,,264245
2,199504423,199554281,dup,SP114970,1,,49858
2,198942568,199156223,dup,SP114968,1,,213655
8,68724880,90766104,dup,SP114970,1,,22041224
2,192662611,198790423,dup,SP114962,1,,6127812
8,16545872,17658059,dup,SP114968,1,,1112187
2,198792320,198941578,del,SP114970,1,,149258
11,20630361,20979979,dup,SP114968,1,,349618
1,65335323,67485453,del,SP114968,1,,2150130
2,192388629,192562062,dup,SP114970,1,,173433
2,140617816,141386289,del,SP114970,1,,768473
13,32952485,33876681,del,SP114968,1,,924196
15,60779599,102520572,del,SP114970,1,,41740973
8,96173379,120836663,dup,SP114970,1,,24663284
17,54572895,79905255,dup,SP114962,1,,25332360
5,151470336,165877057,dup,SP114968,1,,14406721
8,90729669,94951375,dup,SP114962,1,,4221706
8,67583681,75480503,dup,SP114968,1,,7896822
1,14180832,20503710,dup,SP114968,1,,6322878
16,78984708,79724611,dup,SP114962,1,,739903
13,32957972,33876962,del,SP114970,1,,918990
8,75483809,94718164,dup,SP114968,1,,19234355
6,118373039,150083787,dup,SP114962,1,,31710748
7,114363869,132435953,dup,SP114962,1,,18072084
3,114315885,167220105,dup,SP114962,1,,52904220
1,144931873,217308047,dup,SP114970,1,,72376174
6,168333954,168591028,dup,SP114968,1,,257074
17,44570355,54572699,dup,SP114962,1,,10002344
11,39329123,49701411,dup,SP114968,1,,10372288
8,62198278,66985121,dup,SP114968,1,,4786843
17,54874901,79878742,dup,SP114970,1,,25003841
4,105878638,155276863,dup,SP114968,1,,49398225
12,41181240,102149981,dup,SP114966,1,,60968741
8,53551808,54356898,dup,SP114962,1,,805090
5,167604002,180711115,dup,SP114968,1,,13107113
8,46959169,53563378,del,SP114970,1,,6604209
8,128740607,136756854,dup,SP114968,1,,8016247
8,6998853,18332245,dup,SP114966,1,,11333392
8,20318494,21709347,dup,SP114966,1,,1390853
8,58447999,59364941,dup,SP114966,1,,916942
6,168333954,168598199,dup,SP114970,1,,264245
16,79796159,79803833,dup,SP114970,1,,7674
11,20630361,20976315,dup,SP114966,1,,345954
16,79796159,79803894,dup,SP114968,1,,7735
1,149736391,157005595,dup,SP114962,1,,7269204
8,95604669,95671117,dup,SP114970,1,,66448
10,45449678,77683544,dup,SP114962,1,,32233866
1,149339087,154318564,dup,SP114966,1,,4979477
5,150226722,151468499,dup,SP114968,1,,1241777
8,47401711,49256969,del,SP114968,1,,1855258
7,68194503,159128337,dup,SP114970,1,,90933834
8,123752044,123982099,dup,SP114966,1,,230055
20,49634885,62954871,dup,SP114968,1,,13319986
6,32648809,36616698,dup,SP114966,1,,3967889
3,59056912,59649815,dup,SP114968,1,,592903
12,41099226,41173781,del,SP114970,1,,74555
8,20303960,21708915,dup,SP114968,1,,1404955
14,19066116,20400226,dup,SP114962,1,,1334110
8,3822916,4334769,dup,SP114962,1,,511853
8,18699820,20064771,dup,SP114962,1,,1364951
8,96173947,101639576,dup,SP114962,1,,5465629
8,123752044,123982099,dup,SP114968,1,,230055
7,9584446,57852906,dup,SP114966,1,,48268460
20,53492619,62954871,dup,SP114966,1,,9462252
8,136762064,146175510,dup,SP114966,1,,9413446
8,101671221,120836663,dup,SP114966,1,,19165442
5,3523512,10591132,dup,SP114966,1,,7067620
2,193203397,198328724,dup,SP114970,1,,5125327
2,144374281,147052552,dup,SP114966,1,,2678271
6,11985499,32601416,dup,SP114968,1,,20615917
18,40221534,40893838,del,SP114970,1,,672304
5,167604002,180711115,dup,SP114966,1,,13107113
8,96173379,101633819,dup,SP114968,1,,5460440
4,105878638,155276863,dup,SP114966,1,,49398225
1,156991571,217869585,dup,SP114968,1,,60878014
16,79796159,79804773,dup,SP114966,1,,8614
8,67583681,68721236,dup,SP114970,1,,1137555
1,157002443,217869585,dup,SP114966,1,,60867142
5,36865669,38472541,dup,SP114901,1,,1606872
20,59471314,60053650,dup,SP114901,1,,582336
11,59979932,61991891,dup,SP114901,1,,2011959
4,154276694,159751275,dup,SP114900,1,,5474581
1,100031574,102783755,dup,SP114900,1,,2752181
2,165330160,166496811,dup,SP114900,1,,1166651
8,97240950,104272419,dup,SP114901,1,,7031469
14,28651016,28805669,dup,SP114898,1,,154653
11,6744442,6997619,dup,SP114903,1,,253177
22,42912847,43252280,dup,SP114903,1,,339433
15,70977813,74827916,dup,SP114900,1,,3850103
3,85002977,88113036,dup,SP114901,1,,3110059
2,183748979,184197119,dup,SP114900,1,,448140
4,77412091,78882757,dup,SP114903,1,,1470666
11,133771179,134862259,dup,SP114901,1,,1091080
1,16543346,17037019,dup,SP114898,1,,493673
14,34233351,35024310,dup,SP114900,1,,790959
12,66744983,68874330,dup,SP114898,1,,2129347
7,90913929,94188680,dup,SP114901,1,,3274751
2,192980006,194339337,dup,SP114901,1,,1359331
3,96066172,96430500,dup,SP114898,1,,364328
4,90316005,90622350,dup,SP114901,1,,306345
5,54810306,55770154,dup,SP114898,1,,959848
14,79384117,79618459,dup,SP114898,1,,234342
14,56087791,59056633,dup,SP114900,1,,2968842
5,55278265,55770154,dup,SP114903,1,,491889
18,52419643,57857837,dup,SP114903,1,,5438194
9,1486005,3054794,dup,SP114901,1,,1568789
3,180900591,182727097,dup,SP114898,1,,1826506
12,69734781,70113517,dup,SP114903,1,,378736
5,143979518,144285538,dup,SP114900,1,,306020
1,186260311,190342876,dup,SP114903,1,,4082565
13,113238377,113473023,dup,SP114898,1,,234646
7,18113008,23109257,dup,SP114900,1,,4996249
5,157786808,158288268,dup,SP114898,1,,501460
16,9736917,11297084,dup,SP114903,1,,1560167
21,46053099,46428137,dup,SP114903,1,,375038
7,123126925,123977345,dup,SP114903,1,,850420
12,5045302,5799214,dup,SP114903,1,,753912
5,141533062,143979058,dup,SP114900,1,,2445996
2,170144788,171674696,dup,SP114901,1,,1529908
19,30227769,30637004,dup,SP114901,1,,409235
8,75136313,97240847,dup,SP114901,1,,22104534
9,96889493,97689374,dup,SP114901,1,,799881
18,59596166,60160327,dup,SP114903,1,,564161
9,20542958,21088416,dup,SP114898,1,,545458
14,106725873,107289436,dup,SP114898,1,,563563
3,88114373,96063914,dup,SP114900,1,,7949541
11,99217421,101205144,dup,SP114898,1,,1987723
7,53144946,53336581,dup,SP114898,1,,191635
4,116533612,138638761,dup,SP114900,1,,22105149
2,175226883,175495461,dup,SP114898,1,,268578
18,287252,1260172,dup,SP114898,1,,972920
8,68539972,69055275,dup,SP114898,1,,515303
4,146933473,148833308,dup,SP114898,1,,1899835
6,31220109,31326251,dup,SP114898,1,,106142
11,1010694,3916506,dup,SP114903,1,,2905812
2,67823924,71423107,dup,SP114903,1,,3599183
5,9604971,11360893,dup,SP114901,1,,1755922
13,95376440,95730539,dup,SP114898,1,,354099
6,28965639,42117679,dup,SP114901,1,,13152040
8,88456846,99552286,dup,SP114898,1,,11095440
3,85002977,88113663,dup,SP114900,1,,3110686
14,71215380,71467070,dup,SP114903,1,,251690
16,4991390,5282628,dup,SP114903,1,,291238
9,20542633,21088416,dup,SP114900,1,,545783
7,5763201,6781075,dup,SP114898,1,,1017874
10,131791241,131804192,del,SP114901,1,,12951
1,3081997,3637247,dup,SP114901,1,,555250
9,96889493,100574120,dup,SP114900,1,,3684627
1,36489977,37051105,dup,SP114901,1,,561128
11,90384749,90598152,dup,SP114900,1,,213403
13,21554217,22172265,dup,SP114900,1,,618048
17,65367220,68908954,dup,SP114900,1,,3541734
2,239752767,240451234,dup,SP114903,1,,698467
2,71424143,73775333,dup,SP114901,1,,2351190
3,33203657,33919967,dup,SP114900,1,,716310
4,67300802,67682225,dup,SP114898,1,,381423
3,85004579,88113663,dup,SP114903,1,,3109084
2,190583187,196597707,dup,SP114898,1,,6014520
5,9606166,11360893,dup,SP114898,1,,1754727
7,61760687,63209246,dup,SP114900,1,,1448559
2,235510542,236074651,dup,SP114903,1,,564109
5,9580152,11360893,dup,SP114900,1,,1780741
4,167875848,170779661,dup,SP114900,1,,2903813
2,23649702,23806335,dup,SP114901,1,,156633
5,140346712,141530696,dup,SP114901,1,,1183984
5,42454085,43503360,dup,SP114898,1,,1049275
12,118283230,118889196,dup,SP114901,1,,605966
1,195400135,197018398,dup,SP114903,1,,1618263
2,177537656,178286946,dup,SP114900,1,,749290
7,17779637,18104972,dup,SP114898,1,,325335
8,71805628,73556728,dup,SP114900,1,,1751100
8,99552286,99975844,dup,SP114900,1,,423558
1,36503216,37058303,dup,SP114903,1,,555087
2,165337083,168768098,dup,SP114903,1,,3431015
1,186262505,190342876,dup,SP114901,1,,4080371
14,54297055,56087148,dup,SP114900,1,,1790093
10,114260483,114446340,del,SP114901,1,,185857
7,3184748,3573316,dup,SP114898,1,,388568
4,90612588,93454778,dup,SP114900,1,,2842190
1,142564434,146393185,dup,SP114901,1,,3828751
2,121459243,121994279,dup,SP114898,1,,535036
5,163509787,163691418,dup,SP114898,1,,181631
12,118873681,121828260,dup,SP114900,1,,2954579
9,119826453,121425024,dup,SP114898,1,,1598571
16,22762176,23900568,dup,SP114900,1,,1138392
14,85004963,85859503,dup,SP114900,1,,854540
18,35991332,41315087,dup,SP114900,1,,5323755
3,90483817,96059233,dup,SP114901,1,,5575416
2,48840047,59833802,dup,SP114900,1,,10993755
19,19619542,21383005,dup,SP114900,1,,1763463
4,182860444,191043168,dup,SP114898,1,,8182724
22,43255397,46187225,dup,SP114903,1,,2931828
18,51890863,52417409,dup,SP114903,1,,526546
2,196603797,198919834,dup,SP114901,1,,2316037
6,2998349,4897449,dup,SP114898,1,,1899100
2,48825650,55098466,dup,SP114901,1,,6272816
3,42841014,44504319,dup,SP114903,1,,1663305
13,45327552,45548000,dup,SP114898,1,,220448
8,99518731,99918720,dup,SP114903,1,,399989
3,149991065,150954156,dup,SP114900,1,,963091
19,51380602,54908607,dup,SP114901,1,,3528005
1,45764258,46118745,dup,SP114901,1,,354487
3,147294985,148446464,dup,SP114900,1,,1151479
4,67926536,68309646,dup,SP114898,1,,383110
17,62636107,63343172,dup,SP114901,1,,707065
2,236074651,239735343,dup,SP114901,1,,3660692
17,71767153,77240105,dup,SP114901,1,,5472952
6,6992873,7269249,dup,SP114900,1,,276376
20,48572787,50601191,dup,SP114900,1,,2028404
20,50602112,55657644,dup,SP114900,1,,5055532
3,129810234,132358844,dup,SP114903,1,,2548610
7,12976608,14209139,dup,SP114903,1,,1232531
16,85268298,90292766,del,SP114900,1,,5024468
14,85004963,85859503,dup,SP114901,1,,854540
4,72306930,77411710,dup,SP114903,1,,5104780
2,31369516,32044482,dup,SP114898,1,,674966
2,121994279,122330781,dup,SP114901,1,,336502
7,3575864,4303934,dup,SP114898,1,,728070
1,6742281,7559952,dup,SP114903,1,,817671
20,44334394,55681183,dup,SP114898,1,,11346789
8,70717139,71665326,dup,SP114898,1,,948187
2,169904462,170129877,dup,SP114900,1,,225415
9,20545477,21088416,dup,SP114903,1,,542939
16,2529997,9741655,dup,SP114900,1,,7211658
11,59981524,61991891,dup,SP114898,1,,2010367
20,44332298,48225985,dup,SP114900,1,,3893687
20,55658292,56198123,dup,SP114900,1,,539831
11,99217421,101361486,dup,SP114903,1,,2144065
8,99562385,99920800,dup,SP114898,1,,358415
7,30458456,30847145,dup,SP114898,1,,388689
3,123470192,123813469,dup,SP114898,1,,343277
6,142822451,145318176,dup,SP114901,1,,2495725
6,135419305,135602403,dup,SP114898,1,,183098
11,119216279,119613092,dup,SP114898,1,,396813
1,76973920,77126189,dup,SP114900,1,,152269
18,42257069,43052572,dup,SP114900,1,,795503
7,95966546,96245563,dup,SP114898,1,,279017
12,69734781,70082540,dup,SP114898,1,,347759
13,21547832,22178403,dup,SP114903,1,,630571
6,134146024,134586626,dup,SP114898,1,,440602
5,40558950,41247993,dup,SP114900,1,,689043
2,171972766,172886148,dup,SP114901,1,,913382
7,1898336,3178549,dup,SP114898,1,,1280213
18,59596166,60163100,dup,SP114898,1,,566934
2,163317571,165337083,dup,SP114901,1,,2019512
4,110905804,138637527,dup,SP114903,1,,27731723
3,149997676,150952752,dup,SP114903,1,,955076
3,64769945,64925383,dup,SP114898,1,,155438
12,68877237,69734375,dup,SP114898,1,,857138
6,2644630,4893278,dup,SP114900,1,,2248648
9,17458772,17650643,dup,SP114901,1,,191871
20,55646681,56356105,dup,SP114903,1,,709424
2,62438681,62961882,dup,SP114901,1,,523201
11,78583525,79961472,dup,SP114898,1,,1377947
17,18546023,21525954,dup,SP114898,1,,2979931
11,129882166,131793500,dup,SP114900,1,,1911334
6,115213139,116577117,dup,SP114901,1,,1363978
4,148845190,149175000,dup,SP114898,1,,329810
4,101910070,103553543,dup,SP114903,1,,1643473
5,51090550,53028307,dup,SP114901,1,,1937757
9,76652827,77274112,dup,SP114900,1,,621285
17,59739005,61361805,dup,SP114901,1,,1622800
1,41862806,45290494,dup,SP114901,1,,3427688
2,11274,14075703,dup,SP114900,1,,14064429
12,118279552,118872528,dup,SP114900,1,,592976
3,107472095,107894386,dup,SP114903,1,,422291
20,55681324,56358006,dup,SP114898,1,,676682
5,11363645,12016537,dup,SP114903,1,,652892
22,42902872,43244269,dup,SP114898,1,,341397
7,30334275,32888176,dup,SP114900,1,,2553901
7,67498152,67715380,dup,SP114903,1,,217228
11,133767275,134862405,dup,SP114898,1,,1095130
2,196603797,212609840,dup,SP114900,1,,16006043
2,23649702,23806335,dup,SP114900,1,,156633
8,114064764,121092087,dup,SP114900,1,,7027323
4,146387147,146930015,dup,SP114901,1,,542868
5,12019023,12889305,dup,SP114898,1,,870282
8,134764788,135038778,dup,SP114900,1,,273990
9,20546887,21090322,dup,SP114901,1,,543435
4,153774545,154272745,dup,SP114900,1,,498200
4,173089919,174637879,dup,SP114900,1,,1547960
2,169904462,170141724,dup,SP114901,1,,237262
9,98314203,100574120,dup,SP114901,1,,2259917
1,18297407,22737344,dup,SP114901,1,,4439937
6,19537503,20006886,dup,SP114901,1,,469383
20,44332298,55620155,dup,SP114901,1,,11287857
20,5886863,6109215,dup,SP114898,1,,222352
1,26650550,28319484,dup,SP114900,1,,1668934
2,11274,14070521,dup,SP114901,1,,14059247
2,201282338,235535223,dup,SP114901,1,,34252885
7,63226229,67014800,dup,SP114901,1,,3788571
7,86964212,94188680,dup,SP114898,1,,7224468
4,159751275,160619099,dup,SP114901,1,,867824
7,94189369,95972285,dup,SP114901,1,,1782916
2,107678488,109227140,dup,SP114903,1,,1548652
8,138724825,139609087,dup,SP114901,1,,884262
5,1280028,1960877,dup,SP114898,1,,680849
17,44310234,57652338,dup,SP114900,1,,13342104
5,40603458,41247993,dup,SP114901,1,,644535
17,76825450,77240122,dup,SP114898,1,,414672
11,78583525,79924584,dup,SP114903,1,,1341059
16,4015311,5284224,dup,SP114898,1,,1268913
13,32992277,38710794,dup,SP114898,1,,5718517
5,54852616,55770154,dup,SP114900,1,,917538
8,87980170,88456667,dup,SP114898,1,,476497
8,33276513,34083654,del,SP114900,1,,807141
8,124934558,139579399,dup,SP114898,1,,14644841
8,73568873,75098003,dup,SP114903,1,,1529130
9,17458772,17648146,dup,SP114900,1,,189374
5,155025037,155336076,dup,SP114903,1,,311039
5,138222330,140346223,dup,SP114901,1,,2123893
2,177526156,181453769,dup,SP114903,1,,3927613
2,181454355,181726753,dup,SP114898,1,,272398
8,69055275,71909222,dup,SP114901,1,,2853947
6,125591008,126686513,dup,SP114903,1,,1095505
12,95605384,95839106,dup,SP114903,1,,233722
22,43249093,46195580,dup,SP114898,1,,2946487
5,157778813,158288268,dup,SP114903,1,,509455
19,36561097,39552338,dup,SP114900,1,,2991241
8,75136313,99516343,dup,SP114903,1,,24380030
17,38043649,38250766,dup,SP114901,1,,207117
5,101181613,101461122,dup,SP114898,1,,279509
9,32133671,32333058,dup,SP114901,1,,199387
2,124062123,124858689,dup,SP114901,1,,796566
4,59147525,59396059,dup,SP114898,1,,248534
17,44213204,44353885,dup,SP114903,1,,140681
4,15228359,15702697,dup,SP114898,1,,474338
16,76452531,85267894,del,SP114900,1,,8815363
14,41429553,41609835,dup,SP114901,1,,180282
1,36495785,37025239,dup,SP114900,1,,529454
10,5303045,5322475,del,SP114901,1,,19430
1,152127455,154008328,dup,SP114903,1,,1880873
7,14209139,17778782,dup,SP114898,1,,3569643
9,23430020,24229093,dup,SP114901,1,,799073
7,39669180,43268518,dup,SP114901,1,,3599338
6,156619396,158376369,dup,SP114901,1,,1756973
11,65094583,66446598,dup,SP114900,1,,1352015
8,135039592,139579533,dup,SP114900,1,,4539941
8,68227004,68564440,dup,SP114903,1,,337436
9,4951232,5293796,dup,SP114898,1,,342564
9,96889493,100574120,dup,SP114903,1,,3684627
9,77274424,79491431,dup,SP114900,1,,2217007
4,159725765,160644401,dup,SP114903,1,,918636
2,148637077,149925577,dup,SP114900,1,,1288500
15,41982203,42440679,dup,SP114900,1,,458476
15,75006841,78766208,dup,SP114901,1,,3759367
5,40921339,41247993,dup,SP114898,1,,326654
6,91323931,91528996,dup,SP114901,1,,205065
7,30299245,32894682,dup,SP114901,1,,2595437
19,49152955,49630863,dup,SP114903,1,,477908
12,24735339,27707353,dup,SP114898,1,,2972014
5,28884398,29191922,dup,SP114898,1,,307524
6,52925277,64470069,dup,SP114901,1,,11544792
4,138969977,146387144,dup,SP114901,1,,7417167
10,5301811,5322183,del,SP114903,1,,20372
2,23649702,23809510,dup,SP114903,1,,159808
17,57652789,59739005,dup,SP114900,1,,2086216
18,59595655,60163100,dup,SP114901,1,,567445
6,28585581,28964847,dup,SP114901,1,,379266
18,51890228,52407476,dup,SP114900,1,,517248
3,167127289,169844718,dup,SP114903,1,,2717429
6,156712682,158361899,dup,SP114898,1,,1649217
5,125419268,126085712,dup,SP114901,1,,666444
18,43727564,48570875,dup,SP114901,1,,4843311
14,52556183,52790347,dup,SP114898,1,,234164
3,159756451,166041612,dup,SP114898,1,,6285161
18,59596288,60152007,dup,SP114900,1,,555719
14,41427999,41609835,dup,SP114900,1,,181836
1,66567555,66798816,dup,SP114901,1,,231261
2,177537656,178286946,dup,SP114901,1,,749290
8,75136313,99550574,dup,SP114900,1,,24414261
4,138963965,146386921,dup,SP114900,1,,7422956
13,46566423,46907115,dup,SP114898,1,,340692
7,138944578,139566104,dup,SP114901,1,,621526
1,26648534,28327218,dup,SP114901,1,,1678684
9,21090772,23425731,dup,SP114901,1,,2334959
8,104233228,104476458,dup,SP114898,1,,243230
3,166452217,167126202,dup,SP114903,1,,673985
12,16331051,20455123,dup,SP114900,1,,4124072
8,110858989,114064764,dup,SP114903,1,,3205775
8,114066751,129987885,dup,SP114903,1,,15921134
2,107703767,109230360,dup,SP114900,1,,1526593
2,205999801,209348412,dup,SP114898,1,,3348611
15,70974516,75006125,dup,SP114901,1,,4031609
3,171670277,172393939,dup,SP114901,1,,723662
9,23430020,24229093,dup,SP114900,1,,799073
12,132526136,133019498,dup,SP114898,1,,493362
10,5301811,5321835,del,SP114900,1,,20024
11,71566665,76535100,dup,SP114898,1,,4968435
11,131190411,133770411,dup,SP114901,1,,2580000
18,42257069,43049905,dup,SP114901,1,,792836
20,44334394,55628189,dup,SP114903,1,,11293795
7,138983484,139462162,dup,SP114903,1,,478678
1,148854502,152127455,dup,SP114900,1,,3272953
12,121828260,125876457,dup,SP114901,1,,4048197
5,101181345,101473293,dup,SP114901,1,,291948
6,28585581,28964847,dup,SP114903,1,,379266
4,96892392,101910070,dup,SP114898,1,,5017678
4,76611851,93454778,dup,SP114898,1,,16842927
9,116764283,117579853,dup,SP114898,1,,815570
2,73774019,76028349,dup,SP114900,1,,2254330
2,190583187,196608265,dup,SP114903,1,,6025078
1,154019922,154682082,dup,SP114900,1,,662160
17,65442127,68923526,dup,SP114901,1,,3481399
14,50000652,52529984,dup,SP114901,1,,2529332
4,167876673,170789711,dup,SP114901,1,,2913038
2,236074651,239735343,dup,SP114900,1,,3660692
5,54882505,55770154,dup,SP114901,1,,887649
13,32992277,38710794,dup,SP114903,1,,5718517
3,33207392,33920182,dup,SP114901,1,,712790
8,114066751,116846082,dup,SP114898,1,,2779331
6,149587194,152306334,dup,SP114903,1,,2719140
10,46259207,47145739,del,SP114900,1,,886532
8,104494448,110815056,dup,SP114901,1,,6320608
13,79633164,85721166,dup,SP114903,1,,6088002
11,89474871,91945465,dup,SP114901,1,,2470594
4,15228910,15682252,dup,SP114903,1,,453342
1,16541776,17031220,dup,SP114901,1,,489444
19,22104599,24099308,dup,SP114903,1,,1994709
14,48729651,48978109,dup,SP114903,1,,248458
4,90622992,93454778,dup,SP114901,1,,2831786
17,58508618,58604461,dup,SP114901,1,,95843
10,89584002,91360331,del,SP114898,1,,1776329
14,89562161,90224320,dup,SP114903,1,,662159
10,93888387,93956264,del,SP114900,1,,67877
8,73560155,75098003,dup,SP114900,1,,1537848
16,18755194,21138357,dup,SP114900,1,,2383163
3,179327082,179978145,dup,SP114901,1,,651063
1,110774238,114095750,dup,SP114903,1,,3321512
9,119825838,121423291,dup,SP114903,1,,1597453
8,54250594,54521760,dup,SP114901,1,,271166
6,31326612,42118226,dup,SP114898,1,,10791614
10,130013682,135498976,del,SP114903,1,,5485294
18,47734007,51890228,dup,SP114903,1,,4156221
5,42451042,43407326,dup,SP114901,1,,956284
2,67825219,71423648,dup,SP114898,1,,3598429
8,104469959,109690467,dup,SP114900,1,,5220508
3,178869413,179324326,dup,SP114898,1,,454913
4,102712542,109815683,dup,SP114901,1,,7103141
10,130104395,135498976,del,SP114900,1,,5394581
4,39778913,52703678,dup,SP114900,1,,12924765
3,184965699,189394613,dup,SP114900,1,,4428914
2,165338886,168767662,dup,SP114898,1,,3428776
6,50403342,52924206,dup,SP114901,1,,2520864
17,58604594,59735681,dup,SP114901,1,,1131087
11,17266176,17619379,dup,SP114900,1,,353203
20,5879187,6109215,dup,SP114900,1,,230028
17,78057575,79998948,dup,SP114900,1,,1941373
12,20455306,21771903,dup,SP114900,1,,1316597
15,42982819,47016876,dup,SP114898,1,,4034057
9,76355347,76651368,dup,SP114900,1,,296021
6,114271094,115213052,dup,SP114901,1,,941958
12,20455306,21771903,dup,SP114901,1,,1316597
7,18113008,18854120,dup,SP114903,1,,741112
3,167123597,169844294,dup,SP114901,1,,2720697
11,87916627,89820516,dup,SP114898,1,,1903889
5,51048981,53028307,dup,SP114900,1,,1979326
5,98846605,99096457,dup,SP114903,1,,249852
1,110769205,114098499,dup,SP114900,1,,3329294
11,87936024,90383337,dup,SP114900,1,,2447313
4,101912362,102711561,dup,SP114898,1,,799199
6,2651987,2997650,dup,SP114898,1,,345663
6,125588528,126789514,dup,SP114900,1,,1200986
21,28695655,30839539,dup,SP114901,1,,2143884
10,22809187,22817861,del,SP114901,1,,8674
5,9600971,11360893,dup,SP114903,1,,1759922
7,3510606,4302076,dup,SP114903,1,,791470
13,45327552,45548000,dup,SP114903,1,,220448
8,116849186,124934256,dup,SP114898,1,,8085070
10,5307855,5322475,del,SP114898,1,,14620
5,155024755,155333254,dup,SP114898,1,,308499
1,3082503,3640340,dup,SP114900,1,,557837
11,59979932,61988127,dup,SP114900,1,,2008195
15,41982203,42439376,dup,SP114901,1,,457173
4,67926138,68310250,dup,SP114903,1,,384112
8,54251834,54521760,dup,SP114898,1,,269926
17,38043649,38242053,dup,SP114900,1,,198404
12,99128001,100797485,dup,SP114901,1,,1669484
8,69055982,71801821,dup,SP114900,1,,2745839
3,26607463,29672551,dup,SP114898,1,,3065088
7,2344203,2694343,dup,SP114900,1,,350140
14,89562161,90224320,dup,SP114898,1,,662159
3,149993738,153655111,dup,SP114901,1,,3661373
16,3594986,4985608,dup,SP114901,1,,1390622
7,155000929,159126177,del,SP114900,1,,4125248
10,20743148,20758830,dup,SP114898,1,,15682
6,125591008,126765715,dup,SP114898,1,,1174707
8,104273096,104491836,dup,SP114901,1,,218740
11,45944029,48188748,dup,SP114900,1,,2244719
8,139579533,139880175,dup,SP114898,1,,300642
2,55650572,59849513,dup,SP114901,1,,4198941
20,48226845,48560396,dup,SP114900,1,,333551
12,58838688,59074568,dup,SP114903,1,,235880
1,204248960,208426693,dup,SP114901,1,,4177733
2,121994279,122255585,dup,SP114900,1,,261306
13,39207475,39453273,dup,SP114898,1,,245798
1,120545166,146921928,dup,SP114898,1,,26376762
21,40929648,41558278,dup,SP114900,1,,628630
8,99975934,104289773,dup,SP114900,1,,4313839
7,32890237,58053551,dup,SP114900,1,,25163314
16,2529997,3575270,dup,SP114901,1,,1045273
3,147308161,148812260,dup,SP114898,1,,1504099
8,51634799,51849723,dup,SP114903,1,,214924
4,116320991,116522637,dup,SP114900,1,,201646
4,170790018,170950243,dup,SP114901,1,,160225
17,63343928,65362552,dup,SP114900,1,,2018624
10,93888810,93955310,del,SP114898,1,,66500
13,89362784,94729739,del,SP114901,1,,5366955
8,99921345,104233155,dup,SP114898,1,,4311810
7,123110103,123978144,dup,SP114901,1,,868041
4,67301854,67682225,dup,SP114900,1,,380371
8,30368430,31634768,dup,SP114903,1,,1266338
14,34234231,35024310,dup,SP114901,1,,790079
9,12192428,15055921,dup,SP114901,1,,2863493
14,71210756,71467070,dup,SP114900,1,,256314
11,133767275,134945373,dup,SP114903,1,,1178098
4,187283642,187641261,dup,SP114900,1,,357619
2,190583187,192437930,dup,SP114901,1,,1854743
14,85004963,85859503,dup,SP114898,1,,854540
6,149589005,152199431,dup,SP114901,1,,2610426
2,190583187,192429694,dup,SP114900,1,,1846507
15,78764285,102429349,dup,SP114900,1,,23665064
12,622058,963195,dup,SP114901,1,,341137
14,35705740,36026342,dup,SP114900,1,,320602
14,106351079,107289436,dup,SP114901,1,,938357
10,130428175,130432991,del,SP114898,1,,4816
4,153766065,154285858,dup,SP114901,1,,519793
4,146387147,146930015,dup,SP114898,1,,542868
2,46624599,48825139,dup,SP114901,1,,2200540
3,159754475,166139334,dup,SP114903,1,,6384859
10,85204716,85210486,del,SP114898,1,,5770
2,165338886,166485191,dup,SP114901,1,,1146305
8,99919268,104247880,dup,SP114903,1,,4328612
5,125450818,126089726,dup,SP114898,1,,638908
9,116755638,117575925,dup,SP114903,1,,820287
5,53032440,54809761,dup,SP114898,1,,1777321
2,32046814,45591461,dup,SP114901,1,,13544647
3,151851455,153651962,dup,SP114900,1,,1800507
4,89604087,93454778,dup,SP114903,1,,3850691
4,96892392,102261253,dup,SP114901,1,,5368861
8,69055982,70716367,dup,SP114898,1,,1660385
3,151856800,153655608,dup,SP114903,1,,1798808
7,17780891,18104972,dup,SP114901,1,,324081
2,212925372,235535223,dup,SP114900,1,,22609851
2,69475954,70175327,dup,SP114900,1,,699373
5,59825361,64220624,dup,SP114900,1,,4395263
9,116764283,117575925,dup,SP114900,1,,811642
21,40924107,41532330,dup,SP114903,1,,608223
3,149993738,150949211,dup,SP114898,1,,955473
3,129815549,132181439,dup,SP114900,1,,2365890
14,48730580,49001707,dup,SP114900,1,,271127
2,69475954,70211961,dup,SP114901,1,,736007
11,45935253,46776176,dup,SP114898,1,,840923
6,144944469,145937438,dup,SP114903,1,,992969
2,89954498,91683361,dup,SP114901,1,,1728863
3,42861456,44504319,dup,SP114900,1,,1642863
3,40049628,42843545,dup,SP114901,1,,2793917
8,66661074,68185759,dup,SP114900,1,,1524685
3,150952752,151853704,dup,SP114898,1,,900952
4,74218621,74774171,dup,SP114900,1,,555550
17,63343928,65441699,dup,SP114901,1,,2097771
12,121664117,123190230,dup,SP114903,1,,1526113
8,18632503,24180215,del,SP114900,1,,5547712
3,55491682,57871932,dup,SP114900,1,,2380250
3,129803006,132181439,dup,SP114901,1,,2378433
7,17779637,18104972,dup,SP114903,1,,325335
4,79314833,79999280,dup,SP114903,1,,684447
5,125419268,126083713,dup,SP114900,1,,664445
8,121148287,124754423,dup,SP114901,1,,3606136
4,8033326,8328088,dup,SP114901,1,,294762
15,20001861,22751868,dup,SP114898,1,,2750007
16,15048643,17454624,dup,SP114900,1,,2405981
7,4307664,5761554,dup,SP114898,1,,1453890
1,41858282,46118184,dup,SP114900,1,,4259902
20,5878139,6122435,dup,SP114901,1,,244296
8,71668528,73527034,dup,SP114898,1,,1858506
3,180900591,182719503,dup,SP114900,1,,1818912
2,73776582,76028349,dup,SP114901,1,,2251767
9,116764283,117575925,dup,SP114901,1,,811642
1,154683421,155979831,dup,SP114900,1,,1296410
2,183758656,184196610,dup,SP114898,1,,437954
8,104478452,110815056,dup,SP114898,1,,6336604
19,19611053,21319391,dup,SP114901,1,,1708338
4,146386977,146930015,dup,SP114900,1,,543038
2,178293004,181205966,dup,SP114901,1,,2912962
12,118860723,120843621,dup,SP114903,1,,1982898
2,89412857,96382469,dup,SP114903,1,,6969612
7,76771243,78460104,dup,SP114903,1,,1688861
1,66574258,66782265,dup,SP114900,1,,208007
1,151656326,152126467,dup,SP114903,1,,470141
12,77779661,78041107,dup,SP114900,1,,261446
1,21087927,23793637,dup,SP114898,1,,2705710
3,150956902,151850968,dup,SP114900,1,,894066
14,28624351,28785637,dup,SP114900,1,,161286
7,18854186,48783897,dup,SP114903,1,,29929711
13,109109821,109355570,dup,SP114898,1,,245749
12,5049569,5798796,dup,SP114901,1,,749227
2,122312420,122868749,dup,SP114898,1,,556329
11,2186335,2576895,dup,SP114900,1,,390560
5,156645436,160125122,dup,SP114900,1,,3479686
11,65082673,66530108,dup,SP114903,1,,1447435
2,194347717,196597707,dup,SP114901,1,,2249990
20,60054447,62917506,dup,SP114901,1,,2863059
1,16543346,17031220,dup,SP114903,1,,487874
4,15079799,15682252,dup,SP114900,1,,602453
1,36498076,37028577,dup,SP114898,1,,530501
6,20241410,26177882,dup,SP114900,1,,5936472
8,121112877,124754423,dup,SP114900,1,,3641546
4,149180903,159751275,dup,SP114898,1,,10570372
16,58902286,61285990,dup,SP114900,1,,2383704
1,3085186,3640340,dup,SP114903,1,,555154
2,25195444,25820664,dup,SP114903,1,,625220
16,76452531,90292766,del,SP114903,1,,13840235
1,169939809,172528943,dup,SP114901,1,,2589134
5,34204362,38472541,dup,SP114898,1,,4268179
3,150954156,151853704,dup,SP114903,1,,899548
9,119826602,121423291,dup,SP114900,1,,1596689
12,30166796,30349661,dup,SP114901,1,,182865
1,99956076,102783755,dup,SP114901,1,,2827679
12,68863228,69734375,dup,SP114903,1,,871147
10,94426,5299938,del,SP114903,1,,5205512
1,110787893,114095750,dup,SP114901,1,,3307857
5,54819938,55276907,dup,SP114903,1,,456969
2,107782642,109227140,dup,SP114901,1,,1444498
2,121995638,122311860,dup,SP114898,1,,316222
4,160638356,167875283,dup,SP114900,1,,7236927
4,78884141,79010520,dup,SP114903,1,,126379
18,41315475,42256693,dup,SP114900,1,,941218
8,144994916,146065452,dup,SP114900,1,,1070536
1,195398667,197018398,dup,SP114901,1,,1619731
8,73534687,75097080,dup,SP114898,1,,1562393
2,25194522,25821689,dup,SP114898,1,,627167
6,141863841,142155517,dup,SP114901,1,,291676
3,159756451,166041612,dup,SP114901,1,,6285161
6,156710670,158193725,dup,SP114903,1,,1483055
16,32203681,47608247,dup,SP114900,1,,15404566
6,14937987,18546505,dup,SP114901,1,,3608518
13,95377689,95785721,dup,SP114903,1,,408032
11,71568062,76528773,dup,SP114901,1,,4960711
7,134189985,134578255,dup,SP114903,1,,388270
15,56528913,56795638,dup,SP114898,1,,266725
6,2651987,4893787,dup,SP114903,1,,2241800
12,45656751,47125031,dup,SP114903,1,,1468280
3,45771601,47259460,dup,SP114900,1,,1487859
12,59279660,61669400,dup,SP114900,1,,2389740
12,66744983,68874330,dup,SP114900,1,,2129347
2,166486320,168767662,dup,SP114901,1,,2281342
7,86497184,90913045,dup,SP114901,1,,4415861
14,89565340,90232466,dup,SP114900,1,,667126
2,166506555,168788681,dup,SP114900,1,,2282126
12,99210851,100820743,dup,SP114903,1,,1609892
14,52556183,52790347,dup,SP114901,1,,234164
11,78587152,79982644,dup,SP114900,1,,1395492
21,34532398,35165167,dup,SP114903,1,,632769
17,18555403,21670341,dup,SP114900,1,,3114938
3,178590283,178862866,dup,SP114901,1,,272583
8,54251834,54521760,dup,SP114903,1,,269926
1,66638913,66803548,dup,SP114898,1,,164635
3,9021348,9881041,dup,SP114898,1,,859693
2,170141210,172887888,dup,SP114900,1,,2746678
14,77160569,77739345,dup,SP114903,1,,578776
7,17778782,18104972,dup,SP114900,1,,326190
8,51635186,51857712,dup,SP114901,1,,222526
2,175226883,175487602,dup,SP114900,1,,260719
2,239751529,240439399,dup,SP114898,1,,687870
10,94426,5299938,del,SP114900,1,,5205512
2,17373466,23644081,dup,SP114900,1,,6270615
5,12019023,12889305,dup,SP114900,1,,870282
16,46467107,47622189,dup,SP114903,1,,1155082
12,116299642,116843507,dup,SP114900,1,,543865
14,71469512,77141290,dup,SP114900,1,,5671778
1,6742281,7558789,dup,SP114898,1,,816508
12,66744199,68863166,dup,SP114903,1,,2118967
7,132779383,136705967,dup,SP114901,1,,3926584
8,51635875,51837880,dup,SP114900,1,,202005
6,2651987,4876723,dup,SP114901,1,,2224736
12,5050383,5800576,dup,SP114898,1,,750193
4,187653446,191043168,dup,SP114901,1,,3389722
2,119675587,120044686,dup,SP114901,1,,369099
5,143976648,144283505,dup,SP114901,1,,306857
8,110858989,114064764,dup,SP114898,1,,3205775
2,146383688,148165153,dup,SP114901,1,,1781465
6,50403342,52647700,dup,SP114900,1,,2244358
11,87931027,89473629,dup,SP114901,1,,1542602
7,67500854,67714699,dup,SP114898,1,,213845
22,48232066,51222100,dup,SP114903,1,,2990034
12,43941387,47126507,dup,SP114900,1,,3185120
2,14072695,17411883,dup,SP114901,1,,3339188
6,116577306,117989145,dup,SP114901,1,,1411839
5,12017265,12889305,dup,SP114901,1,,872040
4,59143816,59400284,dup,SP114903,1,,256468
4,67931581,68309646,dup,SP114900,1,,378065
8,30326612,31747059,dup,SP114898,1,,1420447
19,22104847,24099308,dup,SP114900,1,,1994461
1,45291708,45763976,dup,SP114901,1,,472268
17,68925507,71766450,dup,SP114901,1,,2840943
17,26159197,27356949,dup,SP114900,1,,1197752
15,78766629,102429349,dup,SP114901,1,,23662720
17,76605122,76821276,dup,SP114898,1,,216154
7,123105827,123977345,dup,SP114898,1,,871518
5,22527778,22774422,dup,SP114903,1,,246644
1,46765185,48812953,del,SP114903,1,,2047768
5,22535225,22774422,dup,SP114898,1,,239197
3,107471059,107894386,dup,SP114900,1,,423327
17,77545371,78660226,dup,SP114901,1,,1114855
14,35724639,37446855,dup,SP114898,1,,1722216
8,54251834,54521760,dup,SP114900,1,,269926
21,9412503,14415944,dup,SP114898,1,,5003441
7,72352626,89743197,dup,SP114900,1,,17390571
7,18113008,18852253,dup,SP114898,1,,739245
2,192439872,192977214,dup,SP114901,1,,537342
13,39217400,39453273,dup,SP114903,1,,235873
5,137966643,140343191,dup,SP114900,1,,2376548
6,25997458,26177882,dup,SP114898,1,,180424
12,43946204,45025692,dup,SP114903,1,,1079488
3,126602009,129639823,dup,SP114901,1,,3037814
8,73565199,75098003,dup,SP114901,1,,1532804
10,70794239,70796932,del,SP114898,1,,2693
11,46057073,48196752,dup,SP114901,1,,2139679
5,34464575,36856801,dup,SP114901,1,,2392226
8,104250293,104473638,dup,SP114903,1,,223345
4,90362857,90611665,dup,SP114900,1,,248808
4,93455625,96872336,dup,SP114898,1,,3416711
10,111962102,111977189,dup,SP114901,1,,15087
4,8033326,8329130,dup,SP114900,1,,295804
3,195724651,197901582,del,SP114901,1,,2176931
10,24556356,24558277,del,SP114898,1,,1921
4,110387787,116318639,dup,SP114900,1,,5930852
12,66740636,68845940,dup,SP114901,1,,2105304
1,169705411,172531672,dup,SP114898,1,,2826261
16,58902286,67626230,dup,SP114901,1,,8723944
11,65078806,66529117,dup,SP114898,1,,1450311
5,144285453,146855963,dup,SP114901,1,,2570510
4,96893798,101903663,dup,SP114903,1,,5009865
16,67719184,70747977,dup,SP114901,1,,3028793
19,53377037,54903067,dup,SP114900,1,,1526030
10,91360395,91548298,del,SP114898,1,,187903
4,174637879,187283642,dup,SP114901,1,,12645763
7,4303934,5763201,dup,SP114903,1,,1459267
11,90599460,91974552,dup,SP114900,1,,1375092
2,181583739,182174501,dup,SP114901,1,,590762
2,67810419,69430372,dup,SP114900,1,,1619953
9,77272813,79497759,dup,SP114898,1,,2224946
7,72795176,74167356,dup,SP114898,1,,1372180
2,163403303,165328475,dup,SP114900,1,,1925172
1,149024552,152127455,dup,SP114901,1,,3102903
2,240451234,243185679,dup,SP114901,1,,2734445
21,46056784,46428137,dup,SP114898,1,,371353
8,139889287,140682446,dup,SP114898,1,,793159
2,55100196,55650512,dup,SP114901,1,,550316
6,57824691,58666731,dup,SP114898,1,,842040
4,138643167,138962929,dup,SP114900,1,,319762
1,18306684,20802277,dup,SP114903,1,,2495593
19,4143413,4765081,dup,SP114901,1,,621668
1,154019922,155334090,dup,SP114898,1,,1314168
6,42126399,42891577,dup,SP114900,1,,765178
4,49224499,53766691,dup,SP114901,1,,4542192
1,183759410,184856204,dup,SP114901,1,,1096794
6,14937812,18550228,dup,SP114900,1,,3612416
18,287252,1260172,dup,SP114901,1,,972920
4,138637865,138952704,dup,SP114903,1,,314839
4,146937467,159715678,dup,SP114903,1,,12778211
3,64769945,64925383,dup,SP114901,1,,155438
12,69803051,71226480,dup,SP114901,1,,1423429
11,66533469,67602951,dup,SP114901,1,,1069482
3,1056328,3477857,dup,SP114898,1,,2421529
16,4988946,5254451,dup,SP114901,1,,265505
3,40048084,42799459,dup,SP114898,1,,2751375
10,114449329,115909735,del,SP114903,1,,1460406
2,229883335,231701319,dup,SP114903,1,,1817984
21,40924107,41558278,dup,SP114898,1,,634171
4,71786276,74218621,dup,SP114898,1,,2432345
1,148549707,151653312,dup,SP114903,1,,3103605
18,11860,1260172,dup,SP114903,1,,1248312
1,18297407,22726948,dup,SP114900,1,,4429541
12,58838688,59077062,dup,SP114898,1,,238374
14,35033839,35699408,dup,SP114900,1,,665569
14,48716525,49018423,dup,SP114901,1,,301898
7,67715374,72337791,dup,SP114900,1,,4622417
2,45725591,46623947,dup,SP114901,1,,898356
10,57033299,57035385,del,SP114898,1,,2086
6,134586626,144936943,dup,SP114903,1,,10350317
1,6742904,7530921,dup,SP114900,1,,788017
1,183759410,184854390,dup,SP114900,1,,1094980
6,50574024,52925277,dup,SP114903,1,,2351253
8,129988219,139585176,dup,SP114903,1,,9596957
17,52404060,52745045,dup,SP114898,1,,340985
1,8910347,14992342,del,SP114903,1,,6081995
5,51048981,53028307,dup,SP114898,1,,1979326
18,41315475,42256693,dup,SP114901,1,,941218
2,240451234,243185679,dup,SP114900,1,,2734445
3,171670277,172561317,dup,SP114900,1,,891040
6,14938771,18546505,dup,SP114898,1,,3607734
12,43949853,47126507,dup,SP114901,1,,3176654
8,139586110,139889287,dup,SP114903,1,,303177
4,106070226,110904502,dup,SP114903,1,,4834276
4,69830733,71783522,dup,SP114898,1,,1952789
2,23809510,31348427,dup,SP114901,1,,7538917
12,70084577,71226480,dup,SP114898,1,,1141903
16,32013747,46430793,dup,SP114898,1,,14417046
12,16329144,20455123,dup,SP114901,1,,4125979
17,44215075,44310164,dup,SP114900,1,,95089
17,59740122,63343172,dup,SP114900,1,,3603050
4,67926536,68312401,dup,SP114901,1,,385865
2,73785046,76029871,dup,SP114898,1,,2244825
7,151926747,152321354,dup,SP114898,1,,394607
3,126597961,129639823,dup,SP114900,1,,3041862
12,106642762,108911718,dup,SP114901,1,,2268956
9,117576479,119826510,dup,SP114900,1,,2250031
4,85000868,89603085,dup,SP114903,1,,4602217
4,67301854,67682225,dup,SP114901,1,,380371
4,110386036,127327915,dup,SP114901,1,,16941879
15,74832344,78760918,dup,SP114900,1,,3928574
4,52704030,53767336,dup,SP114900,1,,1063306
16,13980739,17454885,dup,SP114901,1,,3474146
22,43255609,51222100,dup,SP114901,1,,7966491
3,167132031,169845285,dup,SP114900,1,,2713254
16,7487378,9297422,dup,SP114898,1,,1810044
8,23797763,24058590,del,SP114898,1,,260827
19,57517611,59118096,dup,SP114901,1,,1600485
2,170578701,172886148,dup,SP114898,1,,2307447
2,14075917,17373202,dup,SP114900,1,,3297285
3,139049804,139578860,dup,SP114900,1,,529056
2,170593690,172886148,dup,SP114903,1,,2292458
1,20803771,21087291,dup,SP114903,1,,283520
12,99128001,100797485,dup,SP114900,1,,1669484
11,71527696,76544076,dup,SP114903,1,,5016380
8,66608500,68185759,dup,SP114898,1,,1577259
12,24738178,27683816,dup,SP114903,1,,2945638
20,6974928,7275124,dup,SP114898,1,,300196
11,78587152,79924584,dup,SP114901,1,,1337432
11,59979932,61991891,dup,SP114903,1,,2011959
4,170950887,173071063,dup,SP114901,1,,2120176
17,77254622,77542643,dup,SP114898,1,,288021
10,114251130,114446340,del,SP114900,1,,195210
6,149589005,152307706,dup,SP114900,1,,2718701
14,35033839,35723798,dup,SP114901,1,,689959
12,118304661,120836349,dup,SP114898,1,,2531688
17,77255810,77543561,dup,SP114903,1,,287751
12,77765594,78039091,dup,SP114901,1,,273497
2,23809510,31352656,dup,SP114900,1,,7543146
4,170788533,170943881,dup,SP114900,1,,155348
3,89722772,90501810,dup,SP114898,1,,779038
14,35698185,37445399,dup,SP114903,1,,1747214
13,79633164,85721167,dup,SP114898,1,,6088003
13,104458106,105046877,dup,SP114903,1,,588771
7,63208193,67014800,dup,SP114898,1,,3806607
8,144994916,146065173,dup,SP114901,1,,1070257
6,64474384,64709929,dup,SP114900,1,,235545
4,15079799,15682252,dup,SP114901,1,,602453
4,109825415,110387757,dup,SP114900,1,,562342
4,170948619,173071063,dup,SP114900,1,,2122444
8,114066751,121131150,dup,SP114901,1,,7064399
7,129174189,129529112,dup,SP114898,1,,354923
14,99141023,102537253,dup,SP114901,1,,3396230
6,117994158,135626348,dup,SP114901,1,,17632190
7,53143320,53336581,dup,SP114903,1,,193261
3,139050136,139581172,dup,SP114903,1,,531036
5,66968259,67520226,dup,SP114901,1,,551967
4,160630206,167876599,dup,SP114901,1,,7246393
10,46259207,47145739,del,SP114903,1,,886532
1,110786319,114095750,dup,SP114898,1,,3309431
11,66448044,67610071,dup,SP114900,1,,1162027
4,138643167,138968868,dup,SP114901,1,,325701
18,35989149,41315087,dup,SP114901,1,,5325938
7,134189024,134558299,dup,SP114898,1,,369275
8,124755460,138722906,dup,SP114901,1,,13967446
5,40929418,41250433,dup,SP114903,1,,321015
1,3082503,3629960,dup,SP114898,1,,547457
20,29421323,29649222,dup,SP114898,1,,227899
16,9327140,9728066,dup,SP114898,1,,400926
2,71424143,73773869,dup,SP114900,1,,2349726
4,129149781,138638761,dup,SP114901,1,,9488980
8,124755460,134761876,dup,SP114900,1,,10006416
10,93888387,93962597,del,SP114903,1,,74210
2,76029871,85285238,dup,SP114901,1,,9255367
3,45771601,47251284,dup,SP114901,1,,1479683
3,144683750,147286684,dup,SP114900,1,,2602934
12,114746560,116844125,dup,SP114901,1,,2097565
2,86168308,87333490,dup,SP114901,1,,1165182
6,52650325,64470069,dup,SP114900,1,,11819744
18,31195424,32930731,dup,SP114901,1,,1735307
5,38472617,39196275,dup,SP114901,1,,723658
3,147305251,148812260,dup,SP114903,1,,1507009
14,77141547,77741971,dup,SP114900,1,,600424
10,89494531,89583792,del,SP114898,1,,89261
5,98857520,99096156,dup,SP114901,1,,238636
2,235538094,236073866,dup,SP114898,1,,535772
13,104458875,105046877,dup,SP114898,1,,588002
3,89584498,90483384,dup,SP114901,1,,898886
4,138953267,146387147,dup,SP114903,1,,7433880
9,12192428,15059442,dup,SP114900,1,,2867014
8,66663792,68224944,dup,SP114903,1,,1561152
8,68186367,68564370,dup,SP114900,1,,378003
4,159760729,160630206,dup,SP114900,1,,869477
4,73051366,74770221,dup,SP114901,1,,1718855
2,107732918,109227140,dup,SP114898,1,,1494222
1,149020368,149430611,dup,SP114898,1,,410243
2,32046814,37277997,dup,SP114900,1,,5231183
6,141863841,142154583,dup,SP114900,1,,290742
5,59826759,64221597,dup,SP114903,1,,4394838
11,67603284,70380055,dup,SP114901,1,,2776771
3,33206420,33920182,dup,SP114898,1,,713762
8,139579964,139914569,dup,SP114900,1,,334605
1,195398667,197020319,dup,SP114900,1,,1621652
2,73767897,76050473,dup,SP114903,1,,2282576
3,107471059,107894386,dup,SP114901,1,,423327
2,31349572,32044482,dup,SP114901,1,,694910
7,61056172,61559662,dup,SP114898,1,,503490
12,121664117,123172353,dup,SP114898,1,,1508236
12,59279660,61669400,dup,SP114901,1,,2389740
20,56361769,59470380,dup,SP114901,1,,3108611
21,40925998,41558278,dup,SP114901,1,,632280
8,85329695,87980088,dup,SP114898,1,,2650393
2,87361162,89908711,dup,SP114901,1,,2547549
2,171679655,171971787,dup,SP114901,1,,292132
2,146383688,148165153,dup,SP114900,1,,1781465
11,87936024,89820516,dup,SP114903,1,,1884492
9,124113554,124412098,dup,SP114901,1,,298544
2,126107839,126501349,dup,SP114901,1,,393510
12,121828648,125876457,dup,SP114900,1,,4047809
9,34339283,35108943,dup,SP114898,1,,769660
4,146387234,146937366,dup,SP114903,1,,550132
18,31195424,32929376,dup,SP114900,1,,1733952
4,187645064,191043168,dup,SP114900,1,,3398104
7,5765564,6862560,dup,SP114903,1,,1096996
13,96071970,96361009,dup,SP114898,1,,289039
10,4640671,4644670,del,SP114898,1,,3999
1,204250248,208425917,dup,SP114900,1,,4175669
4,53055891,53266735,dup,SP114903,1,,210844
12,95383715,95838422,dup,SP114898,1,,454707
3,171670277,172374033,dup,SP114898,1,,703756
20,6972615,7276970,dup,SP114903,1,,304355
4,58787376,58938414,dup,SP114898,1,,151038
6,149587810,152200363,dup,SP114898,1,,2612553
2,53840278,54505213,dup,SP114898,1,,664935
12,58838688,59074758,dup,SP114900,1,,236070
4,102708235,109824217,dup,SP114900,1,,7115982
6,56768148,58469923,dup,SP114903,1,,1701775
1,6742281,7557152,dup,SP114901,1,,814871
3,157861911,159141602,dup,SP114903,1,,1279691
3,26604461,29708067,dup,SP114901,1,,3103606
4,69830733,71783522,dup,SP114903,1,,1952789
13,89358288,89361328,del,SP114901,1,,3040
2,240441268,243185679,dup,SP114898,1,,2744411
11,67610425,71568062,dup,SP114900,1,,3957637
20,56357134,60054447,dup,SP114903,1,,3697313
12,114747533,116299468,dup,SP114900,1,,1551935
1,203737223,207328547,dup,SP114898,1,,3591324
3,178858315,179319655,dup,SP114903,1,,461340
15,20001861,22574918,dup,SP114901,1,,2573057
3,123469660,123809989,dup,SP114903,1,,340329
2,85271558,86147050,dup,SP114900,1,,875492
1,26643523,28327218,dup,SP114903,1,,1683695
7,61056172,61665437,dup,SP114903,1,,609265
9,4947510,5293796,dup,SP114901,1,,346286
3,147294985,148446464,dup,SP114901,1,,1151479
21,28696476,30840513,dup,SP114900,1,,2144037
1,154711226,155979831,dup,SP114901,1,,1268605
2,235538094,236073866,dup,SP114900,1,,535772
3,144707811,147286684,dup,SP114901,1,,2578873
20,6113147,6972615,dup,SP114900,1,,859468
9,119826453,121423291,dup,SP114901,1,,1596838
9,4952801,5293796,dup,SP114900,1,,340995
5,12016840,12893338,dup,SP114903,1,,876498
13,94731102,94732112,del,SP114901,1,,1010
17,61362681,61925498,dup,SP114901,1,,562817
20,6972615,7275967,dup,SP114901,1,,303352
5,140343372,141530696,dup,SP114900,1,,1187324
12,58838688,59074758,dup,SP114901,1,,236070
16,18798540,21102707,dup,SP114901,1,,2304167
5,98846605,99091447,dup,SP114898,1,,244842
14,36026738,37566224,dup,SP114900,1,,1539486
16,9272315,9736881,dup,SP114903,1,,464566
2,235538094,236073866,dup,SP114901,1,,535772
18,43725904,48563574,dup,SP114900,1,,4837670
4,102270353,102711561,dup,SP114901,1,,441208
2,76051484,89408644,dup,SP114903,1,,13357160
3,139049804,139571662,dup,SP114898,1,,521858
19,36927932,37377159,dup,SP114903,1,,449227
11,66533469,71526126,dup,SP114903,1,,4992657
12,68846196,69799224,dup,SP114901,1,,953028
4,102203824,102703729,dup,SP114900,1,,499905
2,70211961,71423648,dup,SP114900,1,,1211687
16,9563525,11319912,dup,SP114901,1,,1756387
14,34234231,35024310,dup,SP114898,1,,790079
2,23649702,23806335,dup,SP114898,1,,156633
10,114255551,114446340,del,SP114898,1,,190789
9,1409581,3068157,dup,SP114900,1,,1658576
4,69830733,71783522,dup,SP114900,1,,1952789
1,14994678,16050547,del,SP114903,1,,1055869
1,186260311,190343439,dup,SP114900,1,,4083128
11,65082673,66530108,dup,SP114901,1,,1447435
1,26648534,28319484,dup,SP114898,1,,1670950
12,69792216,71227175,dup,SP114900,1,,1434959
13,77484700,79632467,dup,SP114903,1,,2147767
12,120841632,121641668,dup,SP114898,1,,800036
2,65852377,67727152,dup,SP114901,1,,1874775
4,173089919,174636038,dup,SP114901,1,,1546119
8,51637825,51827773,dup,SP114898,1,,189948
18,15078713,20308123,dup,SP114898,1,,5229410
2,122463183,122878843,dup,SP114903,1,,415660
7,67016951,67498152,dup,SP114900,1,,481201
16,32382604,46463082,dup,SP114903,1,,14080478
9,109577271,109932654,dup,SP114901,1,,355383
6,12243114,12632982,dup,SP114901,1,,389868
16,9742295,15034279,dup,SP114900,1,,5291984
3,40042282,42834876,dup,SP114903,1,,2792594
4,187286121,187647832,dup,SP114901,1,,361711
20,56361769,60053650,dup,SP114898,1,,3691881
14,35724209,37446855,dup,SP114901,1,,1722646
11,70381563,71567871,dup,SP114901,1,,1186308
7,14213412,17778782,dup,SP114903,1,,3565370
5,42454085,43645783,dup,SP114900,1,,1191698
4,93455625,96872336,dup,SP114901,1,,3416711
1,22735341,23788994,dup,SP114900,1,,1053653
19,53377037,54902759,dup,SP114898,1,,1525722
2,179464527,181453769,dup,SP114898,1,,1989242
15,41982203,42445554,dup,SP114898,1,,463351
4,102712542,138638761,dup,SP114898,1,,35926219
5,53032440,54882305,dup,SP114901,1,,1849865
3,26604461,29701734,dup,SP114903,1,,3097273
9,124112337,124421965,dup,SP114900,1,,309628
7,94199607,132779383,dup,SP114900,1,,38579776
7,89743287,94196192,dup,SP114900,1,,4452905
19,22104847,24099308,dup,SP114898,1,,1994461
4,93455625,96892392,dup,SP114903,1,,3436767
8,146065452,146301152,dup,SP114901,1,,235700
6,6990457,7270629,dup,SP114901,1,,280172
10,89526348,89542058,del,SP114901,1,,15710
3,42808503,44483574,dup,SP114898,1,,1675071
7,110470629,111085586,dup,SP114901,1,,614957
16,73773,4991277,dup,SP114903,1,,4917504
3,126597961,129639823,dup,SP114903,1,,3041862
4,74779596,76285336,dup,SP114898,1,,1505740
2,239739439,240442825,dup,SP114901,1,,703386
2,172887888,173115660,dup,SP114901,1,,227772
4,74774171,75374304,dup,SP114901,1,,600133
4,96892392,102203409,dup,SP114900,1,,5311017
16,67591016,70755851,dup,SP114900,1,,3164835
13,19021248,21545542,dup,SP114901,1,,2524294
11,133767275,134860957,dup,SP114900,1,,1093682
4,138643167,138978408,dup,SP114898,1,,335241
9,34348408,34946454,dup,SP114903,1,,598046
14,71215380,71467070,dup,SP114901,1,,251690
1,151556652,152106853,dup,SP114898,1,,550201
8,110858989,114064764,dup,SP114901,1,,3205775
18,41317460,42257069,dup,SP114903,1,,939609
13,21547832,22172265,dup,SP114901,1,,624433
20,6974928,7275124,dup,SP114900,1,,300196
13,95787496,104455010,dup,SP114903,1,,8667514
18,15067124,20308123,dup,SP114903,1,,5240999
20,60056337,62917506,dup,SP114903,1,,2861169
3,126597961,129639823,dup,SP114898,1,,3041862
6,42120903,42946864,dup,SP114898,1,,825961
1,183759410,184854390,dup,SP114898,1,,1094980
12,95839344,99209435,dup,SP114903,1,,3370091
10,117433008,117464416,dup,SP114898,1,,31408
6,134585518,141861393,dup,SP114900,1,,7275875
4,53064083,53266735,dup,SP114898,1,,202652
1,152130539,154019182,dup,SP114900,1,,1888643
4,146933473,153762277,dup,SP114901,1,,6828804
7,110001807,110468213,dup,SP114901,1,,466406
7,139014074,139469178,dup,SP114898,1,,455104
4,146933473,153773254,dup,SP114900,1,,6839781
1,20762896,21087291,dup,SP114898,1,,324395
8,75098003,85281390,dup,SP114898,1,,10183387
15,61253714,65070234,dup,SP114901,1,,3816520
3,178869413,179338260,dup,SP114900,1,,468847
2,239739439,240442825,dup,SP114900,1,,703386
11,71568213,76532548,dup,SP114900,1,,4964335
5,28955133,29192184,dup,SP114903,1,,237051
18,51889512,52407476,dup,SP114898,1,,517964
17,18554513,21670341,dup,SP114901,1,,3115828
5,59826759,64221597,dup,SP114898,1,,4394838
7,67500854,67714699,dup,SP114900,1,,213845
2,121465524,121993301,dup,SP114903,1,,527777
6,19496611,20006828,dup,SP114900,1,,510217
6,26182872,28580593,dup,SP114898,1,,2397721
2,62966758,65851574,dup,SP114901,1,,2884816
2,172888509,173124040,dup,SP114900,1,,235531
4,74222748,74779289,dup,SP114898,1,,556541
2,31352741,32044482,dup,SP114900,1,,691741
12,43949853,47126507,dup,SP114898,1,,3176654
2,148639212,149922663,dup,SP114901,1,,1283451
2,88362940,96382469,dup,SP114898,1,,8019529
2,178293004,181205966,dup,SP114900,1,,2912962
8,32939786,33276407,del,SP114900,1,,336621
2,212643178,212887731,dup,SP114900,1,,244553
3,121510969,124959878,dup,SP114900,1,,3448909
6,42117679,42891577,dup,SP114903,1,,773898
10,3848844,4782841,del,SP114901,1,,933997
10,22346585,22807282,del,SP114901,1,,460697
12,21840309,27706834,dup,SP114901,1,,5866525
8,68186367,68539564,dup,SP114898,1,,353197
2,119676029,120046905,dup,SP114900,1,,370876
3,139050136,139578860,dup,SP114901,1,,528724
8,69055982,73565199,dup,SP114903,1,,4509217
2,183742312,184196610,dup,SP114901,1,,454298
17,78660946,79998948,dup,SP114901,1,,1338002
2,45592032,45724914,dup,SP114901,1,,132882
21,34532398,35167520,dup,SP114898,1,,635122
1,143245708,145734261,dup,SP114900,1,,2488553
12,5049569,5800609,dup,SP114900,1,,751040
17,77240122,77544297,dup,SP114901,1,,304175
17,47051352,58508582,dup,SP114901,1,,11457230
17,26162372,27356949,dup,SP114901,1,,1194577
4,67682225,67925429,dup,SP114903,1,,243204
21,39649549,40925998,dup,SP114900,1,,1276449
18,18570235,20308123,dup,SP114900,1,,1737888
12,45026274,45655740,dup,SP114903,1,,629466
4,77075187,77806986,dup,SP114901,1,,731799
7,67500854,67715418,dup,SP114901,1,,214564
8,7668889,8090144,dup,SP114901,1,,421255
10,89543778,91360649,del,SP114901,1,,1816871
11,66530108,71566615,dup,SP114898,1,,5036507
12,120856874,121641668,dup,SP114903,1,,784794
7,129174432,129529112,dup,SP114901,1,,354680
4,174638471,187283558,dup,SP114900,1,,12645087
3,30874961,33205996,dup,SP114898,1,,2331035
2,177533880,178886723,dup,SP114898,1,,1352843
5,23557361,25418965,dup,SP114901,1,,1861604
12,100823387,118860608,dup,SP114903,1,,18037221
7,147561714,154999108,dup,SP114900,1,,7437394
6,28964847,31219862,dup,SP114898,1,,2255015
12,70114699,71231223,dup,SP114903,1,,1116524
14,79998294,85859503,dup,SP114903,1,,5861209
7,86966304,94213363,dup,SP114903,1,,7247059
6,134181663,134585527,dup,SP114903,1,,403864
7,34918,2343975,dup,SP114900,1,,2309057
12,118889559,121827744,dup,SP114901,1,,2938185
3,96066172,96429207,dup,SP114900,1,,363035
9,77274112,79484775,dup,SP114903,1,,2210663
19,36927932,37378825,dup,SP114898,1,,450893
2,76029871,85271522,dup,SP114900,1,,9241651
12,21840309,27707391,dup,SP114900,1,,5867082
9,4947995,5293796,dup,SP114903,1,,345801
7,63208423,67014800,dup,SP114903,1,,3806377
3,171664619,172478679,dup,SP114903,1,,814060
7,2694452,17778032,dup,SP114900,1,,15083580
1,22738317,23788994,dup,SP114901,1,,1050677
2,192436018,196597707,dup,SP114900,1,,4161689
1,179554228,179890655,dup,SP114901,1,,336427
8,68564440,69055275,dup,SP114900,1,,490835
16,32013747,46430793,dup,SP114901,1,,14417046
5,156644624,158639599,dup,SP114901,1,,1994975
10,37272251,37277870,del,SP114898,1,,5619
9,131788129,132049503,dup,SP114903,1,,261374
2,121993458,122461336,dup,SP114903,1,,467878
14,56087148,59061469,dup,SP114901,1,,2974321
5,164356732,164635897,dup,SP114898,1,,279165
1,169943179,172528943,dup,SP114900,1,,2585764
1,195398667,197018398,dup,SP114898,1,,1619731
4,93455625,96872336,dup,SP114900,1,,3416711
10,90203342,90335074,del,SP114900,1,,131732
6,42118226,42885664,dup,SP114901,1,,767438
22,42273842,43255397,dup,SP114901,1,,981555
5,59828755,64220624,dup,SP114901,1,,4391869
18,14660604,15374117,dup,SP114901,1,,713513
11,119238381,119611734,dup,SP114903,1,,373353
17,61927473,62635921,dup,SP114901,1,,708448
5,102867875,106789764,dup,SP114901,1,,3921889
22,26990807,27159406,dup,SP114901,1,,168599
2,70222153,71423648,dup,SP114901,1,,1201495
22,48245138,51222100,dup,SP114898,1,,2976962
4,69830733,71783522,dup,SP114901,1,,1952789
14,35033839,35697982,dup,SP114903,1,,664143
18,51890863,52407476,dup,SP114901,1,,516613
2,85285712,86166301,dup,SP114901,1,,880589
12,99128001,100797485,dup,SP114898,1,,1669484
1,18297407,20762197,dup,SP114898,1,,2464790
16,73773,2513420,del,SP114900,1,,2439647
10,91362107,91479288,del,SP114901,1,,117181
13,85721167,87727280,dup,SP114903,1,,2006113
6,20009979,26177882,dup,SP114901,1,,6167903
18,23862555,26686324,dup,SP114901,1,,2823769
4,182708670,182859352,dup,SP114898,1,,150682
3,1055263,3477857,dup,SP114900,1,,2422594
6,56864218,57823419,dup,SP114898,1,,959201
14,99141023,102537253,dup,SP114900,1,,3396230
5,101183009,101461122,dup,SP114900,1,,278113
19,36569010,39549653,dup,SP114901,1,,2980643
9,109572678,109951159,dup,SP114900,1,,378481
9,32137678,32333058,dup,SP114900,1,,195380
3,166452217,167127289,dup,SP114900,1,,675072
7,61056172,61760329,dup,SP114900,1,,704157
8,104292013,104469083,dup,SP114900,1,,177070
6,91532613,114265754,dup,SP114901,1,,22733141
4,160644545,191043168,dup,SP114903,1,,30398623
4,154288126,159735581,dup,SP114901,1,,5447455
10,114260483,114446340,del,SP114903,1,,185857
2,178887060,179462347,dup,SP114898,1,,575287
6,142824130,145205895,dup,SP114900,1,,2381765
3,40042282,42858920,dup,SP114900,1,,2816638
5,36876333,39191206,dup,SP114900,1,,2314873
16,13980739,16574349,dup,SP114898,1,,2593610
2,119675587,120038495,dup,SP114898,1,,362908
1,154057802,154711080,dup,SP114901,1,,653278
14,34234231,35024310,dup,SP114903,1,,790079
20,56199626,59484644,dup,SP114900,1,,3285018
7,63209770,67014800,dup,SP114900,1,,3805030
13,113240778,113477317,dup,SP114903,1,,236539
9,34348408,34966978,dup,SP114901,1,,618570
2,31407476,32051761,dup,SP114903,1,,644285
7,138926709,139568132,dup,SP114900,1,,641423
21,9412503,14406818,dup,SP114903,1,,4994315
8,85282857,85329516,dup,SP114898,1,,46659
8,68566930,69055275,dup,SP114903,1,,488345
14,48716525,49017217,dup,SP114898,1,,300692
5,42454085,43407326,dup,SP114903,1,,953241
6,50403342,52905501,dup,SP114898,1,,2502159
3,159756451,166139334,dup,SP114900,1,,6382883
6,64474384,64709929,dup,SP114898,1,,235545
5,102867875,106788039,dup,SP114900,1,,3920164
8,104476458,110815056,dup,SP114903,1,,6338598
19,22104602,24099308,dup,SP114901,1,,1994706
3,148447756,149493663,dup,SP114901,1,,1045907
4,109816956,110378257,dup,SP114901,1,,561301
5,141533062,143975945,dup,SP114901,1,,2442883
20,60054447,62917506,dup,SP114898,1,,2863059
7,67016951,67498152,dup,SP114901,1,,481201
9,77274424,79501546,dup,SP114901,1,,2227122
22,42273842,43252280,dup,SP114900,1,,978438
11,17255750,17619379,dup,SP114901,1,,363629
14,77146725,77728735,dup,SP114898,1,,582010
4,74774198,77075188,dup,SP114900,1,,2300990
20,59484714,62917506,dup,SP114900,1,,3432792
3,178869413,179324326,dup,SP114901,1,,454913
7,23110209,30315222,dup,SP114900,1,,7205013
4,77075277,77756690,dup,SP114900,1,,681413
3,180900591,182727097,dup,SP114903,1,,1826506
5,34217393,38435130,dup,SP114903,1,,4217737
14,93544174,95699662,dup,SP114901,1,,2155488
3,42858920,44483574,dup,SP114901,1,,1624654
5,53032440,54819871,dup,SP114903,1,,1787431
8,66613267,69054721,dup,SP114901,1,,2441454
9,97690501,98307128,dup,SP114901,1,,616627
16,7486525,9272015,dup,SP114903,1,,1785490
3,96061280,96420177,dup,SP114901,1,,358897
18,13657962,14660464,dup,SP114901,1,,1002502
4,76286113,76605321,dup,SP114898,1,,319208
3,121532024,122032436,dup,SP114901,1,,500412
4,53768812,57105985,dup,SP114900,1,,3337173
7,132780163,136706535,dup,SP114900,1,,3926372
4,67300802,67677814,dup,SP114903,1,,377012
3,30645119,30874928,dup,SP114898,1,,229809
1,186255374,190342876,dup,SP114898,1,,4087502
6,141867459,142147719,dup,SP114898,1,,280260
1,169954973,172530903,dup,SP114903,1,,2575930
5,144291559,146855963,dup,SP114900,1,,2564404
3,148447756,149493663,dup,SP114900,1,,1045907
18,41315087,42267397,dup,SP114898,1,,952310
16,9729771,11297084,dup,SP114898,1,,1567313
2,59849990,62011340,dup,SP114901,1,,2161350
2,67739726,69430372,dup,SP114901,1,,1690646
8,144994916,146065173,dup,SP114903,1,,1070257
4,77811051,90310492,dup,SP114901,1,,12499441
5,53032440,54852608,dup,SP114900,1,,1820168
1,154015852,154693901,dup,SP114903,1,,678049
5,101181613,101461122,dup,SP114903,1,,279509
11,2178330,2576895,dup,SP114901,1,,398565
19,53377037,54900248,dup,SP114903,1,,1523211
17,18589120,21503147,dup,SP114903,1,,2914027
2,181642212,182174501,dup,SP114900,1,,532289
10,8419135,8425812,dup,SP114901,1,,6677
17,68925507,71769081,dup,SP114898,1,,2843574
5,1281693,1959751,dup,SP114903,1,,678058
12,77779661,78039091,dup,SP114903,1,,259430
8,7693089,8089900,dup,SP114900,1,,396811
6,28585581,28963248,dup,SP114898,1,,377667
15,54881180,55011051,dup,SP114901,1,,129871
3,33207322,33920062,dup,SP114903,1,,712740
6,166005689,166194698,dup,SP114898,1,,189009
6,114265587,117989145,dup,SP114900,1,,3723558
6,114265754,117989145,dup,SP114898,1,,3723391
6,134196415,134583752,dup,SP114900,1,,387337
6,130801767,131511553,dup,SP114900,1,,709786
6,156720020,158373622,dup,SP114900,1,,1653602
6,20006886,20240295,dup,SP114900,1,,233409
14,89560430,90164159,dup,SP114901,1,,603729
7,95975028,96248708,dup,SP114901,1,,273680
6,114271094,117994158,dup,SP114903,1,,3723064
12,68877237,69792025,dup,SP114900,1,,914788
14,71210756,71467070,dup,SP114898,1,,256314
4,138985752,146387144,dup,SP114898,1,,7401392
3,167132031,169845285,dup,SP114898,1,,2713254
2,17430657,23644081,dup,SP114901,1,,6213424
2,86151245,87171068,dup,SP114900,1,,1019823
9,34348408,34959936,dup,SP114900,1,,611528
18,18527782,20308123,dup,SP114901,1,,1780341
17,52417411,52745150,dup,SP114903,1,,327739
5,143978010,144285538,dup,SP114898,1,,307528
4,75381509,77074586,dup,SP114901,1,,1693077
19,55800329,56077272,dup,SP114898,1,,276943
3,85002977,88113663,dup,SP114898,1,,3110686
6,14938771,18544866,dup,SP114903,1,,3606095
1,183759410,184856204,dup,SP114903,1,,1096794
5,158702459,160739709,dup,SP114901,1,,2037250
3,123470192,123813469,dup,SP114901,1,,343277
2,183187314,184191882,dup,SP114903,1,,1004568
3,129803006,131842193,dup,SP114898,1,,2039187
3,107471059,107894386,dup,SP114898,1,,423327
4,77762586,90359411,dup,SP114900,1,,12596825
7,111091819,114078358,dup,SP114901,1,,2986539
5,143976648,144291559,dup,SP114903,1,,314911
4,160638356,182708213,dup,SP114898,1,,22069857
2,198924347,201278766,dup,SP114901,1,,2354419
5,34217393,36865675,dup,SP114900,1,,2648282
9,76364970,76651368,dup,SP114901,1,,286398
14,35033839,35724209,dup,SP114898,1,,690370
3,1056328,3477857,dup,SP114901,1,,2421529
16,61287012,62730517,dup,SP114900,1,,1443505
15,41987295,42439376,dup,SP114903,1,,452081
4,104908312,106066982,dup,SP114903,1,,1158670
4,53767336,57103784,dup,SP114901,1,,3336448
3,55496532,57865494,dup,SP114901,1,,2368962
3,154639154,154876994,dup,SP114903,1,,237840
16,73773,4014964,dup,SP114898,1,,3941191
20,55620602,56358006,dup,SP114901,1,,737404
17,38043343,38231853,dup,SP114903,1,,188510
11,130950139,131184615,dup,SP114901,1,,234476
8,144994916,146063308,dup,SP114898,1,,1068392
8,71913174,73563985,dup,SP114901,1,,1650811
1,149652811,151556506,dup,SP114898,1,,1903695
3,151856800,153653970,dup,SP114898,1,,1797170
9,103787631,105827336,dup,SP114903,1,,2039705
7,139569537,146782371,dup,SP114900,1,,7212834
14,77191612,77718621,dup,SP114901,1,,527009
12,17736138,18846693,dup,SP114898,1,,1110555
1,152130539,154049775,dup,SP114901,1,,1919236
11,95320808,97297854,dup,SP114901,1,,1977046
8,109690799,110858989,dup,SP114900,1,,1168190
9,96901406,100574120,dup,SP114898,1,,3672714
15,54882068,55011051,dup,SP114900,1,,128983
15,65005048,65228708,dup,SP114903,1,,223660
6,91323931,91520949,dup,SP114898,1,,197018
10,93888810,93962597,del,SP114901,1,,73787
16,22733450,23900568,dup,SP114901,1,,1167118
7,136707227,138922422,dup,SP114900,1,,2215195
6,42892834,50572655,dup,SP114903,1,,7679821
5,125447090,126086748,dup,SP114903,1,,639658
13,46578354,46894272,dup,SP114903,1,,315918
3,26607463,29675989,dup,SP114900,1,,3068526
3,1056328,3477857,dup,SP114903,1,,2421529
21,9412503,9961696,dup,SP114901,1,,549193
4,159760729,160630206,dup,SP114898,1,,869477
17,68908990,78057090,dup,SP114900,1,,9148100
8,110868457,114062008,dup,SP114900,1,,3193551
17,38043649,38231376,dup,SP114898,1,,187727
12,77765594,78038704,dup,SP114898,1,,273110
5,51048981,53028307,dup,SP114903,1,,1979326
8,139613626,141394985,dup,SP114901,1,,1781359
18,275078,1261131,dup,SP114900,1,,986053
12,106409695,108950947,dup,SP114912,1,,2541252
8,129138272,132942751,dup,SP114918,1,,3804479
1,149652811,205570406,dup,SP114908,1,,55917595
5,175052014,180701594,dup,SP114908,1,,5649580
11,55652963,56677622,dup,SP114917,1,,1024659
1,205636334,207075171,dup,SP114910,1,,1438837
6,29852679,31285748,dup,SP114920,1,,1433069
12,123167344,126537580,dup,SP114914,1,,3370236
12,106438975,108950947,dup,SP114920,1,,2511972
1,113715350,114141775,dup,SP114904,1,,426425
8,55924884,56313943,dup,SP114914,1,,389059
1,36485004,52721653,dup,SP114908,1,,16236649
17,8283379,17234181,dup,SP114914,1,,8950802
7,35489,43905719,dup,SP114910,1,,43870230
18,32482762,40231502,dup,SP114908,1,,7748740
15,24671051,31339049,dup,SP114904,1,,6667998
10,34958841,37172229,dup,SP114906,1,,2213388
10,37172229,38019644,dup,SP114920,1,,847415
10,109080262,135498976,dup,SP114908,1,,26418714
1,92386880,112470215,dup,SP114912,1,,20083335
11,57935480,131153641,dup,SP114914,1,,73218161
6,28112713,29839360,dup,SP114912,1,,1726647
6,31311362,32444078,dup,SP114920,1,,1132716
5,54444621,55463726,dup,SP114912,1,,1019105
6,120929573,122352141,dup,SP114904,1,,1422568
18,32041904,40231241,dup,SP114914,1,,8189337
6,32452361,32656608,dup,SP114906,1,,204247
6,55135902,55284698,dup,SP114920,1,,148796
12,32495246,32778913,dup,SP114904,1,,283667
11,49214048,51098366,dup,SP114910,1,,1884318
18,40231502,43608511,del,SP114916,1,,3377009
10,35793263,37165771,dup,SP114904,1,,1372508
3,6003582,197872160,dup,SP114904,1,,191868578
11,129625118,134944160,dup,SP114904,1,,5319042
11,49214048,50778214,dup,SP114904,1,,1564166
18,12007,18545353,dup,SP114906,1,,18533346
3,25931689,26393940,dup,SP114912,1,,462251
10,34894899,35792573,dup,SP114920,1,,897674
19,107958,24512098,dup,SP114906,1,,24404140
6,32504085,32655213,dup,SP114908,1,,151128
6,55086407,55259617,dup,SP114914,1,,173210
10,35793263,37165771,dup,SP114916,1,,1372508
6,24864254,28112713,dup,SP114920,1,,3248459
12,104001399,106096157,dup,SP114920,1,,2094758
1,12847291,12899057,dup,SP114920,1,,51766
13,71887449,78789286,dup,SP114916,1,,6901837
11,131128,30327162,dup,SP114910,1,,30196034
1,113715350,114141635,dup,SP114914,1,,426285
3,6003395,7036747,dup,SP114916,1,,1033352
17,8283379,17234181,dup,SP114916,1,,8950802
1,113715350,114141635,dup,SP114917,1,,426285
10,37172244,38019644,dup,SP114906,1,,847400
12,32495246,32779938,dup,SP114912,1,,284692
5,65686059,132006641,dup,SP114912,1,,66320582
8,133329296,139370480,dup,SP114920,1,,6041184
1,36194819,53011697,dup,SP114918,1,,16816878
12,122641420,126158135,dup,SP114920,1,,3516715
21,39864584,41608372,dup,SP114910,1,,1743788
12,130361719,133839206,dup,SP114904,1,,3477487
6,11470694,21485478,dup,SP114908,1,,10014784
15,34038737,102505693,dup,SP114910,1,,68466956
6,46007845,49125037,dup,SP114908,1,,3117192
1,28578385,52606488,dup,SP114916,1,,24028103
3,26364202,197872160,dup,SP114914,1,,171507958
10,34247385,34498398,dup,SP114906,1,,251013
6,145145848,146083967,dup,SP114904,1,,938119
6,32657020,37903273,dup,SP114914,1,,5246253
6,120929573,128514053,dup,SP114914,1,,7584480
10,37169295,38019592,dup,SP114916,1,,850297
6,6914906,11331129,dup,SP114912,1,,4416223
6,31286339,31311355,dup,SP114920,1,,25016
10,35793263,37165771,dup,SP114910,1,,1372508
1,113715350,114141775,dup,SP114916,1,,426425
8,139405412,140661285,dup,SP114908,1,,1255873
12,71833681,104010660,dup,SP114914,1,,32176979
21,15229345,18822262,dup,SP114920,1,,3592917
10,64679505,66842771,dup,SP114912,1,,2163266
5,54548830,55464684,dup,SP114917,1,,915854
12,122641420,126157346,dup,SP114912,1,,3515926
17,2339198,2665633,dup,SP114904,1,,326435
6,18345635,21479514,dup,SP114917,1,,3133879
7,43908866,159122682,dup,SP114920,1,,115213816
6,55275755,57301152,dup,SP114904,1,,2025397
6,29842117,32453853,dup,SP114904,1,,2611736
12,129212519,129889867,dup,SP114910,1,,677348
8,56316741,126874215,dup,SP114910,1,,70557474
12,122622637,126158657,dup,SP114917,1,,3536020
10,38019644,48654049,dup,SP114908,1,,10634405
6,138820724,145025472,dup,SP114920,1,,6204748
12,108951814,110993791,dup,SP114917,1,,2041977
11,175241,11276082,dup,SP114912,1,,11100841
15,31339151,33464534,dup,SP114904,1,,2125383
21,41789960,42251261,dup,SP114906,1,,461301
5,65665913,175052459,dup,SP114918,1,,109386546
6,146086192,171050238,dup,SP114904,1,,24964046
1,28439813,35988627,dup,SP114906,1,,7548814
18,58022624,68658738,dup,SP114906,1,,10636114
13,71885336,74356683,dup,SP114910,1,,2471347
12,37857819,71918578,dup,SP114912,1,,34060759
18,68666474,78002730,dup,SP114906,1,,9336256
1,57961554,57987673,dup,SP114920,1,,26119
12,71994530,104010020,dup,SP114906,1,,32015490
1,92390758,112470215,dup,SP114920,1,,20079457
11,57989697,134944160,dup,SP114918,1,,76954463
11,175241,49206325,dup,SP114918,1,,49031084
6,29842698,32447364,dup,SP114917,1,,2604666
1,8510577,9658809,del,SP114908,1,,1148232
12,72513196,104014473,dup,SP114917,1,,31501277
16,25322657,25328350,dup,SP114920,1,,5693
3,61466,5913291,dup,SP114904,1,,5851825
6,24864254,28111536,dup,SP114917,1,,3247282
10,66694248,79997370,dup,SP114904,1,,13303122
15,34038737,102505693,dup,SP114912,1,,68466956
12,104001399,106096157,dup,SP114918,1,,2094758
6,49125846,51904041,dup,SP114916,1,,2778195
13,71894040,78785779,dup,SP114914,1,,6891739
6,14038231,18344412,dup,SP114917,1,,4306181
1,113715350,114141775,dup,SP114912,1,,426425
11,30685685,134944160,dup,SP114908,1,,104258475
12,37857819,71832567,dup,SP114914,1,,33974748
6,104694332,105353475,dup,SP114916,1,,659143
21,9412503,18822919,dup,SP114914,1,,9410416
6,24864254,28112562,dup,SP114918,1,,3248308
12,104010660,108950947,dup,SP114906,1,,4940287
11,49215431,50778848,dup,SP114916,1,,1563417
6,146086192,162114707,dup,SP114918,1,,16028515
6,122360537,128514053,dup,SP114912,1,,6153516
12,106443988,108950726,dup,SP114918,1,,2506738
6,32657334,37903273,dup,SP114910,1,,5245939
14,19083154,107289436,dup,SP114904,1,,88206282
7,37445,159122682,dup,SP114908,1,,159085237
3,6003582,25930204,dup,SP114912,1,,19926622
7,35489,43904219,dup,SP114904,1,,43868730
11,129625118,134944160,dup,SP114910,1,,5319042
6,49125037,51895712,dup,SP114918,1,,2770675
17,2332777,2665633,dup,SP114920,1,,332856
5,175055515,180704307,dup,SP114910,1,,5648792
12,126157970,129208448,dup,SP114918,1,,3050478
1,54676,876067,dup,SP114904,1,,821391
6,5473796,11331129,dup,SP114904,1,,5857333
12,129247643,129894864,dup,SP114912,1,,647221
13,78789272,115109852,dup,SP114917,1,,36320580
12,129895292,130358919,dup,SP114912,1,,463627
8,49481503,132941814,dup,SP114917,1,,83460311
6,116267166,120641833,dup,SP114916,1,,4374667
12,129211019,133839206,dup,SP114906,1,,4628187
13,19020917,31775774,dup,SP114918,1,,12754857
12,130361719,133839206,dup,SP114912,1,,3477487
1,8524340,9658809,del,SP114906,1,,1134469
3,26401306,45949954,dup,SP114912,1,,19548648
3,45951602,46323939,dup,SP114912,1,,372337
1,8510577,9658809,del,SP114916,1,,1148232
1,28578385,35355381,dup,SP114912,1,,6776996
1,28578385,35657285,dup,SP114914,1,,7078900
12,37857819,71918578,dup,SP114904,1,,34060759
1,36636854,52576555,dup,SP114920,1,,15939701
1,205636334,207075171,dup,SP114908,1,,1438837
1,36681458,52606488,dup,SP114906,1,,15925030
6,18347412,21479514,dup,SP114920,1,,3132102
5,65686059,132105801,dup,SP114908,1,,66419742
8,47378797,55924884,dup,SP114918,1,,8546087
21,25431181,41608372,dup,SP114908,1,,16177191
5,175058851,180704307,dup,SP114904,1,,5645456
3,5914259,6002768,dup,SP114908,1,,88509
12,129211019,129795404,dup,SP114920,1,,584385
1,146970568,149024552,dup,SP114917,1,,2053984
12,37857819,71918578,dup,SP114908,1,,34060759
8,47378797,49469523,dup,SP114917,1,,2090726
12,129212519,129795404,dup,SP114916,1,,582885
19,107958,27764330,dup,SP114910,1,,27656372
14,19083154,107289436,dup,SP114912,1,,88206282
6,24864254,28111114,dup,SP114906,1,,3246860
21,41789960,42251261,dup,SP114918,1,,461301
6,146086192,171050238,dup,SP114916,1,,24964046
6,8978564,11450339,dup,SP114918,1,,2471775
8,125431834,127382601,dup,SP114912,1,,1950767
6,29913042,32504681,dup,SP114918,1,,2591639
6,6454771,11450339,dup,SP114908,1,,4995568
17,2344493,2665633,dup,SP114910,1,,321140
6,29858660,32452517,dup,SP114916,1,,2593857
1,35360861,36193919,dup,SP114918,1,,833058
10,34247385,34498398,dup,SP114920,1,,251013
12,123189208,126256711,dup,SP114908,1,,3067503
21,9412503,18817528,dup,SP114917,1,,9405025
1,113715350,114141775,dup,SP114910,1,,426425
6,6391883,21479514,dup,SP114910,1,,15087631
8,126878608,127541678,dup,SP114910,1,,663070
6,51901450,98795356,dup,SP114908,1,,46893906
8,56316340,125388989,dup,SP114918,1,,69072649
12,106438975,123167138,dup,SP114914,1,,16728163
12,106438975,108950726,dup,SP114908,1,,2511751
1,205636334,207075171,dup,SP114912,1,,1438837
10,66694248,66840395,dup,SP114908,1,,146147
6,104694332,105354446,dup,SP114917,1,,660114
11,129625118,134944160,dup,SP114912,1,,5319042
11,49214048,50782777,dup,SP114912,1,,1568729
21,36975473,41608372,dup,SP114916,1,,4632899
5,175055515,180701594,dup,SP114914,1,,5646079
12,32495246,32730558,dup,SP114910,1,,235312
21,45082365,48101335,dup,SP114920,1,,3018970
6,9795592,11331129,dup,SP114916,1,,1535537
20,29425717,29643839,dup,SP114920,1,,218122
6,120929573,128814504,dup,SP114918,1,,7884931
11,50782777,55134153,dup,SP114917,1,,4351376
12,110974890,122674190,dup,SP114910,1,,11699300
6,32657020,37903273,dup,SP114916,1,,5246253
13,78786901,115109852,dup,SP114914,1,,36322951
12,129212519,129893947,dup,SP114914,1,,681428
5,55465552,65665913,dup,SP114917,1,,10200361
18,12007,40231502,dup,SP114920,1,,40219495
13,74870592,78785779,dup,SP114910,1,,3915187
21,41789960,42281670,dup,SP114920,1,,491710
17,8283379,17233402,dup,SP114912,1,,8950023
1,118429694,146970568,dup,SP114908,1,,28540874
6,55133342,55259137,dup,SP114910,1,,125795
8,47378797,49469523,dup,SP114920,1,,2090726
1,117868790,118024957,dup,SP114910,1,,156167
2,210262554,210386295,dup,SP114920,1,,123741
5,65686059,131511637,dup,SP114904,1,,65825578
6,41070216,51865858,dup,SP114910,1,,10795642
6,28111536,29841915,dup,SP114906,1,,1730379
10,38020337,66692350,dup,SP114910,1,,28672013
6,18349234,21484927,dup,SP114912,1,,3135693
6,6914906,11325777,dup,SP114906,1,,4410871
13,78786901,115109852,dup,SP114910,1,,36322951
20,26306351,62955706,dup,SP114912,1,,36649355
6,11445378,12622739,dup,SP114916,1,,1177361
10,35793263,37165771,dup,SP114914,1,,1372508
14,19083154,107289436,dup,SP114918,1,,88206282
6,51873614,55086339,dup,SP114914,1,,3212725
6,12622739,14038231,dup,SP114904,1,,1415492
13,19020917,31774060,dup,SP114914,1,,12753143
6,14044568,18345635,dup,SP114906,1,,4301067
13,49663915,87408123,dup,SP114906,1,,37744208
12,126296990,129212519,dup,SP114908,1,,2915529
5,65686059,131511637,dup,SP114910,1,,65825578
16,25117706,25129143,dup,SP114920,1,,11437
21,41789960,42251261,dup,SP114917,1,,461301
5,175055515,180704307,dup,SP114916,1,,5648792
8,127394134,132941814,dup,SP114912,1,,5547680
19,108003,27745982,dup,SP114918,1,,27637979
8,55926304,56313943,dup,SP114918,1,,387639
18,33678972,40231502,dup,SP114918,1,,6552530
6,104693827,105352312,dup,SP114908,1,,658485
3,6003805,25980417,dup,SP114914,1,,19976612
8,47378797,49799268,dup,SP114916,1,,2420471
6,29841544,32502037,dup,SP114908,1,,2660493
6,18342134,21479514,dup,SP114918,1,,3137380
18,43604379,78002730,dup,SP114918,1,,34398351
5,132295488,175052459,dup,SP114920,1,,42756971
10,66694248,88327407,dup,SP114910,1,,21633159
6,14044568,18346792,dup,SP114920,1,,4302224
6,49125846,51865858,dup,SP114914,1,,2740012
12,71918578,104001220,dup,SP114918,1,,32082642
9,10469,141033723,dup,SP114906,1,,141023254
21,45082365,48101335,dup,SP114906,1,,3018970
8,47120426,47212791,dup,SP114908,1,,92365
12,104001220,106095632,dup,SP114912,1,,2094412
12,108950947,123166371,dup,SP114918,1,,14215424
6,18349234,21479514,dup,SP114914,1,,3130280
6,104694332,105354446,dup,SP114914,1,,660114
6,46007845,51873614,dup,SP114904,1,,5865769
6,51919900,98859194,dup,SP114912,1,,46939294
6,49125846,51899824,dup,SP114917,1,,2773978
16,85364,34613363,dup,SP114918,1,,34527999
3,6003395,197872160,dup,SP114908,1,,191868765
6,41070216,46004698,dup,SP114908,1,,4934482
22,29300306,31218133,dup,SP114920,1,,1917827
13,49663915,71882912,dup,SP114918,1,,22218997
10,66696934,106540909,dup,SP114920,1,,39843975
12,129212819,129888822,dup,SP114908,1,,676003
6,104694716,105352312,dup,SP114918,1,,657596
10,42526835,64678682,dup,SP114912,1,,22151847
12,37857819,71918578,dup,SP114910,1,,34060759
6,151171458,160987539,dup,SP114908,1,,9816081
4,97884,25628002,dup,SP114906,1,,25530118
6,58076042,58771458,dup,SP114904,1,,695416
1,148180135,205570406,dup,SP114912,1,,57390271
6,104694716,105352312,dup,SP114912,1,,657596
6,32444096,32655213,dup,SP114920,1,,211117
6,11445378,12580740,dup,SP114912,1,,1135362
1,92398969,112470215,dup,SP114906,1,,20071246
12,130361719,133839206,dup,SP114910,1,,3477487
3,5914259,6003395,dup,SP114917,1,,89136
5,54394787,55464522,dup,SP114904,1,,1069735
1,146961650,147993975,dup,SP114920,1,,1032325
8,47157749,47212791,dup,SP114904,1,,55042
12,32546165,32779690,dup,SP114908,1,,233525
14,19083154,107289436,dup,SP114914,1,,88206282
17,19956856,79998834,dup,SP114918,1,,60041978
12,106438975,108949283,dup,SP114904,1,,2510308
17,19799630,79998834,dup,SP114920,1,,60199204
5,55464684,65665913,dup,SP114904,1,,10201229
1,205636334,207075171,dup,SP114906,1,,1438837
15,34037447,102505693,dup,SP114906,1,,68468246
4,97884,25659608,dup,SP114914,1,,25561724
12,32440243,32798665,dup,SP114918,1,,358422
9,10469,141033723,dup,SP114912,1,,141023254
1,35988858,36675482,dup,SP114906,1,,686624
12,106097597,106409695,dup,SP114920,1,,312098
10,34247385,34480923,dup,SP114917,1,,233538
1,117868790,118024957,dup,SP114920,1,,156167
15,20001861,33464534,dup,SP114906,1,,13462673
12,108951515,110975675,dup,SP114920,1,,2024160
1,35383875,36586077,dup,SP114920,1,,1202202
12,122679383,126158715,dup,SP114910,1,,3479332
6,55259938,57177297,dup,SP114916,1,,1917359
7,43905719,159122682,dup,SP114917,1,,115216963
1,8510577,9658809,del,SP114920,1,,1148232
6,28112562,29842615,dup,SP114917,1,,1730053
8,47120426,47139951,dup,SP114920,1,,19525
1,146961650,149357818,dup,SP114916,1,,2396168
8,61811321,132942751,dup,SP114920,1,,71131430
13,74866723,78789286,dup,SP114904,1,,3922563
22,29305061,31269579,dup,SP114916,1,,1964518
5,12041,46405351,dup,SP114910,1,,46393310
8,133329296,139370480,dup,SP114904,1,,6041184
5,132295488,175055515,dup,SP114904,1,,42760027
6,12622739,14038231,dup,SP114920,1,,1415492
12,71921663,104000792,dup,SP114912,1,,32079129
1,113715350,114141775,dup,SP114908,1,,426425
6,145145848,146083967,dup,SP114908,1,,938119
8,127580690,132941814,dup,SP114910,1,,5361124
21,25439649,36930777,dup,SP114917,1,,11491128
10,39133889,66692350,dup,SP114906,1,,27558461
12,123167138,126157346,dup,SP114918,1,,2990208
17,8283379,17234181,dup,SP114904,1,,8950802
6,46013386,49112917,dup,SP114918,1,,3099531
8,56316340,125390894,dup,SP114914,1,,69074554
6,138820724,145062594,dup,SP114916,1,,6241870
15,34020394,102505693,dup,SP114918,1,,68485299
6,49125846,51917968,dup,SP114912,1,,2792122
13,71883214,78853311,dup,SP114918,1,,6970097
12,108951515,110974890,dup,SP114912,1,,2023375
6,55259883,85913066,dup,SP114914,1,,30653183
15,20001861,33462495,dup,SP114918,1,,13460634
3,5914259,6003582,dup,SP114914,1,,89323
18,43614685,78002730,dup,SP114920,1,,34388045
8,125389193,129136454,dup,SP114918,1,,3747261
12,32178196,32779690,dup,SP114906,1,,601494
21,9412503,15023417,dup,SP114912,1,,5610914
8,140665076,141119151,dup,SP114917,1,,454075
4,97884,25628002,dup,SP114918,1,,25530118
8,141113716,146300622,dup,SP114908,1,,5186906
6,18346792,21479514,dup,SP114906,1,,3132722
12,32440243,32779690,dup,SP114917,1,,339447
6,122352585,128540940,dup,SP114904,1,,6188355
1,36636854,52576555,dup,SP114912,1,,15939701
4,106844048,107642234,dup,SP114917,1,,798186
17,19799630,79998834,dup,SP114904,1,,60199204
6,98797541,99913218,dup,SP114908,1,,1115677
11,11280690,30327162,dup,SP114912,1,,19046472
12,71921663,104010020,dup,SP114904,1,,32088357
20,29437210,62955706,dup,SP114914,1,,33518496
17,8283486,17234181,dup,SP114906,1,,8950695
4,25669138,25987977,del,SP114914,1,,318839
6,98799148,120641833,dup,SP114920,1,,21842685
1,36518726,52576555,dup,SP114914,1,,16057829
3,6003395,45975093,dup,SP114920,1,,39971698
12,106097597,106409695,dup,SP114914,1,,312098
1,155207549,205569973,dup,SP114904,1,,50362424
12,71921663,104010660,dup,SP114916,1,,32088997
6,41070216,46004698,dup,SP114920,1,,4934482
11,51191702,57446272,dup,SP114910,1,,6254570
21,45072321,48101335,dup,SP114916,1,,3029014
21,45082365,48101335,dup,SP114914,1,,3018970
6,32497870,32655548,dup,SP114904,1,,157678
10,37169295,38019644,dup,SP114914,1,,850349
2,210262554,210386295,dup,SP114912,1,,123741
7,159032892,159122682,dup,SP114904,1,,89790
12,108949557,110993791,dup,SP114904,1,,2044234
8,56316340,125389873,dup,SP114904,1,,69073533
22,29305061,31218133,dup,SP114917,1,,1913072
12,122674190,129211019,dup,SP114916,1,,6536829
2,210262554,210386295,dup,SP114910,1,,123741
6,122336379,128514053,dup,SP114916,1,,6177674
1,146974957,149357818,dup,SP114908,1,,2382861
10,37169295,38019592,dup,SP114908,1,,850297
11,30685685,49208868,dup,SP114920,1,,18523183
21,45082365,48101335,dup,SP114917,1,,3018970
6,32497870,32657201,dup,SP114910,1,,159331
21,41789960,42251261,dup,SP114912,1,,461301
1,146961650,147993975,dup,SP114912,1,,1032325
1,28578385,35399972,dup,SP114908,1,,6821587
13,19020917,31775774,dup,SP114908,1,,12754857
21,44822178,48101335,dup,SP114918,1,,3279157
6,138820724,145062594,dup,SP114904,1,,6241870
14,19083154,107289436,dup,SP114908,1,,88206282
1,8516282,9658809,del,SP114910,1,,1142527
21,45082365,48101335,dup,SP114910,1,,3018970
7,44055852,159122682,dup,SP114918,1,,115066830
6,120940794,122358547,dup,SP114912,1,,1417753
1,238797929,238825797,dup,SP114910,1,,27868
6,6454771,14044568,dup,SP114914,1,,7589797
6,51873614,55118632,dup,SP114910,1,,3245018
18,12007,33677763,dup,SP114918,1,,33665756
6,120929573,128514053,dup,SP114910,1,,7584480
6,146088443,170916550,dup,SP114914,1,,24828107
8,129134367,132942751,dup,SP114914,1,,3808384
1,149272860,205570406,dup,SP114917,1,,56297546
3,5913291,6002768,dup,SP114916,1,,89477
6,41070216,46011912,dup,SP114918,1,,4941696
10,28560610,30691503,dup,SP114917,1,,2130893
21,41789960,42251261,dup,SP114904,1,,461301
1,28578385,52576555,dup,SP114904,1,,23998170
1,117868790,118024957,dup,SP114906,1,,156167
18,12007,32041498,dup,SP114914,1,,32029491
6,28112713,29912944,dup,SP114918,1,,1800231
12,129895914,133839206,dup,SP114918,1,,3943292
8,140665076,141119151,dup,SP114918,1,,454075
21,45082365,48101335,dup,SP114912,1,,3018970
9,10469,141033723,dup,SP114908,1,,141023254
21,9412503,15027936,dup,SP114908,1,,5615433
6,12622739,14036774,dup,SP114917,1,,1414035
10,30696503,31936553,dup,SP114917,1,,1240050
6,51909525,55043236,dup,SP114916,1,,3133711
17,8283379,17234181,dup,SP114908,1,,8950802
21,41789960,42251261,dup,SP114908,1,,461301
1,146961650,149024552,dup,SP114914,1,,2062902
5,65686059,175055515,dup,SP114906,1,,109369456
7,43908866,159122682,dup,SP114916,1,,115213816
6,6454771,11331129,dup,SP114920,1,,4876358
21,9412503,18817528,dup,SP114904,1,,9405025
11,51192870,57989018,dup,SP114918,1,,6796148
11,49206916,51192393,dup,SP114918,1,,1985477
1,28578385,52576555,dup,SP114910,1,,23998170
8,47378797,55922105,dup,SP114914,1,,8543308
6,46007845,49125037,dup,SP114920,1,,3117192
16,28337920,28622957,dup,SP114920,1,,285037
20,29429945,62955706,dup,SP114906,1,,33525761
21,41789960,42251261,dup,SP114910,1,,461301
6,32657020,37903273,dup,SP114904,1,,5246253
6,12622739,14034986,dup,SP114918,1,,1412247
21,25439649,41614092,dup,SP114918,1,,16174443
7,43911730,159122682,dup,SP114912,1,,115210952
15,20001861,33464534,dup,SP114916,1,,13462673
12,129889867,133839206,dup,SP114908,1,,3949339
3,7037925,197872160,dup,SP114916,1,,190834235
7,35489,159122682,dup,SP114906,1,,159087193
21,25439649,41610796,dup,SP114906,1,,16171147
6,14044568,18347412,dup,SP114916,1,,4302844
12,106097597,106409695,dup,SP114904,1,,312098
3,25980485,26364058,dup,SP114914,1,,383573
5,132295488,175052459,dup,SP114910,1,,42756971
4,25636766,25990680,del,SP114918,1,,353914
5,12041,65665913,dup,SP114914,1,,65653872
21,15026777,18820756,dup,SP114912,1,,3793979
10,28560610,31937548,dup,SP114906,1,,3376938
5,12041,54414320,dup,SP114912,1,,54402279
8,47378797,48687774,dup,SP114910,1,,1308977
10,34247385,34498398,dup,SP114904,1,,251013
5,12041,54309477,dup,SP114920,1,,54297436
8,47157749,47212791,dup,SP114920,1,,55042
15,20001861,33462495,dup,SP114920,1,,13460634
10,34958841,35792573,dup,SP114904,1,,833732
9,10469,141048727,dup,SP114914,1,,141038258
11,175241,30327162,dup,SP114917,1,,30151921
13,49663915,71893746,dup,SP114914,1,,22229831
8,133329296,139370480,dup,SP114918,1,,6041184
9,10469,141033723,dup,SP114916,1,,141023254
6,41070216,46001357,dup,SP114906,1,,4931141
9,108423939,141099663,dup,SP114917,1,,32675724
6,24864254,28113373,dup,SP114914,1,,3249119
12,110998213,126158135,dup,SP114904,1,,15159922
6,32508783,32655336,dup,SP114918,1,,146553
8,49802564,132940896,dup,SP114916,1,,83138332
10,35799195,37169295,dup,SP114917,1,,1370100
6,24864254,28112713,dup,SP114916,1,,3248459
5,12041,65665913,dup,SP114908,1,,65653872
4,97884,23440343,dup,SP114910,1,,23342459
5,12041,54548460,dup,SP114917,1,,54536419
11,55134657,55649712,dup,SP114917,1,,515055
10,38021143,66692350,dup,SP114904,1,,28671207
9,10469,106027495,dup,SP114917,1,,106017026
20,29429945,62955706,dup,SP114918,1,,33525761
12,108951515,123120753,dup,SP114906,1,,14169238
10,28560610,31937548,dup,SP114920,1,,3376938
8,48701329,55924884,dup,SP114910,1,,7223555
8,49481503,55924884,dup,SP114904,1,,6443381
6,46004698,49125037,dup,SP114906,1,,3120339
12,126537660,129211019,dup,SP114914,1,,2673359
6,146086192,151170989,dup,SP114908,1,,5084797
6,29912517,32502037,dup,SP114914,1,,2589520
17,19799630,81152877,dup,SP114917,1,,61353247
5,55464283,65665913,dup,SP114912,1,,10201630
8,48701329,49469523,dup,SP114904,1,,768194
6,162115760,170916550,dup,SP114918,1,,8800790
1,8510577,9658707,del,SP114914,1,,1148130
4,97884,25075451,dup,SP114912,1,,24977567
1,28430757,35355381,dup,SP114918,1,,6924624
8,133329296,139370480,dup,SP114916,1,,6041184
14,19083154,107289436,dup,SP114910,1,,88206282
12,123162566,126256711,dup,SP114906,1,,3094145
19,107958,27760122,dup,SP114916,1,,27652164
8,47120426,47212791,dup,SP114918,1,,92365
21,45082365,48101335,dup,SP114904,1,,3018970
17,7620907,8280009,del,SP114908,1,,659102
10,66840937,109079688,dup,SP114908,1,,42238751
21,14532932,18817528,dup,SP114906,1,,4284596
8,127580690,129124831,dup,SP114904,1,,1544141
6,138820724,145247422,dup,SP114914,1,,6426698
8,133329296,139370480,dup,SP114917,1,,6041184
6,46007845,49125037,dup,SP114917,1,,3117192
2,210262785,210362585,dup,SP114908,1,,99800
16,32257485,33483605,dup,SP114920,1,,1226120
10,34247385,34480923,dup,SP114914,1,,233538
22,29300306,31269579,dup,SP114910,1,,1969273
6,11327021,12580740,dup,SP114906,1,,1253719
1,118429694,146944984,dup,SP114920,1,,28515290
6,105353475,120937129,dup,SP114912,1,,15583654
10,34247385,34498398,dup,SP114916,1,,251013
8,140665076,141062675,dup,SP114920,1,,397599
8,55926304,56316340,dup,SP114910,1,,390036
6,146081369,170916550,dup,SP114917,1,,24835181
1,146963438,147822234,dup,SP114918,1,,858796
1,8510577,9658707,del,SP114904,1,,1148130
10,37169295,38019644,dup,SP114910,1,,850349
1,92398969,112464376,dup,SP114918,1,,20065407
4,97884,25067305,dup,SP114917,1,,24969421
1,118429694,146963438,dup,SP114906,1,,28533744
6,120735318,122354251,dup,SP114917,1,,1618933
1,8503379,9670483,del,SP114918,1,,1167104
8,140687654,141078311,dup,SP114914,1,,390657
10,49396387,66692350,dup,SP114908,1,,17295963
5,46405411,65665913,dup,SP114910,1,,19260502
4,97884,25075451,dup,SP114916,1,,24977567
12,106095749,106406046,dup,SP114912,1,,310297
20,29432185,62955706,dup,SP114916,1,,33523521
19,108003,24573688,dup,SP114917,1,,24465685
9,10469,141033723,dup,SP114910,1,,141023254
12,106097597,106443266,dup,SP114918,1,,345669
4,97884,25075451,dup,SP114908,1,,24977567
6,14036774,18341747,dup,SP114918,1,,4304973
1,35402743,36484514,dup,SP114908,1,,1081771
6,41043148,46004698,dup,SP114904,1,,4961550
12,129238314,129888822,dup,SP114917,1,,650508
5,12041,65646257,dup,SP114918,1,,65634216
6,99904008,104694332,dup,SP114912,1,,4790324
6,12622739,14038231,dup,SP114906,1,,1415492
3,6003582,197872160,dup,SP114917,1,,191868578
19,108003,24573688,dup,SP114908,1,,24465685
6,55284772,98797708,dup,SP114920,1,,43512936
21,25439649,41608372,dup,SP114920,1,,16168723
5,12041,65665913,dup,SP114916,1,,65653872
11,131128,30327162,dup,SP114916,1,,30196034
8,47378797,125431654,dup,SP114912,1,,78052857
17,19799630,79998834,dup,SP114916,1,,60199204
8,140687654,141062675,dup,SP114916,1,,375021
8,125390894,126896886,dup,SP114904,1,,1505992
8,133329296,139370480,dup,SP114912,1,,6041184
6,11470694,12580740,dup,SP114918,1,,1110046
10,30668786,31937548,dup,SP114914,1,,1268762
12,110998213,122605297,dup,SP114917,1,,11607084
22,29305061,31273284,dup,SP114904,1,,1968223
5,65686059,132006641,dup,SP114920,1,,66320582
17,8283379,13699170,dup,SP114910,1,,5415791
18,43614685,78002730,dup,SP114914,1,,34388045
11,51098366,57437551,dup,SP114912,1,,6339185
17,2332441,2665633,dup,SP114912,1,,333192
6,49125846,51899824,dup,SP114908,1,,2773978
6,104694332,105352312,dup,SP114910,1,,657980
6,146088443,170916550,dup,SP114920,1,,24828107
1,92399424,112464376,dup,SP114908,1,,20064952
8,133325922,139396801,dup,SP114906,1,,6070879
8,133329296,139370480,dup,SP114914,1,,6041184
1,149820656,155206341,dup,SP114904,1,,5385685
15,20001861,33462495,dup,SP114917,1,,13460634
12,108951515,110955884,dup,SP114910,1,,2004369
1,92400217,112470215,dup,SP114916,1,,20069998
6,138820724,145247422,dup,SP114918,1,,6426698
6,105353475,120926954,dup,SP114918,1,,15573479
9,10469,141099663,dup,SP114918,1,,141089194
6,18345635,21479514,dup,SP114904,1,,3133879
13,78854028,115108993,dup,SP114918,1,,36254965
1,146961650,149707476,dup,SP114904,1,,2745826
4,97884,25075451,dup,SP114920,1,,24977567
21,41789960,42251261,dup,SP114916,1,,461301
3,5914259,6002768,dup,SP114920,1,,88509
9,10469,141033723,dup,SP114920,1,,141023254
10,38020337,39133033,dup,SP114906,1,,1112696
10,34894899,35792573,dup,SP114916,1,,897674
13,78789272,115109852,dup,SP114912,1,,36320580
8,140687654,141113716,dup,SP114904,1,,426062
3,61466,5913291,dup,SP114906,1,,5851825
1,121374612,146944984,dup,SP114916,1,,25570372
21,41789960,42310676,dup,SP114914,1,,520716
6,6914906,11450339,dup,SP114917,1,,4535433
22,29300306,31200051,dup,SP114912,1,,1899745
8,47120426,47212791,dup,SP114916,1,,92365
1,143123062,146944984,dup,SP114904,1,,3821922
6,41070216,46004698,dup,SP114917,1,,4934482
1,65152364,65294703,del,SP114910,1,,142339
6,32657020,37903273,dup,SP114908,1,,5246253
6,120943637,122346719,dup,SP114908,1,,1403082
11,175241,30327162,dup,SP114908,1,,30151921
12,129210129,129895363,dup,SP114918,1,,685234
6,24864254,28112562,dup,SP114912,1,,3248308
21,14532932,18817528,dup,SP114916,1,,4284596
6,51895712,55133342,dup,SP114904,1,,3237630
1,79495128,92398969,dup,SP114908,1,,12903841
11,129629001,134944160,dup,SP114917,1,,5315159
10,37169295,38021043,dup,SP114904,1,,851748
11,129625118,134944160,dup,SP114906,1,,5319042
12,126296990,129210149,dup,SP114906,1,,2913159
3,46324071,197872160,dup,SP114912,1,,151548089
6,28113373,29852633,dup,SP114920,1,,1739260
6,146086192,171050238,dup,SP114910,1,,24964046
10,106685758,109079688,del,SP114904,1,,2393930
6,138820724,144997516,dup,SP114912,1,,6176792
6,138820724,145057341,dup,SP114917,1,,6236617
10,34958841,35792573,dup,SP114914,1,,833732
10,34958841,35798191,dup,SP114917,1,,839350
17,19799630,79998834,dup,SP114914,1,,60199204
17,19799630,79998834,dup,SP114912,1,,60199204
13,91963232,104183257,dup,SP114906,1,,12220025
14,19083154,63428362,dup,SP114906,1,,44345208
1,205636334,207075171,dup,SP114916,1,,1438837
13,19020917,31774060,dup,SP114906,1,,12753143
3,5914259,6003395,dup,SP114912,1,,89136
4,23443426,25075451,dup,SP114910,1,,1632025
16,32257485,32641092,dup,SP114904,1,,383607
10,34247385,34498398,dup,SP114910,1,,251013
6,28113730,29911190,dup,SP114914,1,,1797460
5,175047966,180701594,dup,SP114912,1,,5653628
21,9412503,15226325,dup,SP114920,1,,5813822
11,131154297,134944160,dup,SP114914,1,,3789863
10,28487042,31936467,dup,SP114918,1,,3449425
11,129630442,134944160,dup,SP114920,1,,5313718
10,28560610,31937548,dup,SP114912,1,,3376938
3,5914259,6002768,dup,SP114918,1,,88509
1,148180135,207075171,dup,SP114918,1,,58895036
1,12851566,12899057,dup,SP114912,1,,47491
21,25439649,36975305,dup,SP114916,1,,11535656
3,6003395,197872160,dup,SP114918,1,,191868765
1,92387348,112468814,dup,SP114914,1,,20081466
10,28560610,31937548,dup,SP114910,1,,3376938
13,78789519,115109852,dup,SP114916,1,,36320333
1,12851566,12899057,dup,SP114904,1,,47491
8,125392671,129131491,dup,SP114914,1,,3738820
11,50781718,56666705,dup,SP114920,1,,5884987
11,49195921,50778848,dup,SP114914,1,,1582927
1,193900354,205570406,dup,SP114910,1,,11670052
12,32732506,32779690,dup,SP114910,1,,47184
6,18349234,21479514,dup,SP114916,1,,3130280
13,71885336,78789272,dup,SP114920,1,,6903936
1,8514844,9565028,del,SP114912,1,,1050184
12,104015249,106095797,dup,SP114917,1,,2080548
6,49125846,51856678,dup,SP114906,1,,2730832
21,15028535,18817528,dup,SP114908,1,,3788993
3,61466,5913291,dup,SP114920,1,,5851825
5,175058851,180704307,dup,SP114906,1,,5645456
12,71921663,104010660,dup,SP114908,1,,32088997
11,56606413,87176995,dup,SP114916,1,,30570582
8,49481503,61760521,dup,SP114920,1,,12279018
11,30685685,49214499,dup,SP114916,1,,18528814
3,61466,5913291,dup,SP114908,1,,5851825
7,43905719,159031548,dup,SP114904,1,,115125829
6,120652450,122336069,dup,SP114916,1,,1683619
6,32657020,37903273,dup,SP114920,1,,5246253
6,32657020,37903273,dup,SP114918,1,,5246253
6,32655213,37903273,dup,SP114917,1,,5248060
6,24864254,29841456,dup,SP114908,1,,4977202
20,29425717,62955706,dup,SP114908,1,,33529989
6,58141876,58771788,dup,SP114910,1,,629912
3,5914259,6002768,dup,SP114906,1,,88509
5,132295488,175050767,dup,SP114908,1,,42755279
1,118429694,121374487,dup,SP114916,1,,2944793
12,32440243,32779690,dup,SP114914,1,,339447
5,175055515,180701594,dup,SP114917,1,,5646079
6,55074356,55259883,dup,SP114916,1,,185527
17,8283379,17234181,dup,SP114918,1,,8950802
15,34038737,102505693,dup,SP114904,1,,68466956
15,34038737,102505693,dup,SP114920,1,,68466956
1,117868790,146961650,dup,SP114918,1,,29092860
12,108950947,123187507,dup,SP114908,1,,14236560
15,58499503,102505693,dup,SP114917,1,,44006190
8,47378797,48687774,dup,SP114904,1,,1308977
1,28578385,36027337,dup,SP114917,1,,7448952
17,19962412,79998834,dup,SP114906,1,,60036422
10,28560610,30667917,dup,SP114914,1,,2107307
18,53784645,57974920,dup,SP114906,1,,4190275
8,132943652,133326153,dup,SP114908,1,,382501
15,20001861,24664322,dup,SP114910,1,,4662461
10,35793263,37170407,dup,SP114920,1,,1377144
11,129623563,134944160,dup,SP114916,1,,5320597
3,46337819,197872160,dup,SP114920,1,,151534341
13,71885336,78787548,dup,SP114912,1,,6902212
5,55464283,65665913,dup,SP114920,1,,10201630
6,120652450,122343842,dup,SP114920,1,,1691392
12,32495246,32779690,dup,SP114916,1,,284444
6,55134247,55274942,dup,SP114904,1,,140695
11,30685685,49210524,dup,SP114912,1,,18524839
3,5914259,6003395,dup,SP114904,1,,89136
8,140665076,141119151,dup,SP114912,1,,454075
6,41070216,46004698,dup,SP114914,1,,4934482
7,37445,43910682,dup,SP114912,1,,43873237
1,146970568,149672642,dup,SP114906,1,,2702074
10,38020337,66692350,dup,SP114918,1,,28672013
8,133329296,139370480,dup,SP114910,1,,6041184
1,8510577,9658809,del,SP114917,1,,1148232
12,104014473,106096157,dup,SP114914,1,,2081684
11,30685685,49195756,dup,SP114914,1,,18510071
1,118429694,142919720,dup,SP114904,1,,24490026
6,14044928,18347412,dup,SP114912,1,,4302484
6,14044928,18347412,dup,SP114914,1,,4302484
7,37445,43904219,dup,SP114917,1,,43866774
5,12041,54326830,dup,SP114904,1,,54314789
6,24864254,32453853,dup,SP114910,1,,7589599
11,175241,30327162,dup,SP114914,1,,30151921
1,148180135,205570406,dup,SP114920,1,,57390271
21,45072321,48101335,dup,SP114908,1,,3029014
7,43908866,159122682,dup,SP114910,1,,115213816
17,19799630,79998834,dup,SP114908,1,,60199204
16,32257485,32902625,dup,SP114917,1,,645140
18,43614685,78002730,dup,SP114908,1,,34388045
5,12041,65665913,dup,SP114906,1,,65653872
8,129131491,132942751,dup,SP114904,1,,3811260
12,110979539,122622637,dup,SP114920,1,,11643098
6,55259524,57177297,dup,SP114910,1,,1917773
6,12641951,14038231,dup,SP114916,1,,1396280
6,51901450,98880543,dup,SP114917,1,,46979093
1,149652811,205570406,dup,SP114916,1,,55917595
20,30154237,62955706,dup,SP114917,1,,32801469
18,18549437,53784319,dup,SP114906,1,,35234882
12,37857819,71990855,dup,SP114906,1,,34133036
17,19799630,79998834,dup,SP114910,1,,60199204
6,28113373,29858256,dup,SP114916,1,,1744883
1,149707476,193899300,dup,SP114910,1,,44191824
17,8283379,17234181,dup,SP114920,1,,8950802
9,106028952,108423667,dup,SP114917,1,,2394715
10,66694248,106455820,dup,SP114917,1,,39761572
1,36488956,52606488,dup,SP114917,1,,16117532
1,118429694,146944984,dup,SP114914,1,,28515290
10,28560610,31936553,dup,SP114904,1,,3375943
12,32495246,32779690,dup,SP114920,1,,284444
10,38020337,66694248,dup,SP114914,1,,28673911
10,38019644,66692350,dup,SP114916,1,,28672706
8,140665076,141078311,dup,SP114908,1,,413235
8,47120426,47139951,dup,SP114910,1,,19525
1,118429694,146944984,dup,SP114912,1,,28515290
11,175241,30327162,dup,SP114920,1,,30151921
21,25439649,41610796,dup,SP114912,1,,16171147
6,32447451,32655180,dup,SP114917,1,,207729
6,32447451,32655180,dup,SP114912,1,,207729
6,32452587,32656608,dup,SP114916,1,,204021
15,34037447,102505693,dup,SP114916,1,,68468246
6,105353475,120943058,dup,SP114908,1,,15589583
11,131128,30327162,dup,SP114904,1,,30196034
7,37445,44054352,dup,SP114918,1,,44016907
1,118429694,149699446,dup,SP114910,1,,31269752
10,109080434,135498976,dup,SP114916,1,,26418542
12,129211019,129795604,dup,SP114904,1,,584585
7,43910351,159122682,dup,SP114914,1,,115212331
6,146086192,171050238,dup,SP114906,1,,24964046
15,20001861,24670886,dup,SP114904,1,,4669025
15,20001861,33459867,dup,SP114912,1,,13458006
5,175055515,180704307,dup,SP114918,1,,5648792
15,24664699,33464534,dup,SP114910,1,,8799835
11,30685685,49210524,dup,SP114917,1,,18524839
8,126900630,127541678,dup,SP114904,1,,641048
6,49125846,51873614,dup,SP114920,1,,2747768
6,120929573,128514053,dup,SP114906,1,,7584480
12,37857819,71918578,dup,SP114916,1,,34060759
17,8295100,17234181,dup,SP114917,1,,8939081
1,205636334,207075171,dup,SP114914,1,,1438837
13,71885336,78787548,dup,SP114917,1,,6902212
20,29429945,62955706,dup,SP114904,1,,33525761
15,20001861,33464534,dup,SP114914,1,,13462673
12,71921663,104010660,dup,SP114910,1,,32088997
5,65686059,175052459,dup,SP114917,1,,109366400
10,28560610,31937548,dup,SP114916,1,,3376938
1,117868790,118024957,dup,SP114904,1,,156167
13,49670120,115109852,dup,SP114908,1,,65439732
6,122347066,128514053,dup,SP114908,1,,6166987
5,132295729,175047644,dup,SP114912,1,,42751915
10,106611695,135498976,dup,SP114920,1,,28887281
20,30154237,62955706,dup,SP114920,1,,32801469
16,32257485,32902625,dup,SP114910,1,,645140
6,32657020,37903273,dup,SP114906,1,,5246253
10,37170407,38019644,dup,SP114918,1,,849237
8,133329296,139404764,dup,SP114908,1,,6075468
10,38027083,42525269,dup,SP114912,1,,4498186
6,46007845,49125037,dup,SP114912,1,,3117192
12,104010660,106096157,dup,SP114904,1,,2085497
16,32257485,32902625,dup,SP114916,1,,645140
12,37857819,71833681,dup,SP114918,1,,33975862
14,63428777,107289436,dup,SP114906,1,,43860659
4,97884,23429780,dup,SP114904,1,,23331896
19,108003,27752293,dup,SP114914,1,,27644290
5,65686059,175052459,dup,SP114916,1,,109366400
3,61466,5913037,dup,SP114916,1,,5851571
1,35657874,36517039,dup,SP114914,1,,859165
6,46007845,49125037,dup,SP114916,1,,3117192
1,12851566,12899057,dup,SP114910,1,,47491
6,41070216,46004698,dup,SP114912,1,,4934482
21,9412503,14474643,dup,SP114906,1,,5062140
15,34038737,58499084,dup,SP114917,1,,24460347
10,28560610,31937548,dup,SP114908,1,,3376938
6,11445378,12580740,dup,SP114920,1,,1135362
3,61466,5913291,dup,SP114914,1,,5851825
6,104694332,105352312,dup,SP114906,1,,657980
6,138820724,144998293,dup,SP114910,1,,6177569
11,50780592,56605094,dup,SP114916,1,,5824502
12,104014473,122674143,dup,SP114916,1,,18659670
6,51895712,55134483,dup,SP114920,1,,3238771
1,149272860,205570406,dup,SP114914,1,,56297546
1,149699446,205570406,dup,SP114906,1,,55870960
17,828,2665633,dup,SP114908,1,,2664805
8,47120426,47212791,dup,SP114912,1,,92365
1,92398969,112470215,dup,SP114910,1,,20071246
1,113715350,114141775,dup,SP114920,1,,426425
8,47120426,47212791,dup,SP114914,1,,92365
6,120652450,120926954,dup,SP114904,1,,274504
6,32504085,32655213,dup,SP114914,1,,151128
12,129894010,133839206,dup,SP114914,1,,3945196
12,104014473,108950947,dup,SP114910,1,,4936474
21,25439649,41608372,dup,SP114914,1,,16168723
1,117868790,118024957,dup,SP114914,1,,156167
1,117868790,118024957,dup,SP114916,1,,156167
1,118429694,146963438,dup,SP114917,1,,28533744
12,37857819,72323414,dup,SP114917,1,,34465595
8,55926304,56313943,dup,SP114904,1,,387639
10,38020337,66692350,dup,SP114917,1,,28672013
3,6003395,197872160,dup,SP114906,1,,191868765
1,92398969,112468814,dup,SP114904,1,,20069845
6,12622739,14044568,dup,SP114912,1,,1421829
6,138820724,145062594,dup,SP114908,1,,6241870
8,47380591,132942751,dup,SP114908,1,,85562160
13,78789286,115109852,dup,SP114920,1,,36320566
6,46007845,49125037,dup,SP114914,1,,3117192
10,35793263,37169295,dup,SP114918,1,,1376032
19,108003,24573688,dup,SP114920,1,,24465685
12,106439724,108951757,dup,SP114917,1,,2512033
1,117868790,118024957,dup,SP114917,1,,156167
21,39853336,41608372,dup,SP114904,1,,1755036
6,122354545,128530307,dup,SP114917,1,,6175762
21,25439649,39852079,dup,SP114904,1,,14412430
12,110975675,122622637,dup,SP114912,1,,11646962
12,130358919,133839206,dup,SP114917,1,,3480287
6,29839381,32447364,dup,SP114912,1,,2607983
11,30685685,49210524,dup,SP114910,1,,18524839
6,122346719,128514053,dup,SP114920,1,,6167334
8,47157749,47212791,dup,SP114910,1,,55042
6,160987547,170916550,dup,SP114908,1,,9929003
1,92386880,112470215,dup,SP114917,1,,20083335
6,99918660,104693438,dup,SP114908,1,,4774778
12,37857819,72632018,dup,SP114920,1,,34774199
13,78789519,115109852,dup,SP114904,1,,36320333
3,61466,5913291,dup,SP114912,1,,5851825
15,20001861,33462495,dup,SP114908,1,,13460634
6,58076042,61884449,dup,SP114916,1,,3808407
15,34039165,102505693,dup,SP114908,1,,68466528
8,47120040,47212791,dup,SP114917,1,,92751
3,45975983,46333222,dup,SP114920,1,,357239
21,14532932,18822262,dup,SP114910,1,,4289330
6,146083860,170916550,dup,SP114912,1,,24832690
16,32385012,32616372,dup,SP114908,1,,231360
8,140665076,141062675,dup,SP114910,1,,397599
21,36937888,41608372,dup,SP114917,1,,4670484
1,113715350,114141775,dup,SP114918,1,,426425
1,28578385,35382454,dup,SP114920,1,,6804069
15,34038737,102505693,dup,SP114914,1,,68466956
3,5914259,6002768,dup,SP114910,1,,88509
10,37170407,38019644,dup,SP114917,1,,849237
11,30685685,49210524,dup,SP114904,1,,18524839
12,106095906,106438975,dup,SP114917,1,,343069
12,129795604,133839206,dup,SP114916,1,,4043602
13,71885336,74356683,dup,SP114904,1,,2471347
6,29842016,32452176,dup,SP114906,1,,2610160
1,117868790,118022704,dup,SP114912,1,,153914
10,66694248,106461934,dup,SP114916,1,,39767686
3,61466,5913291,dup,SP114917,1,,5851825
6,41070216,46004698,dup,SP114916,1,,4934482
21,9412503,18820756,dup,SP114918,1,,9408253
12,130367568,133839206,dup,SP114920,1,,3471638
6,51899824,86224053,dup,SP114918,1,,34324229
3,61466,5913291,dup,SP114910,1,,5851825
1,35360861,36586077,dup,SP114912,1,,1225216
5,54309711,55463726,dup,SP114920,1,,1154015
5,65686059,175052459,dup,SP114914,1,,109366400
11,50780592,57934596,dup,SP114914,1,,7154004
21,25439649,39861864,dup,SP114910,1,,14422215
16,28863946,28864106,dup,SP114904,1,,160
9,10469,141033723,dup,SP114904,1,,141023254
3,61466,5913291,dup,SP114918,1,,5851825
5,175055515,180701594,dup,SP114920,1,,5646079
12,104014473,106095797,dup,SP114908,1,,2081324
11,50778501,57446272,dup,SP114904,1,,6667771
1,205636334,207075171,dup,SP114917,1,,1438837
1,205636334,207075171,dup,SP114904,1,,1438837
11,49209722,50781457,dup,SP114920,1,,1571735
1,113715350,114141775,dup,SP114906,1,,426425
17,2344493,2665633,dup,SP114916,1,,321140
6,51860651,57106426,dup,SP114906,1,,5245775
10,38020337,66694248,dup,SP114920,1,,28673911
17,13733806,17234181,dup,SP114910,1,,3500375
7,37445,43908866,dup,SP114914,1,,43871421
6,32655213,37903273,dup,SP114912,1,,5248060
12,106095906,106409695,dup,SP114908,1,,313789
13,104186448,115109852,dup,SP114906,1,,10923404
1,205636334,207075171,dup,SP114920,1,,1438837
6,24864254,28112562,dup,SP114904,1,,3248308
11,49214048,50782510,dup,SP114917,1,,1568462
6,11470694,12580740,dup,SP114917,1,,1110046
16,32257485,33483605,dup,SP114912,1,,1226120
10,35781244,37163932,dup,SP114912,1,,1382688
12,72632311,104001220,dup,SP114920,1,,31368909
20,29429945,62955706,dup,SP114910,1,,33525761
10,34247385,34498398,dup,SP114908,1,,251013
8,47380591,132943816,dup,SP114906,1,,85563225
16,32385012,32616372,dup,SP114914,1,,231360
10,34958841,37165771,dup,SP114908,1,,2206930
3,6003395,197872160,dup,SP114910,1,,191868765
13,34625324,115108598,dup,SP114921,1,,80483274
6,89329667,160102040,dup,SP114921,1,,70772373
2,121686882,125956280,dup,SP114921,1,,4269398
11,78543856,79994214,dup,SP114921,1,,1450358
8,102495873,104779368,dup,SP114921,1,,2283495
3,179131652,197842358,dup,SP114921,1,,18710706
8,130496365,139355606,dup,SP114921,1,,8859241
2,108066662,121754663,dup,SP114924,1,,13688001
8,133993446,142857551,dup,SP114924,1,,8864105
16,31948583,65007353,dup,SP114921,1,,33058770
10,42428055,86851682,dup,SP114921,1,,44423627
6,27513460,32449276,dup,SP114924,1,,4935816
11,29293673,38015477,dup,SP114921,1,,8721804
5,165880712,172188448,dup,SP114921,1,,6307736
5,79521506,105017111,dup,SP114921,1,,25495605
20,14060408,29434963,dup,SP114921,1,,15374555
19,107962,22301003,dup,SP114924,1,,22193041
8,73373140,76030051,dup,SP114921,1,,2656911
3,155459,16680604,dup,SP114921,1,,16525145
14,19089464,37737658,dup,SP114921,1,,18648194
6,44713331,51165634,dup,SP114921,1,,6452303
11,128335249,129280473,dup,SP114921,1,,945224
6,32520259,32707039,dup,SP114921,1,,186780
6,26675972,32519881,dup,SP114921,1,,5843909
3,73916738,97443050,dup,SP114924,1,,23526312
5,20510,10642261,dup,SP114921,1,,10621751
8,110033532,130337949,dup,SP114921,1,,20304417
11,12163479,25688756,dup,SP114921,1,,13525277
8,40379530,52791397,dup,SP114924,1,,12411867
2,188628343,243185679,dup,SP114921,1,,54557336
8,139780908,142857551,dup,SP114921,1,,3076643
11,51191702,56933839,dup,SP114921,1,,5742137
8,142858149,146273484,dup,SP114924,1,,3415335
2,106634447,108063018,dup,SP114924,1,,1428571
16,65007916,66490651,dup,SP114921,1,,1482735
3,41171323,71074194,dup,SP114921,1,,29902871
5,75295339,79520654,dup,SP114921,1,,4225315
20,33701652,35156142,dup,SP114921,1,,1454490
2,125957101,186035745,dup,SP114921,1,,60078644
11,129280750,134946277,dup,SP114921,1,,5665527
6,32707282,44711791,dup,SP114921,1,,12004509
3,31621146,41430774,dup,SP114924,1,,9809628
9,45440,78320919,dup,SP114921,1,,78275479
7,35691934,62031825,dup,SP114921,1,,26339891
21,14830826,47832917,dup,SP114924,1,,33002091
19,23385239,59118148,dup,SP114924,1,,35732909
8,79999240,130886595,dup,SP114924,1,,50887355
17,17610404,34334647,dup,SP114924,1,,16724243
10,17554160,42427995,dup,SP114921,1,,24873835
4,72510,55274856,dup,SP114921,1,,55202346
2,103641828,106633218,dup,SP114921,1,,2991390
19,107962,22300007,dup,SP114921,1,,22192045
11,110048500,134946277,dup,SP114924,1,,24897777
19,27742769,36154524,dup,SP114921,1,,8411755
11,50355655,50782777,dup,SP114921,1,,427122
9,44076700,78297567,dup,SP114924,1,,34220867
7,62032579,159122682,dup,SP114921,1,,97090103
20,24156508,26311428,dup,SP114924,1,,2154920
5,118935789,164047711,dup,SP114921,1,,45111922
5,172188673,174256617,dup,SP114921,1,,2067944
9,79998290,141109979,dup,SP114921,1,,61111689
18,10854,15078713,dup,SP114921,1,,15067859
7,31273,35690812,dup,SP114924,1,,35659539
11,76352366,110047686,dup,SP114924,1,,33695320
5,172234341,174250492,dup,SP114924,1,,2016151
8,43599700,73371749,dup,SP114921,1,,29772049
8,52792056,61075978,dup,SP114924,1,,8283922
15,20001861,102505693,dup,SP114921,1,,82503832
18,67998427,78017073,dup,SP114924,1,,10018646
9,45440,44072730,dup,SP114924,1,,44027290
20,52972517,62880369,dup,SP114921,1,,9907852
2,13241,30406830,dup,SP114921,1,,30393589
20,75813,14059113,dup,SP114921,1,,13983300
17,41244429,79999293,dup,SP114924,1,,38754864
11,79995419,88255084,dup,SP114921,1,,8259665
16,83807,31937982,dup,SP114921,1,,31854175
4,184292904,191042999,dup,SP114921,1,,6750095
9,78321032,79995380,dup,SP114921,1,,1674348
19,36155347,51589473,dup,SP114921,1,,15434126
16,66551294,90292788,dup,SP114921,1,,23741494
20,48937467,49839085,dup,SP114924,1,,901618
2,108067298,121686794,dup,SP114921,1,,13619496
12,47715453,133840986,dup,SP114921,1,,86125533
2,186689987,188627121,dup,SP114921,1,,1937134
6,32554540,44699354,dup,SP114924,1,,12144814
3,155459,16659016,dup,SP114924,1,,16503557
19,55682977,59118148,dup,SP114921,1,,3435171
8,108089324,110032847,dup,SP114921,1,,1943523
8,142858149,146273484,dup,SP114921,1,,3415335
22,16052513,51228910,dup,SP114921,1,,35176397
7,31273,35690812,dup,SP114921,1,,35659539
6,51169536,89302447,dup,SP114921,1,,38132911
5,111915705,118935351,dup,SP114921,1,,7019646
11,88256603,128268365,dup,SP114921,1,,40011762
3,71161467,72387971,dup,SP114924,1,,1226504
20,51149657,52514473,dup,SP114924,1,,1364816
18,15078877,68027980,dup,SP114921,1,,52949103
12,30194855,47870212,dup,SP114924,1,,17675357
21,9427957,14799557,dup,SP114921,1,,5371600
2,106634447,108066752,dup,SP114921,1,,1432305
7,145357051,159122682,dup,SP114924,1,,13765631
8,130888404,133992758,dup,SP114924,1,,3104354
14,37738197,107283598,dup,SP114921,1,,69545401
11,47268550,50355364,dup,SP114921,1,,3086814
12,47888496,133840986,dup,SP114924,1,,85952490
9,78298423,85078014,dup,SP114924,1,,6779591
5,20510,10533516,dup,SP114924,1,,10513006
4,72510,98957465,dup,SP114924,1,,98884955
5,54528526,75295027,dup,SP114921,1,,20766501
8,76030974,102494964,dup,SP114921,1,,26463990
3,97381963,179130913,dup,SP114921,1,,81748950
2,75089569,103624188,dup,SP114921,1,,28534619
4,55275733,74532232,dup,SP114921,1,,19256499
3,97445469,179100620,dup,SP114924,1,,81655151
2,103644243,106633218,dup,SP114924,1,,2988975
11,193865,50511418,dup,SP114924,1,,50317553
13,114010154,115108598,dup,SP114924,1,,1098444
20,33702831,35067384,dup,SP114924,1,,1364553
11,50512279,71231543,dup,SP114924,1,,20719264
1,144851968,144946768,dup,SP114924,1,,94800
1,46016358,46615056,dup,SP114924,1,,598698
3,31549788,41155345,dup,SP114921,1,,9605557
5,105019468,111914852,dup,SP114921,1,,6895384
17,17602977,79999293,dup,SP114921,1,,62396316
2,188308240,243185679,dup,SP114924,1,,54877439
11,193865,9999948,dup,SP114921,1,,9806083
5,10642437,49676895,dup,SP114921,1,,39034458
5,174259843,179717643,dup,SP114921,1,,5457800
5,179720255,180706205,dup,SP114921,1,,985950
5,73939265,79521599,dup,SP114924,1,,5582334
8,74756846,79994267,dup,SP114924,1,,5237421
19,51593929,55682966,dup,SP114921,1,,4089037
3,41432472,71160581,dup,SP114924,1,,29728109
5,174250895,180706205,dup,SP114924,1,,6455310
5,164065767,165878092,dup,SP114921,1,,1812325
21,42861181,47832917,dup,SP114921,1,,4971736
3,179107019,197842358,dup,SP114924,1,,18735339
8,61076434,74756122,dup,SP114924,1,,13679688
20,48938580,49838142,dup,SP114921,1,,899562
21,14800611,39920484,dup,SP114921,1,,25119873
10,77582,17553097,dup,SP114921,1,,17475515
11,25695825,29258947,dup,SP114921,1,,3563122
9,85128683,141109979,dup,SP114924,1,,55981296
13,19275875,34621121,dup,SP114921,1,,15345246
3,71130287,72383413,dup,SP114921,1,,1253126
3,17065116,30363284,dup,SP114924,1,,13298168
3,73916738,97381406,dup,SP114921,1,,23464668
8,104780901,107947848,dup,SP114921,1,,3166947
1,144854397,145075854,dup,SP114921,1,,221457
11,38038399,47268310,dup,SP114921,1,,9229911
4,74533816,134227799,dup,SP114921,1,,59693983
6,44699559,51180765,dup,SP114924,1,,6481206
20,52971883,62880369,dup,SP114924,1,,9908486
20,50922767,52514473,dup,SP114921,1,,1591706
14,19089464,107283598,dup,SP114924,1,,88194134
4,134228422,184292836,dup,SP114921,1,,50064414
12,34732811,47713177,dup,SP114921,1,,12980366
11,56941205,68709531,dup,SP114921,1,,11768326
2,125954272,188307962,dup,SP114924,1,,62353690
5,164047711,165878092,dup,SP114924,1,,1830381
3,17068563,30369095,dup,SP114921,1,,13300532
11,10000334,12161451,dup,SP114921,1,,2161117
18,68027995,78017073,dup,SP114921,1,,9989078
5,49715802,54422470,dup,SP114921,1,,4706668
10,99672541,102764511,dup,SP114930,1,,3091970
16,2461597,3333391,dup,SP114934,1,,871794
2,26077722,58306811,dup,SP114932,1,,32229089
18,13535,77972066,dup,SP114934,1,,77958531
9,121141437,141107896,dup,SP114932,1,,19966459
1,67231916,85203057,dup,SP114930,1,,17971141
7,34918,159121569,dup,SP114935,1,,159086651
10,64389552,86719553,dup,SP114926,1,,22330001
12,53442956,133469670,dup,SP114930,1,,80026714
10,64390647,86719553,dup,SP114932,1,,22328906
9,24898858,40485189,dup,SP114930,1,,15586331
21,14592705,39872696,dup,SP114932,1,,25279991
2,131546685,132331394,dup,SP114935,1,,784709
20,61279,62947828,dup,SP114930,1,,62886549
16,3262987,90278320,dup,SP114926,1,,87015333
6,7247344,31104698,dup,SP114930,1,,23857354
18,13535,77972066,dup,SP114926,1,,77958531
2,13241,25646967,dup,SP114935,1,,25633726
16,60816,35263876,dup,SP114930,1,,35203060
16,60816,2468202,dup,SP114932,1,,2407386
19,8079081,59118783,dup,SP114930,1,,51039702
10,93177376,94446635,dup,SP114926,1,,1269259
2,13241,25646967,dup,SP114932,1,,25633726
3,152656180,153964496,dup,SP114932,1,,1308316
3,131094620,175431181,dup,SP114930,1,,44336561
5,58382465,180711115,dup,SP114934,1,,122328650
1,213364581,249216384,dup,SP114934,1,,35851803
10,94026,55659360,dup,SP114935,1,,55565334
5,58375577,180709938,dup,SP114926,1,,122334361
10,93177376,94446635,dup,SP114935,1,,1269259
8,101764749,124149944,dup,SP114926,1,,22385195
10,104591152,104672233,dup,SP114926,1,,81081
5,12041,180711115,dup,SP114932,1,,180699074
4,162006858,191043125,dup,SP114934,1,,29036267
21,42869063,48038575,dup,SP114935,1,,5169512
4,161947071,162006905,dup,SP114935,1,,59834
6,140098560,170920196,dup,SP114926,1,,30821636
14,73704224,107283598,dup,SP114934,1,,33579374
4,161952680,162005915,dup,SP114934,1,,53235
10,96193443,97389101,dup,SP114930,1,,1195658
16,3338167,90278320,dup,SP114932,1,,86940153
1,213364581,249216384,dup,SP114926,1,,35851803
2,26077722,58306811,dup,SP114926,1,,32229089
1,87365107,212345628,dup,SP114932,1,,124980521
17,70318866,79989546,dup,SP114930,1,,9670680
6,140098560,170920196,dup,SP114934,1,,30821636
19,107962,6510126,dup,SP114932,1,,6402164
21,14599450,39872696,dup,SP114926,1,,25273246
11,193797,134942926,dup,SP114934,1,,134749129
2,13241,25646967,dup,SP114934,1,,25633726
3,152655953,153964496,dup,SP114935,1,,1308543
5,12041,57309750,dup,SP114934,1,,57297709
1,87365107,212345669,dup,SP114926,1,,124980562
4,161952680,162003689,dup,SP114932,1,,51009
16,2470720,3258422,dup,SP114926,1,,787702
5,99928881,180709938,dup,SP114930,1,,80781057
10,64389552,86719553,dup,SP114934,1,,22330001
1,87365107,212345555,dup,SP114934,1,,124980448
6,160271,6782298,dup,SP114930,1,,6622027
5,12041,57309750,dup,SP114926,1,,57297709
20,61279,62947828,dup,SP114932,1,,62886549
4,176150780,191043125,dup,SP114930,1,,14892345
9,10469,117123750,dup,SP114934,1,,117113281
10,56538759,64351581,dup,SP114926,1,,7812822
10,93177376,94446635,dup,SP114934,1,,1269259
10,114820191,135523763,dup,SP114930,1,,20703572
10,114161548,114476198,dup,SP114934,1,,314650
10,56538759,64351581,dup,SP114935,1,,7812822
1,51479,85210779,dup,SP114926,1,,85159300
9,10469,117123750,dup,SP114932,1,,117113281
7,34918,159121569,dup,SP114932,1,,159086651
14,73703747,107283598,dup,SP114926,1,,33579851
21,9412503,14538311,dup,SP114930,1,,5125808
6,108849793,139250519,dup,SP114930,1,,30400726
10,56538759,64351581,dup,SP114932,1,,7812822
13,74285917,115108993,dup,SP114926,1,,40823076
21,42868888,48038575,dup,SP114932,1,,5169687
8,2192387,2263016,dup,SP114926,1,,70629
8,124658404,146300622,dup,SP114934,1,,21642218
10,114072732,114475955,dup,SP114930,1,,403223
15,20004352,102520572,dup,SP114934,1,,82516220
19,8082536,59118783,dup,SP114935,1,,51036247
15,20004352,102520572,dup,SP114932,1,,82516220
13,74285917,115108993,dup,SP114935,1,,40823076
11,193797,134942926,dup,SP114932,1,,134749129
7,34918,159121569,dup,SP114934,1,,159086651
9,10469,117123750,dup,SP114926,1,,117113281
10,104592249,104667406,dup,SP114930,1,,75157
9,10469,117123750,dup,SP114935,1,,117113281
2,131482395,131853825,dup,SP114932,1,,371430
16,2470720,3333391,dup,SP114932,1,,862671
6,108850101,139250519,dup,SP114935,1,,30400418
2,131544948,131853825,dup,SP114926,1,,308877
10,93177376,94446041,dup,SP114932,1,,1268665
10,94026,55659360,dup,SP114926,1,,55565334
10,114161548,114475955,dup,SP114926,1,,314407
10,64389552,86719553,dup,SP114935,1,,22330001
10,56538759,64351581,dup,SP114934,1,,7812822
6,160271,29514923,dup,SP114932,1,,29354652
10,91171430,92449965,dup,SP114930,1,,1278535
5,12041,57309750,dup,SP114935,1,,57297709
9,121141437,141107896,dup,SP114930,1,,19966459
12,53442956,133469670,dup,SP114926,1,,80026714
15,20004352,102520572,dup,SP114930,1,,82516220
17,64095247,69404748,dup,SP114930,1,,5309501
10,103414885,103635938,dup,SP114934,1,,221053
19,8082536,59118783,dup,SP114926,1,,51036247
20,61279,62947828,dup,SP114935,1,,62886549
19,8082536,59118783,dup,SP114934,1,,51036247
2,131856499,243153522,dup,SP114932,1,,111297023
5,57340961,58375577,dup,SP114930,1,,1034616
10,55693525,56444429,dup,SP114926,1,,750904
10,114189482,114476198,dup,SP114935,1,,286716
4,19729,161947071,dup,SP114934,1,,161927342
8,29196656,96801654,dup,SP114926,1,,67604998
10,91171430,92449965,dup,SP114926,1,,1278535
13,74285917,115108993,dup,SP114934,1,,40823076
1,51479,63956746,dup,SP114930,1,,63905267
9,10469,24891957,dup,SP114930,1,,24881488
10,105850787,113649319,dup,SP114934,1,,7798532
10,94026,31068210,dup,SP114930,1,,30974184
17,5687,4847356,dup,SP114935,1,,4841669
22,16052513,51237063,dup,SP114930,1,,35184550
6,160271,79979394,dup,SP114935,1,,79819123
10,91171430,92449965,dup,SP114935,1,,1278535
17,5687,4911239,dup,SP114934,1,,4905552
17,11914615,62410570,dup,SP114926,1,,50495955
4,162007447,191043125,dup,SP114935,1,,29035678
10,36957317,56444429,dup,SP114930,1,,19487112
18,13535,77972066,dup,SP114932,1,,77958531
17,5687,4911239,dup,SP114926,1,,4905552
6,31104956,32602602,dup,SP114930,1,,1497646
8,29141834,124113977,dup,SP114935,1,,94972143
17,11866197,62509325,dup,SP114932,1,,50643128
10,99672541,102764511,dup,SP114935,1,,3091970
10,105850787,113649319,dup,SP114932,1,,7798532
10,55693525,56444429,dup,SP114934,1,,750904
3,176156898,194824168,dup,SP114930,1,,18667270
10,96193443,97389101,dup,SP114926,1,,1195658
8,29196656,124657263,dup,SP114934,1,,95460607
2,77429248,131495547,dup,SP114926,1,,54066299
17,5687,4847356,dup,SP114932,1,,4841669
4,19729,161944857,dup,SP114935,1,,161925128
3,73214,152206633,dup,SP114932,1,,152133419
21,42868888,48038575,dup,SP114930,1,,5169687
1,213364581,249216384,dup,SP114932,1,,35851803
19,108003,6508473,dup,SP114935,1,,6400470
17,70318866,79989546,dup,SP114935,1,,9670680
9,118279489,121034033,dup,SP114930,1,,2754544
3,152666493,153964496,dup,SP114934,1,,1298003
2,77429248,131141569,dup,SP114932,1,,53712321
10,105850787,113649319,dup,SP114926,1,,7798532
18,13535,77972066,dup,SP114930,1,,77958531
10,55693525,56444429,dup,SP114935,1,,750904
21,42869063,48038575,dup,SP114934,1,,5169512
10,104591152,104672233,dup,SP114935,1,,81081
5,57319482,58367957,dup,SP114935,1,,1048475
5,57319482,58375577,dup,SP114934,1,,1056095
10,103414885,103635938,dup,SP114932,1,,221053
17,11866197,62761639,dup,SP114935,1,,50895442
10,104591152,104672233,dup,SP114934,1,,81081
8,96801724,101763760,dup,SP114926,1,,4962036
6,108849793,139250519,dup,SP114926,1,,30400726
10,91171430,92449965,dup,SP114934,1,,1278535
10,105850787,113649319,dup,SP114935,1,,7798532
10,96193443,97389101,dup,SP114935,1,,1195658
3,73214,152206633,dup,SP114935,1,,152133419
10,104591152,104672233,dup,SP114932,1,,81081
4,19729,191043125,dup,SP114926,1,,191023396
2,77429248,131544948,dup,SP114935,1,,54115700
6,140098560,170920196,dup,SP114932,1,,30821636
19,8082536,59118783,dup,SP114932,1,,51036247
6,108849793,139250519,dup,SP114934,1,,30400726
17,70318866,79989546,dup,SP114926,1,,9670680
1,87365107,249216384,dup,SP114930,1,,161851277
5,57319482,58374223,dup,SP114926,1,,1054741
4,19729,161947071,dup,SP114932,1,,161927342
21,14532932,39872696,dup,SP114934,1,,25339764
10,103414885,103635938,dup,SP114926,1,,221053
10,94026,55659360,dup,SP114934,1,,55565334
10,99672541,102775205,dup,SP114926,1,,3102664
2,131856499,243153522,dup,SP114926,1,,111297023
10,103414885,103635938,dup,SP114935,1,,221053
13,74285917,115108993,dup,SP114932,1,,40823076
6,140084551,170920196,dup,SP114935,1,,30835645
2,77429248,243153522,dup,SP114934,1,,165724274
10,114189482,114475955,dup,SP114932,1,,286473
8,29141834,124671136,dup,SP114932,1,,95529302
6,32635883,79979394,dup,SP114930,1,,47343511
12,53442956,133469670,dup,SP114935,1,,80026714
4,161952680,162005915,dup,SP114930,1,,53235
3,73214,152206633,dup,SP114934,1,,152133419
5,12041,49940840,dup,SP114930,1,,49928799
17,11914615,62706779,dup,SP114930,1,,50792164
10,96193443,97389101,dup,SP114934,1,,1195658
7,34918,159121569,dup,SP114926,1,,159086651
10,55693525,56444429,dup,SP114932,1,,750904
2,13241,25646967,dup,SP114926,1,,25633726
4,162006858,174105556,dup,SP114930,1,,12098698
2,26077722,58306811,dup,SP114934,1,,32229089
3,154067770,197902936,dup,SP114926,1,,43835166
10,93177376,94446635,dup,SP114930,1,,1269259
10,105850787,113649319,dup,SP114930,1,,7798532
21,40516872,42860494,dup,SP114932,1,,2343622
6,160271,79979394,dup,SP114934,1,,79819123
9,121142577,141107896,dup,SP114935,1,,19965319
17,70318866,79989546,dup,SP114932,1,,9670680
6,108849793,139250519,dup,SP114932,1,,30400726
21,40516308,42868888,dup,SP114935,1,,2352580
10,91171430,92449965,dup,SP114932,1,,1278535
21,9412503,14522894,dup,SP114934,1,,5110391
9,121141437,141107896,dup,SP114934,1,,19966459
10,114072732,114109821,dup,SP114934,1,,37089
6,160271,79979394,dup,SP114926,1,,79819123
6,140098560,170920196,dup,SP114930,1,,30821636
12,53442956,133469670,dup,SP114934,1,,80026714
3,194824294,197902936,dup,SP114930,1,,3078642
1,87365107,212345669,dup,SP114935,1,,124980562
14,19066116,73703747,dup,SP114934,1,,54637631
16,60816,2461560,dup,SP114934,1,,2400744
9,118279489,121034033,dup,SP114932,1,,2754544
3,73214,70811997,dup,SP114930,1,,70738783
18,13535,77972066,dup,SP114935,1,,77958531
14,19066116,73700667,dup,SP114926,1,,54634551
22,16052513,51237063,dup,SP114935,1,,35184550
11,193797,134942926,dup,SP114935,1,,134749129
2,13241,11757076,dup,SP114930,1,,11743835
3,152656180,153964496,dup,SP114926,1,,1308316
10,114072732,114109821,dup,SP114932,1,,37089
11,193797,134942926,dup,SP114926,1,,134749129
10,96193443,97389101,dup,SP114932,1,,1195658
17,64095247,69404748,dup,SP114932,1,,5309501
4,162005899,191043125,dup,SP114932,1,,29037226
17,11914615,62410570,dup,SP114934,1,,50495955
10,99672541,102764511,dup,SP114932,1,,3091970
17,70318866,79989546,dup,SP114934,1,,9670680
4,19729,161947071,dup,SP114930,1,,161927342
10,99672541,102775205,dup,SP114934,1,,3102664
21,40516308,42868888,dup,SP114934,1,,2352580
16,2471836,3369346,dup,SP114935,1,,897510
21,42868888,48038575,dup,SP114926,1,,5169687
10,114820191,135523763,dup,SP114932,1,,20703572
15,20004352,102520572,dup,SP114926,1,,82516220
8,124114560,146300622,dup,SP114935,1,,22186062
1,51479,79999862,dup,SP114932,1,,79948383
10,114072732,114109821,dup,SP114935,1,,37089
6,32636434,85012209,dup,SP114932,1,,52375775
10,114820191,135523763,dup,SP114926,1,,20703572
11,193797,134942926,dup,SP114930,1,,134749129
9,118279489,121034033,dup,SP114934,1,,2754544
9,118279489,121034033,dup,SP114935,1,,2754544
5,58374223,180711115,dup,SP114935,1,,122336892
17,5687,4847356,dup,SP114930,1,,4841669
21,9412503,14591277,dup,SP114935,1,,5178774
2,47369709,58306811,dup,SP114930,1,,10937102
17,64095247,69404748,dup,SP114935,1,,5309501
10,89551255,90483261,del,SP114926,1,,932006
1,51479,79999862,dup,SP114934,1,,79948383
13,19020145,40345466,dup,SP114934,1,,21325321
13,19020145,40345466,dup,SP114932,1,,21325321
16,60816,2468202,dup,SP114926,1,,2407386
13,19020145,40348733,dup,SP114926,1,,21328588
17,64095247,69404748,dup,SP114926,1,,5309501
9,40488663,117122202,dup,SP114930,1,,76633539
21,14592705,39872696,dup,SP114935,1,,25279991
16,3338167,90278320,dup,SP114934,1,,86940153
14,19066116,107283598,dup,SP114932,1,,88217482
10,56538759,86719553,dup,SP114930,1,,30180794
2,132331901,243153522,dup,SP114935,1,,110821621
12,53442956,133469670,dup,SP114932,1,,80026714
21,40516872,42860494,dup,SP114926,1,,2343622
3,154067770,197902936,dup,SP114932,1,,43835166
19,107962,6510126,dup,SP114934,1,,6402164
9,121141437,141107896,dup,SP114926,1,,19966459
3,73889849,131082680,dup,SP114930,1,,57192831
3,175498137,176155842,dup,SP114930,1,,657705
10,88415611,89531978,dup,SP114926,1,,1116367
10,114820191,135523763,dup,SP114934,1,,20703572
2,26077722,58306811,dup,SP114935,1,,32229089
17,64095247,69404748,dup,SP114934,1,,5309501
13,19020145,40348733,dup,SP114935,1,,21328588
2,77429248,243153522,dup,SP114930,1,,165724274
14,19066116,73736390,dup,SP114935,1,,54670274
21,14541946,39872696,dup,SP114930,1,,25330750
20,61279,62947828,dup,SP114926,1,,62886549
8,29196656,146300622,dup,SP114930,1,,117103966
3,73214,152206633,dup,SP114926,1,,152133419
16,3370096,90278320,dup,SP114935,1,,86908224
15,20004352,102520572,dup,SP114935,1,,82516220
19,107962,6510126,dup,SP114926,1,,6402164
1,213363374,249216384,dup,SP114935,1,,35853010
8,124150413,146300622,dup,SP114926,1,,22150209
9,118279489,121034033,dup,SP114926,1,,2754544
19,107962,6508473,dup,SP114930,1,,6400511
14,73740649,107283598,dup,SP114935,1,,33542949
3,154067770,197902936,dup,SP114934,1,,43835166
21,9412503,14591277,dup,SP114932,1,,5178774
10,94026,55659360,dup,SP114932,1,,55565334
20,61279,62947828,dup,SP114934,1,,62886549
3,154067770,197902936,dup,SP114935,1,,43835166
21,9412503,14597296,dup,SP114926,1,,5184793
7,34918,159121569,dup,SP114930,1,,159086651
22,16052513,51237063,dup,SP114926,1,,35184550
10,114820191,135523763,dup,SP114935,1,,20703572
8,124671876,146300622,dup,SP114932,1,,21628746
22,16052513,51237063,dup,SP114934,1,,35184550
10,114072732,114109821,dup,SP114926,1,,37089
16,60816,2471356,dup,SP114935,1,,2410540
22,16052513,51237063,dup,SP114932,1,,35184550
1,51479,79999862,dup,SP114935,1,,79948383
3,73506292,197902936,dup,SP114937,1,,124396644
2,159198538,165624846,dup,SP114944,1,,6426308
3,626960,9174699,dup,SP114937,1,,8547739
20,61207306,61270938,dup,SP114943,1,,63632
21,9438527,22155795,dup,SP114945,1,,12717268
9,73508497,75803990,dup,SP114945,1,,2295493
22,16059973,35901373,dup,SP114944,1,,19841400
2,171636850,173414077,dup,SP114941,1,,1777227
17,49792035,76653624,dup,SP114944,1,,26861589
7,154991646,159122682,dup,SP114937,1,,4131036
4,69253396,90628127,dup,SP114944,1,,21374731
1,89938325,94881143,dup,SP114945,1,,4942818
10,55864540,63840062,dup,SP114943,1,,7975522
19,39264829,44883469,dup,SP114945,1,,5618640
2,157577131,165624846,dup,SP114937,1,,8047715
10,63982783,86058770,dup,SP114944,1,,22075987
5,2279813,4814696,dup,SP114943,1,,2534883
19,47661493,59101970,dup,SP114944,1,,11440477
7,132645222,136687408,dup,SP114941,1,,4042186
7,142409373,145848737,dup,SP114941,1,,3439364
4,35441986,42522504,dup,SP114941,1,,7080518
9,73508497,75803635,dup,SP114944,1,,2295138
16,13780389,14776789,dup,SP114941,1,,996400
5,49490662,51834824,dup,SP114941,1,,2344162
16,29329141,52099532,dup,SP114937,1,,22770391
12,74034517,110829254,dup,SP114941,1,,36794737
3,9248949,9844762,dup,SP114941,1,,595813
8,141119151,141558049,dup,SP114941,1,,438898
5,488926,2264925,dup,SP114937,1,,1775999
20,61270,18475704,dup,SP114941,1,,18414434
7,154991646,158252057,dup,SP114944,1,,3260411
21,42897136,48104004,dup,SP114941,1,,5206868
9,97158729,104563334,dup,SP114944,1,,7404605
5,4864535,6215258,dup,SP114943,1,,1350723
2,228381108,243178168,dup,SP114943,1,,14797060
15,20001861,57053542,dup,SP114945,1,,37051681
1,31207781,49564034,dup,SP114945,1,,18356253
17,76654585,79998702,dup,SP114944,1,,3344117
13,19028335,41106499,dup,SP114941,1,,22078164
3,626960,9174699,dup,SP114944,1,,8547739
9,104555177,106382531,dup,SP114945,1,,1827354
2,156286908,159198538,dup,SP114943,1,,2911630
22,16059973,35902517,dup,SP114943,1,,19842544
19,27752364,30816060,dup,SP114945,1,,3063696
17,35848211,49791175,dup,SP114944,1,,13942964
6,120854811,171050238,dup,SP114943,1,,50195427
3,9245529,9844762,dup,SP114945,1,,599233
1,53381267,59076050,dup,SP114941,1,,5694783
1,89936945,94881143,dup,SP114943,1,,4944198
9,104564957,106381634,dup,SP114944,1,,1816677
10,38571064,55338240,dup,SP114943,1,,16767176
1,113575878,249239130,dup,SP114944,1,,135663252
12,18154219,42912131,dup,SP114945,1,,24757912
19,39251197,44883469,dup,SP114944,1,,5632272
2,175379439,180050449,dup,SP114943,1,,4671010
2,191866658,243178168,dup,SP114941,1,,51311510
17,35801885,49784770,dup,SP114937,1,,13982885
2,156344565,157630899,dup,SP114945,1,,1286334
2,228381108,243178168,dup,SP114945,1,,14797060
2,9773586,13009277,dup,SP114937,1,,3235691
1,95964323,113575878,dup,SP114945,1,,17611555
12,44369103,53842472,dup,SP114941,1,,9473369
18,12007,4654200,dup,SP114943,1,,4642193
2,228381108,243178168,dup,SP114944,1,,14797060
17,15928600,35771860,dup,SP114937,1,,19843260
5,132700141,180730532,dup,SP114937,1,,48030391
10,63982783,86280451,dup,SP114937,1,,22297668
1,89936945,94881143,dup,SP114937,1,,4944198
9,97090722,104455503,dup,SP114945,1,,7364781
22,16059973,35845347,dup,SP114945,1,,19785374
5,49518461,70701806,dup,SP114944,1,,21183345
15,20001861,57063177,dup,SP114937,1,,37061316
3,73506292,197902936,dup,SP114943,1,,124396644
11,6724381,90592759,dup,SP114943,1,,83868378
5,6226785,7591244,dup,SP114944,1,,1364459
12,53849996,110829254,dup,SP114937,1,,56979258
2,13054683,156336013,dup,SP114945,1,,143281330
17,76599328,79998702,dup,SP114943,1,,3399374
22,35902517,45631441,dup,SP114944,1,,9728924
10,55338790,55863993,dup,SP114943,1,,525203
2,159198538,165624846,dup,SP114945,1,,6426308
16,18755392,50780552,dup,SP114941,1,,32025160
19,47661493,59101970,dup,SP114937,1,,11440477
2,182138407,191724500,dup,SP114937,1,,9586093
4,49230570,64796789,dup,SP114944,1,,15566219
5,9278888,14304813,dup,SP114945,1,,5025925
3,60482556,60983267,dup,SP114943,1,,500711
11,90604817,92841384,dup,SP114941,1,,2236567
4,49161938,131897140,dup,SP114941,1,,82735202
4,55192503,90626111,dup,SP114945,1,,35433608
19,31499573,35535332,dup,SP114945,1,,4035759
14,105559610,107289436,dup,SP114944,1,,1729826
2,156344565,157630899,dup,SP114944,1,,1286334
19,107962,27965587,dup,SP114944,1,,27857625
1,526840,28186226,dup,SP114945,1,,27659386
1,113567908,249239130,dup,SP114937,1,,135671222
19,35566917,39250800,dup,SP114944,1,,3683883
2,19956,9771620,dup,SP114937,1,,9751664
7,154991646,159122682,dup,SP114945,1,,4131036
1,53381267,59076717,dup,SP114943,1,,5695450
2,175508353,180139783,dup,SP114945,1,,4631430
17,44355602,49889904,dup,SP114945,1,,5534302
4,142854165,191043593,dup,SP114937,1,,48189428
7,131031763,132678578,dup,SP114944,1,,1646815
12,16004467,18150245,dup,SP114945,1,,2145778
1,95964323,113493337,dup,SP114937,1,,17529014
11,92845646,134939568,dup,SP114941,1,,42093922
2,165675115,171306347,dup,SP114937,1,,5631232
4,49224499,55166573,dup,SP114945,1,,5942074
7,142473188,145848737,dup,SP114944,1,,3375549
18,42460436,78017073,dup,SP114941,1,,35556637
1,143543006,249239130,dup,SP114945,1,,105696124
8,96296844,141112998,dup,SP114937,1,,44816154
2,183705197,191735930,dup,SP114941,1,,8030733
10,104503584,135523763,dup,SP114937,1,,31020179
17,76542542,79206789,dup,SP114941,1,,2664247
3,73506292,197902936,dup,SP114944,1,,124396644
7,34918,108907065,dup,SP114941,1,,108872147
16,60600,13775655,dup,SP114941,1,,13715055
5,70329226,94803780,dup,SP114937,1,,24474554
2,165624846,171306347,dup,SP114943,1,,5681501
1,89938325,94881143,dup,SP114944,1,,4942818
16,70884224,71199125,dup,SP114941,1,,314901
11,71060946,134939568,dup,SP114945,1,,63878622
19,30816284,31450576,dup,SP114945,1,,634292
6,110734999,121046350,dup,SP114941,1,,10311351
14,19002084,68550540,dup,SP114941,1,,49548456
6,120628974,171050238,dup,SP114937,1,,50421264
12,112761853,133839206,dup,SP114944,1,,21077353
12,16004467,42912131,dup,SP114937,1,,26907664
4,175086260,191043593,dup,SP114945,1,,15957333
16,50781802,52099532,dup,SP114941,1,,1317730
4,142854165,150670648,dup,SP114945,1,,7816483
16,60600,10513035,dup,SP114943,1,,10452435
5,6218863,9278405,dup,SP114945,1,,3059542
4,142854165,152032732,dup,SP114944,1,,9178567
2,182138407,191735930,dup,SP114945,1,,9597523
12,112761853,133839206,dup,SP114945,1,,21077353
9,107270669,141109979,dup,SP114945,1,,33839310
12,112761853,133839206,dup,SP114937,1,,21077353
7,145849598,146206710,dup,SP114944,1,,357112
4,150683754,153011520,dup,SP114945,1,,2327766
9,104555177,106381634,dup,SP114937,1,,1826457
2,156286908,157570431,dup,SP114937,1,,1283523
8,58830834,141114024,dup,SP114945,1,,82283190
17,49791052,76542409,dup,SP114941,1,,26751357
2,127375074,127668765,dup,SP114941,1,,293691
9,97164536,104455503,dup,SP114943,1,,7290967
15,57258531,102431166,dup,SP114937,1,,45172635
17,15928600,35801885,dup,SP114945,1,,19873285
6,160271,79997944,dup,SP114943,1,,79837673
2,175448779,180050449,dup,SP114944,1,,4601670
3,105371046,119115532,dup,SP114941,1,,13744486
3,10242243,22005074,dup,SP114941,1,,11762831
11,151370,6695844,dup,SP114943,1,,6544474
9,73508497,75803635,dup,SP114937,1,,2295138
19,31446002,35500919,dup,SP114943,1,,4054917
7,128296052,131020135,dup,SP114944,1,,2724083
1,53381267,59076717,dup,SP114937,1,,5695450
2,196883248,225279073,dup,SP114943,1,,28395825
4,173484169,175111153,dup,SP114943,1,,1626984
17,15928600,35801885,dup,SP114944,1,,19873285
14,68942069,107289436,dup,SP114941,1,,38347367
5,488926,2264925,dup,SP114944,1,,1775999
14,21457945,67710768,dup,SP114944,1,,46252823
9,75803990,97158485,dup,SP114944,1,,21354495
14,68144191,105553763,dup,SP114945,1,,37409572
22,16059973,35862913,dup,SP114937,1,,19802940
1,31209796,49447932,dup,SP114937,1,,18238136
21,39858902,42879236,dup,SP114941,1,,3020334
8,141113240,141526311,dup,SP114937,1,,413071
4,142854165,152302052,dup,SP114943,1,,9447887
4,153012030,173483087,dup,SP114943,1,,20471057
10,67193,15711387,dup,SP114943,1,,15644194
1,95964323,113567908,dup,SP114944,1,,17603585
5,132700141,180730532,dup,SP114941,1,,48030391
14,21631426,67710768,dup,SP114943,1,,46079342
19,47661493,59101970,dup,SP114945,1,,11440477
17,35848211,44209364,dup,SP114945,1,,8361153
4,152332391,153011520,dup,SP114941,1,,679129
3,22005565,32887837,dup,SP114941,1,,10882272
2,175508353,180050449,dup,SP114937,1,,4542096
10,67193,9697754,dup,SP114941,1,,9630561
19,24382242,31505283,dup,SP114937,1,,7123041
22,47568203,51222766,dup,SP114943,1,,3654563
3,119115556,132626665,dup,SP114941,1,,13511109
9,107270669,141109979,dup,SP114944,1,,33839310
9,97087707,104563334,dup,SP114941,1,,7475627
5,4814696,53483180,dup,SP114937,1,,48668484
1,526840,28194161,dup,SP114937,1,,27667321
5,14702011,49806540,dup,SP114945,1,,35104529
18,4657449,13222892,dup,SP114945,1,,8565443
16,29261537,52099532,dup,SP114945,1,,22837995
17,49899685,76599661,dup,SP114945,1,,26699976
6,110734999,120634290,dup,SP114945,1,,9899291
7,34918,151307311,dup,SP114945,1,,151272393
1,31207781,49587871,dup,SP114944,1,,18380090
10,15711480,38560648,dup,SP114943,1,,22849168
6,110734999,120599100,dup,SP114937,1,,9864101
9,10469,73508497,dup,SP114943,1,,73498028
8,95934907,96292784,dup,SP114937,1,,357877
11,90604817,92839912,dup,SP114944,1,,2235095
8,141689757,145988012,dup,SP114944,1,,4298255
12,16835982,41284591,dup,SP114941,1,,24448609
8,141117789,141591739,dup,SP114944,1,,473950
4,91603697,106482887,dup,SP114944,1,,14879190
18,13253080,14548928,dup,SP114944,1,,1295848
7,132678761,142455471,dup,SP114944,1,,9776710
1,59203121,89867883,dup,SP114945,1,,30664762
5,488926,2241586,dup,SP114941,1,,1752660
16,10514090,29264225,dup,SP114943,1,,18750135
4,91603697,131897140,dup,SP114937,1,,40293443
2,171636850,173414077,dup,SP114944,1,,1777227
1,143769721,249239130,dup,SP114941,1,,105469409
21,42863320,48104004,dup,SP114945,1,,5240684
10,104503584,135523763,dup,SP114941,1,,31020179
8,141117789,141755859,dup,SP114943,1,,638070
5,37898347,46401185,dup,SP114941,1,,8502838
1,59203121,89936183,dup,SP114943,1,,30733062
22,47568203,51222766,dup,SP114941,1,,3654563
16,70884224,71199125,dup,SP114945,1,,314901
5,488926,2264925,dup,SP114943,1,,1775999
8,42497882,58702663,dup,SP114937,1,,16204781
22,35903328,45603212,dup,SP114943,1,,9699884
14,19002084,21630781,dup,SP114943,1,,2628697
5,132700141,180730532,dup,SP114945,1,,48030391
12,16004467,42912131,dup,SP114944,1,,26907664
11,90604817,92838538,dup,SP114937,1,,2233721
10,63841130,86058770,dup,SP114943,1,,22217640
9,75803990,97076569,dup,SP114937,1,,21272579
2,196866420,225268300,dup,SP114937,1,,28401880
3,9245822,9844762,dup,SP114943,1,,598940
14,19002084,21457048,dup,SP114944,1,,2454964
19,39264829,44893074,dup,SP114943,1,,5628245
9,106382163,107068660,dup,SP114937,1,,686497
3,626960,9174699,dup,SP114943,1,,8547739
1,526840,28100721,dup,SP114944,1,,27573881
8,42497882,58702663,dup,SP114945,1,,16204781
17,36913807,49790270,dup,SP114941,1,,12876463
21,39858902,42861332,dup,SP114944,1,,3002430
14,105558360,107289436,dup,SP114937,1,,1731076
14,105558360,107289436,dup,SP114943,1,,1731076
2,182138407,191735930,dup,SP114943,1,,9597523
21,9438527,39853336,dup,SP114944,1,,30414809
2,127678372,165575974,dup,SP114941,1,,37897602
2,165624846,171306347,dup,SP114941,1,,5681501
7,154991646,159122682,dup,SP114943,1,,4131036
3,10242243,60481459,dup,SP114945,1,,50239216
16,29642392,52099532,dup,SP114944,1,,22457140
10,35190438,86058770,dup,SP114941,1,,50868332
4,64807879,67890117,dup,SP114944,1,,3082238
2,165675115,171306347,dup,SP114944,1,,5631232
2,196866420,225271467,dup,SP114944,1,,28405047
9,104555177,106382531,dup,SP114943,1,,1827354
4,106553364,107068874,dup,SP114945,1,,515510
1,59200910,89874057,dup,SP114937,1,,30673147
4,90628439,91596735,dup,SP114944,1,,968296
9,75805044,97087707,dup,SP114945,1,,21282663
17,76601363,79998702,dup,SP114945,1,,3397339
12,42913235,44347675,dup,SP114937,1,,1434440
8,96298606,141117924,dup,SP114941,1,,44819318
9,73508693,75803635,dup,SP114943,1,,2294942
16,60600,1980563,dup,SP114945,1,,1919963
8,141117789,141755859,dup,SP114945,1,,638070
5,132700141,180730532,dup,SP114943,1,,48030391
4,49224499,90626111,dup,SP114937,1,,41401612
12,53849996,110829254,dup,SP114943,1,,56979258
2,171636850,171668946,dup,SP114937,1,,32096
7,108907267,128292780,dup,SP114941,1,,19385513
4,49224499,55303110,dup,SP114943,1,,6078611
9,106382163,107046757,dup,SP114944,1,,664594
20,18442772,29645306,dup,SP114944,1,,11202534
18,12007,4654200,dup,SP114945,1,,4642193
2,9782397,13009277,dup,SP114943,1,,3226880
3,73506292,85686771,dup,SP114941,1,,12180479
19,31516764,35535289,dup,SP114937,1,,4018525
14,19002084,21633269,dup,SP114937,1,,2631185
12,16004467,42912131,dup,SP114943,1,,26907664
19,39260198,44904097,dup,SP114937,1,,5643899
1,31207781,41172734,dup,SP114943,1,,9964953
15,57258531,102431166,dup,SP114945,1,,45172635
19,35516926,39260198,dup,SP114943,1,,3743272
13,19028335,24294158,dup,SP114945,1,,5265823
7,34918,128292780,dup,SP114944,1,,128257862
18,14549551,78017073,dup,SP114943,1,,63467522
21,9438527,22155795,dup,SP114937,1,,12717268
20,18442772,29645306,dup,SP114937,1,,11202534
15,57258531,102431166,dup,SP114944,1,,45172635
3,9248949,9844762,dup,SP114944,1,,595813
18,14543362,78017073,dup,SP114945,1,,63473711
5,4864535,37897858,dup,SP114941,1,,33033323
2,225280521,228380448,dup,SP114945,1,,3099927
2,191866658,196864158,dup,SP114944,1,,4997500
12,41286021,42912131,dup,SP114941,1,,1626110
2,171636850,171668946,dup,SP114945,1,,32096
1,113492862,143221358,dup,SP114941,1,,29728496
13,19028335,41106499,dup,SP114937,1,,22078164
8,42497882,58702663,dup,SP114944,1,,16204781
12,55526917,74032340,dup,SP114941,1,,18505423
8,141762558,145988012,dup,SP114945,1,,4225454
5,14705665,46401185,dup,SP114943,1,,31695520
1,113590993,143221358,dup,SP114945,1,,29630365
5,132700141,180730532,dup,SP114944,1,,48030391
7,145849598,146206710,dup,SP114941,1,,357112
15,20001861,57053542,dup,SP114944,1,,37051681
2,9822136,13048350,dup,SP114945,1,,3226214
1,113567908,249239130,dup,SP114943,1,,135671222
5,14311915,14702375,dup,SP114943,1,,390460
5,53483402,70308251,dup,SP114937,1,,16824849
19,47661493,59101970,dup,SP114943,1,,11440477
11,151370,90592759,dup,SP114941,1,,90441389
11,92845646,134939568,dup,SP114943,1,,42093922
14,67741553,68144191,dup,SP114944,1,,402638
19,30816060,31434802,dup,SP114943,1,,618742
2,182138407,191735930,dup,SP114944,1,,9597523
8,58830834,95929837,dup,SP114937,1,,37099003
9,75803990,97162342,dup,SP114943,1,,21358352
2,196866420,225279073,dup,SP114945,1,,28412653
3,9248949,9844762,dup,SP114937,1,,595813
6,160271,79997944,dup,SP114945,1,,79837673
14,67741553,68142940,dup,SP114945,1,,401387
16,10514090,29260696,dup,SP114945,1,,18746606
18,4652432,13253010,dup,SP114944,1,,8600578
2,171636850,171668946,dup,SP114943,1,,32096
18,40862247,42454688,dup,SP114941,1,,1592441
9,107270148,141109979,dup,SP114943,1,,33839831
7,136688650,142389380,dup,SP114941,1,,5700730
12,42913235,44278489,dup,SP114945,1,,1365254
8,141591739,145988012,dup,SP114941,1,,4396273
1,95964323,113491364,dup,SP114941,1,,17527041
10,67193,15711841,dup,SP114945,1,,15644648
3,60481459,60983267,dup,SP114937,1,,501808
19,27970858,31595749,dup,SP114944,1,,3624891
21,39725516,42861332,dup,SP114945,1,,3135816
20,18442772,29645306,dup,SP114945,1,,11202534
20,50666036,50707474,dup,SP114945,1,,41438
21,22255861,22800167,dup,SP114941,1,,544306
2,19956,127374341,dup,SP114941,1,,127354385
15,20001861,57053542,dup,SP114943,1,,37051681
1,526840,28100721,dup,SP114941,1,,27573881
22,47485536,51222766,dup,SP114944,1,,3737230
7,158252308,159122682,dup,SP114944,1,,870374
8,58830834,141114024,dup,SP114943,1,,82283190
10,104503584,135523763,dup,SP114943,1,,31020179
3,626960,9198120,dup,SP114941,1,,8571160
5,72315858,94803780,dup,SP114945,1,,22487922
8,58830834,95937502,dup,SP114944,1,,37106668
22,35862913,45631441,dup,SP114941,1,,9768528
1,95964323,113493337,dup,SP114943,1,,17529014
16,70884224,71199125,dup,SP114944,1,,314901
19,107962,24247741,dup,SP114943,1,,24139779
3,132629302,188149586,dup,SP114941,1,,55520284
21,42863320,48104004,dup,SP114944,1,,5240684
15,57258531,102431166,dup,SP114943,1,,45172635
14,19002084,21625262,dup,SP114945,1,,2623178
4,153012030,191043593,dup,SP114941,1,,38031563
4,90628127,91596735,dup,SP114945,1,,968608
17,44210988,44353885,dup,SP114945,1,,142897
13,19028335,41106499,dup,SP114943,1,,22078164
19,24248611,30812664,dup,SP114941,1,,6564053
12,44369103,53842472,dup,SP114937,1,,9473369
2,165675115,171306347,dup,SP114945,1,,5631232
12,44282132,53849996,dup,SP114945,1,,9567864
11,151370,71060426,dup,SP114945,1,,70909056
4,55320334,90626111,dup,SP114943,1,,35305777
9,10469,73507057,dup,SP114945,1,,73496588
12,44291693,53842472,dup,SP114943,1,,9550779
9,35963836,36791532,dup,SP114937,1,,827696
9,10469,35962172,dup,SP114944,1,,35951703
7,34918,151307311,dup,SP114943,1,,151272393
18,14549551,78017073,dup,SP114944,1,,63467522
5,14311195,14701845,dup,SP114945,1,,390650
5,4864535,6217837,dup,SP114945,1,,1353302
2,225280521,228380448,dup,SP114943,1,,3099927
2,180586586,183704084,dup,SP114941,1,,3117498
21,9438527,39820408,dup,SP114943,1,,30381881
3,60994583,71020490,dup,SP114945,1,,10025907
17,35559633,44215045,dup,SP114943,1,,8655412
19,35565968,39260198,dup,SP114941,1,,3694230
10,104503584,135523763,dup,SP114944,1,,31020179
8,141762558,145988012,dup,SP114943,1,,4225454
4,107080029,131897140,dup,SP114945,1,,24817111
19,24248364,30812903,dup,SP114943,1,,6564539
10,34224901,63966912,dup,SP114944,1,,29742011
18,13252648,14532260,dup,SP114945,1,,1279612
10,104503584,135523763,dup,SP114945,1,,31020179
18,12007,4654200,dup,SP114937,1,,4642193
12,100047421,110829254,dup,SP114945,1,,10781833
2,191866658,196864158,dup,SP114945,1,,4997500
13,19028335,41346520,dup,SP114944,1,,22318185
1,59200910,89867883,dup,SP114944,1,,30666973
6,121293535,171050238,dup,SP114944,1,,49756703
4,91603697,106552733,dup,SP114945,1,,14949036
7,146239908,151307311,dup,SP114944,1,,5067403
12,42913235,44290991,dup,SP114943,1,,1377756
8,95940598,96292784,dup,SP114944,1,,352186
18,13252648,14548928,dup,SP114943,1,,1296280
19,31595953,35565968,dup,SP114944,1,,3970015
1,41837173,49448355,dup,SP114943,1,,7611182
19,31499573,35535332,dup,SP114941,1,,4035759
21,22255861,48104004,dup,SP114937,1,,25848143
19,107962,24508992,dup,SP114945,1,,24401030
3,85900761,105369731,dup,SP114941,1,,19468970
11,90604817,92841384,dup,SP114943,1,,2236567
2,225269975,228381108,dup,SP114937,1,,3111133
4,173402274,175085550,dup,SP114944,1,,1683276
3,10242243,71020490,dup,SP114944,1,,60778247
3,60994583,71020490,dup,SP114937,1,,10025907
7,146239908,151307311,dup,SP114941,1,,5067403
17,49790270,76598407,dup,SP114943,1,,26808137
2,191866658,196882116,dup,SP114943,1,,5015458
4,152332391,153011520,dup,SP114943,1,,679129
5,2279813,4814696,dup,SP114945,1,,2534883
10,9698647,15711387,dup,SP114941,1,,6012740
9,97077155,104455503,dup,SP114937,1,,7378348
6,120703685,171050238,dup,SP114945,1,,50346553
1,59200910,94881143,dup,SP114941,1,,35680233
4,106489300,107080552,dup,SP114943,1,,591252
5,12562337,49495713,dup,SP114944,1,,36933376
5,49835855,72314959,dup,SP114945,1,,22479104
20,18500521,29634946,dup,SP114941,1,,11134425
3,626960,9174699,dup,SP114945,1,,8547739
17,49784829,76567013,dup,SP114937,1,,26782184
2,9837880,13070150,dup,SP114944,1,,3232270
7,128296052,131006474,dup,SP114941,1,,2710422
5,70662060,94803780,dup,SP114941,1,,24141720
11,92838831,134939568,dup,SP114937,1,,42100737
9,106385266,107046761,dup,SP114943,1,,661495
2,13070582,156336013,dup,SP114944,1,,143265431
12,53912599,110829254,dup,SP114944,1,,56916655
19,47661493,59101970,dup,SP114941,1,,11440477
20,29639234,62940904,dup,SP114941,1,,33301670
17,44410243,49790100,dup,SP114943,1,,5379857
4,153085173,173401451,dup,SP114944,1,,20316278
9,10469,35963773,dup,SP114937,1,,35953304
8,96296844,141114024,dup,SP114944,1,,44817180
5,9278888,14311195,dup,SP114943,1,,5032307
3,10242243,60480932,dup,SP114937,1,,50238689
5,2279813,4814696,dup,SP114944,1,,2534883
4,175086079,191043593,dup,SP114944,1,,15957514
20,18442772,29645306,dup,SP114943,1,,11202534
16,60600,10505001,dup,SP114937,1,,10444401
5,488926,2264925,dup,SP114945,1,,1775999
6,121089156,170786827,dup,SP114941,1,,49697671
9,107270669,141109979,dup,SP114937,1,,33839310
12,16004467,16834301,dup,SP114941,1,,829834
4,90628127,91596735,dup,SP114943,1,,968608
19,107962,24343320,dup,SP114937,1,,24235358
19,30812903,31450576,dup,SP114941,1,,637673
2,191728044,196864158,dup,SP114937,1,,5136114
2,19956,9821979,dup,SP114945,1,,9802023
12,111343742,133839206,dup,SP114943,1,,22495464
14,67741553,68144191,dup,SP114943,1,,402638
10,15712178,63893358,dup,SP114945,1,,48181180
17,15928600,35771860,dup,SP114941,1,,19843260
18,12007,40849193,dup,SP114941,1,,40837186
9,36793247,73507057,dup,SP114937,1,,36713810
2,225279073,228380448,dup,SP114944,1,,3101375
10,18448322,34222978,dup,SP114944,1,,15774656
16,70884224,71199125,dup,SP114943,1,,314901
10,67193,18448109,dup,SP114944,1,,18380916
14,21635871,105557662,dup,SP114937,1,,83921791
22,35862913,45461782,dup,SP114945,1,,9598869
3,189241245,197902936,dup,SP114941,1,,8661691
20,210759,211711,dup,SP114945,1,,952
3,73506292,197902936,dup,SP114945,1,,124396644
16,29264945,52099532,dup,SP114943,1,,22834587
6,160271,79997944,dup,SP114941,1,,79837673
2,159301529,165575974,dup,SP114943,1,,6274445
6,110734999,120829851,dup,SP114943,1,,10094852
7,158248507,159122682,dup,SP114941,1,,874175
17,15883134,35421080,dup,SP114943,1,,19537946
1,526840,28210662,dup,SP114943,1,,27683822
21,22800446,39853336,dup,SP114941,1,,17052890
2,180586586,182068527,dup,SP114945,1,,1481941
4,106489300,107080552,dup,SP114944,1,,591252
17,44215075,44369320,dup,SP114943,1,,154245
11,92841384,134939568,dup,SP114944,1,,42098184
5,6217781,9278405,dup,SP114943,1,,3060624
21,39833768,42861332,dup,SP114943,1,,3027564
22,35901373,45461782,dup,SP114937,1,,9560409
21,9438527,21370122,dup,SP114941,1,,11931595
7,34918,151307311,dup,SP114937,1,,151272393
8,58830834,95929837,dup,SP114941,1,,37099003
22,16059973,35845347,dup,SP114941,1,,19785374
14,105554626,107289436,dup,SP114945,1,,1734810
2,171670121,173414077,dup,SP114943,1,,1743956
18,14548928,78017073,dup,SP114937,1,,63468145
5,70703986,94803780,dup,SP114944,1,,24099794
2,13029056,156272162,dup,SP114937,1,,143243106
16,60600,10512590,dup,SP114944,1,,10451990
4,152047676,153032688,dup,SP114944,1,,985012
9,35962223,36791532,dup,SP114944,1,,829309
14,68145660,105559097,dup,SP114944,1,,37413437
9,10469,97087329,dup,SP114941,1,,97076860
2,180586586,182068527,dup,SP114937,1,,1481941
6,110734999,121284684,dup,SP114944,1,,10549685
9,36793247,73507057,dup,SP114944,1,,36713810
4,35441986,42522504,dup,SP114945,1,,7080518
7,131020135,132644903,dup,SP114941,1,,1624768
20,45246819,45250891,dup,SP114945,1,,4072
10,63940713,86058770,dup,SP114945,1,,22118057
19,107962,24248413,dup,SP114941,1,,24140451
3,10242243,60481459,dup,SP114943,1,,50239216
4,35441986,42522504,dup,SP114944,1,,7080518
5,7662561,12561084,dup,SP114944,1,,4898523
4,175115254,191043593,dup,SP114943,1,,15928339
16,1981924,10513035,dup,SP114945,1,,8531111
4,35441986,42522504,dup,SP114943,1,,7080518
15,20001861,57053542,dup,SP114941,1,,37051681
18,4657449,13210525,dup,SP114937,1,,8553076
4,90628127,91596735,dup,SP114937,1,,968608
16,10512654,29641818,dup,SP114944,1,,19129164
9,106385266,106876389,dup,SP114945,1,,491123
21,42863320,48104004,dup,SP114943,1,,5240684
19,35535332,39251923,dup,SP114937,1,,3716591
6,160271,79997944,dup,SP114944,1,,79837673
11,151370,90592759,dup,SP114944,1,,90441389
4,67891641,69253291,dup,SP114944,1,,1361650
6,170787278,171050238,dup,SP114941,1,,262960
17,76567332,79998702,dup,SP114937,1,,3431370
4,153012030,173380293,dup,SP114945,1,,20368263
4,107090242,131897140,dup,SP114943,1,,24806898
3,32888851,71020490,dup,SP114941,1,,38131639
3,60482556,60983267,dup,SP114945,1,,500711
4,35441986,42522504,dup,SP114937,1,,7080518
10,15711480,35186721,dup,SP114941,1,,19475241
4,91603697,106482887,dup,SP114943,1,,14879190
4,107090242,131897140,dup,SP114944,1,,24806898
4,142854165,152302052,dup,SP114941,1,,9447887
2,175405804,180139297,dup,SP114941,1,,4733493
4,173382865,175086079,dup,SP114945,1,,1703214
22,47568203,51222766,dup,SP114937,1,,3654563
1,53381267,59076717,dup,SP114945,1,,5695450
15,57258531,71585806,dup,SP114941,1,,14327275
14,21626496,67710768,dup,SP114945,1,,46084272
2,171670121,173414077,dup,SP114945,1,,1743956
19,35565968,39260198,dup,SP114945,1,,3694230
16,14777006,18755194,dup,SP114941,1,,3978188
12,44369103,53902190,dup,SP114944,1,,9533087
20,61455666,61486885,dup,SP114945,1,,31219
12,111343742,133839206,dup,SP114941,1,,22495464
9,104564957,106876389,dup,SP114941,1,,2311432
13,24305456,41106499,dup,SP114945,1,,16801043
15,72402551,102431166,dup,SP114941,1,,30028615
8,95934907,96296844,dup,SP114941,1,,361937
8,42497882,58702663,dup,SP114941,1,,16204781
12,53852074,100047121,dup,SP114945,1,,46195047
9,107270148,141109979,dup,SP114941,1,,33839831
20,40789682,40790633,dup,SP114945,1,,951
2,180586586,182068527,dup,SP114944,1,,1481941
2,171670121,173414077,dup,SP114937,1,,1743956
19,39264829,44893074,dup,SP114941,1,,5628245
5,2242952,4814696,dup,SP114941,1,,2571744
2,19956,9782132,dup,SP114943,1,,9762176
2,180586586,182068527,dup,SP114943,1,,1481941
5,51855950,70578374,dup,SP114941,1,,18722424
18,4657449,13222892,dup,SP114943,1,,8565443
8,42497882,58702663,dup,SP114943,1,,16204781
5,2279813,4801119,dup,SP114937,1,,2521306
21,22255861,39709390,dup,SP114945,1,,17453529
12,53849996,55526358,dup,SP114941,1,,1676362
2,19956,9837368,dup,SP114944,1,,9817412
3,60994583,71020490,dup,SP114943,1,,10025907
17,35801885,36911933,dup,SP114941,1,,1110048
18,13222892,14546885,dup,SP114937,1,,1323993
11,151370,90592759,dup,SP114937,1,,90441389
22,47568203,51222766,dup,SP114945,1,,3654563
1,53381267,59076717,dup,SP114944,1,,5695450
16,10506981,29304259,dup,SP114937,1,,18797278
1,31207781,49564034,dup,SP114941,1,,18356253
6,160271,85035496,dup,SP114937,1,,84875225
2,228382022,243178168,dup,SP114937,1,,14796146
8,141540556,145988012,dup,SP114937,1,,4447456
5,4864535,6222552,dup,SP114944,1,,1358017
5,49490662,94803780,dup,SP114943,1,,45313118
14,68145660,105557662,dup,SP114943,1,,37412002
7,154991646,158247404,dup,SP114941,1,,3255758
2,13029056,156272162,dup,SP114943,1,,143243106
18,12007,4652097,dup,SP114944,1,,4640090
21,21377549,22155795,dup,SP114941,1,,778246
10,67193,63966912,dup,SP114937,1,,63899719
9,10469,141101939,dup,SP114951,1,,141091470
8,40163559,43324112,dup,SP114951,1,,3160553
21,9438527,14916669,dup,SP114946,1,,5478142
6,186795,62107890,dup,SP114946,1,,61921095
9,10469,2064795,dup,SP114949,1,,2054326
2,211637823,212314132,dup,SP114949,1,,676309
13,97814246,115108993,dup,SP114949,1,,17294747
2,211637823,212316100,dup,SP114951,1,,678277
21,9438541,15026777,dup,SP114951,1,,5588236
1,143759509,153990946,dup,SP114951,1,,10231437
7,63228221,65769833,dup,SP114951,1,,2541612
20,29423270,62955966,dup,SP114946,1,,33532696
1,217236979,220331961,dup,SP114951,1,,3094982
3,154441238,197902936,dup,SP114949,1,,43461698
6,186795,32589217,dup,SP114949,1,,32402422
3,51368858,69245454,dup,SP114949,1,,17876596
11,47450498,134935281,dup,SP114949,1,,87484783
14,107149500,107182717,dup,SP114951,1,,33217
10,108518084,108955938,dup,SP114946,1,,437854
6,57750280,171051256,dup,SP114949,1,,113300976
7,151180603,156182556,dup,SP114949,1,,5001953
7,31273,62276972,dup,SP114951,1,,62245699
3,60596,9348361,dup,SP114946,1,,9287765
3,32367671,45261300,dup,SP114951,1,,12893629
7,156185042,159127076,dup,SP114949,1,,2942034
7,31273,2573137,dup,SP114949,1,,2541864
1,231874143,232382630,dup,SP114951,1,,508487
7,119895961,121721201,dup,SP114951,1,,1825240
1,30923,12869780,dup,SP114949,1,,12838857
10,108521566,108952870,dup,SP114949,1,,431304
7,122400402,124963783,dup,SP114949,1,,2563381
2,101388,211637186,dup,SP114949,1,,211535798
14,30335832,30342818,dup,SP114951,1,,6986
1,229813451,230908948,dup,SP114951,1,,1095497
3,72591306,131503343,dup,SP114949,1,,58912037
3,154441238,197902936,dup,SP114951,1,,43461698
17,17128444,18782582,dup,SP114949,1,,1654138
7,138886769,141104385,dup,SP114951,1,,2217616
1,169742214,170767987,dup,SP114951,1,,1025773
7,141110794,148794442,dup,SP114951,1,,7683648
1,153992734,155186742,dup,SP114951,1,,1194008
3,69245910,71300030,del,SP114946,1,,2054120
6,32635616,57746830,dup,SP114949,1,,25111214
7,124965330,151177134,dup,SP114949,1,,26211804
8,8880928,13850947,dup,SP114949,1,,4970019
1,199105019,199449355,dup,SP114951,1,,344336
14,20383648,107289436,dup,SP114949,1,,86905788
3,71279339,71670444,dup,SP114951,1,,391105
3,32378176,45280687,dup,SP114946,1,,12902511
2,212316100,243152918,dup,SP114949,1,,30836818
1,13375066,249239130,dup,SP114949,1,,235864064
19,107958,59118096,dup,SP114949,1,,59010138
15,20001861,102505693,dup,SP114949,1,,82503832
3,60596,9348361,dup,SP114951,1,,9287765
21,42875652,48101335,dup,SP114949,1,,5225683
1,179661256,182300435,dup,SP114951,1,,2639179
3,12490083,31218207,dup,SP114946,1,,18728124
12,66463083,133840986,dup,SP114949,1,,67377903
8,48714335,146301295,dup,SP114949,1,,97586960
3,60596,9348361,dup,SP114949,1,,9287765
7,138282642,138856549,dup,SP114951,1,,573907
17,17130237,18782582,dup,SP114946,1,,1652345
12,55174733,55498745,dup,SP114949,1,,324012
6,65409615,65984929,dup,SP114946,1,,575314
9,12790262,141101939,dup,SP114949,1,,128311677
20,29423270,62955966,dup,SP114951,1,,33532696
10,108520052,108955938,dup,SP114951,1,,435886
12,55173965,55499177,dup,SP114951,1,,325212
7,133949345,137542900,dup,SP114951,1,,3593555
3,32370144,45261300,dup,SP114949,1,,12891156
3,12490064,31218207,dup,SP114951,1,,18728143
3,71301604,71671994,dup,SP114949,1,,370390
8,38369831,40154311,dup,SP114951,1,,1784480
6,32589300,32635312,dup,SP114949,1,,46012
3,51368858,69245454,dup,SP114946,1,,17876596
1,232382864,232968294,dup,SP114951,1,,585430
7,126202883,127786260,dup,SP114951,1,,1583377
1,230909242,231871781,dup,SP114951,1,,962539
7,133746764,133946615,dup,SP114951,1,,199851
17,20903068,79925460,dup,SP114949,1,,59022392
3,72606951,131498662,dup,SP114946,1,,58891711
21,9438527,14417811,dup,SP114949,1,,4979284
12,85661,55173965,dup,SP114949,1,,55088304
1,228916287,229811989,dup,SP114951,1,,895702
7,137544600,138276634,dup,SP114951,1,,732034
3,154441238,197902936,dup,SP114946,1,,43461698
10,90127,108520052,dup,SP114949,1,,108429925
7,62634594,63227478,dup,SP114951,1,,592884
14,19068869,20382818,dup,SP114949,1,,1313949
1,204852499,205865119,dup,SP114951,1,,1012620
7,62277063,62630255,dup,SP114951,1,,353192
3,131906447,153774462,dup,SP114949,1,,21868015
3,131906447,153774462,dup,SP114951,1,,21868015
7,127786919,133744637,dup,SP114951,1,,5957718
22,16052513,51234632,dup,SP114949,1,,35182119
14,20183705,20310852,dup,SP114951,1,,127147
11,128429,33765897,dup,SP114949,1,,33637468
1,203045054,204851682,dup,SP114951,1,,1806628
16,67248,90252258,dup,SP114949,1,,90185010
13,39195635,39983671,dup,SP114949,1,,788036
10,108955935,135498976,dup,SP114949,1,,26543041
7,2577961,6370305,dup,SP114949,1,,3792344
8,43324631,146301295,dup,SP114951,1,,102976664
4,102178892,191043168,dup,SP114949,1,,88864276
17,18466815,18782582,dup,SP114951,1,,315767
4,31794867,32831773,dup,SP114951,1,,1036906
9,2066493,12790111,dup,SP114949,1,,10723618
8,83237,8880818,dup,SP114949,1,,8797581
3,131906447,153774462,dup,SP114946,1,,21868015
3,12490083,31218207,dup,SP114949,1,,18728124
20,29423270,62955966,dup,SP114949,1,,33532696
13,19020145,33259007,dup,SP114949,1,,14238862
13,76093935,93049119,dup,SP114949,1,,16955184
7,103228457,107143164,dup,SP114951,1,,3914707
1,12879881,13374715,dup,SP114949,1,,494834
21,14589972,39845030,dup,SP114949,1,,25255058
7,6370406,122398319,dup,SP114949,1,,116027913
3,71301604,71674875,dup,SP114946,1,,373271
18,11860,78017128,dup,SP114949,1,,78005268
7,117740907,119889146,dup,SP114951,1,,2148239
7,117580488,117738961,dup,SP114951,1,,158473
8,13852051,48713898,dup,SP114949,1,,34861847
3,51368858,69245454,dup,SP114951,1,,17876596
12,55499040,62729782,dup,SP114949,1,,7230742
5,11956,180729006,dup,SP114949,1,,180717050
7,31273,159127076,dup,SP114946,1,,159095803
4,75893,79865281,dup,SP114949,1,,79789388
17,834,5520943,dup,SP114949,1,,5520109
12,55174733,55499266,dup,SP114946,1,,324533
11,36723630,46717938,dup,SP114949,1,,9994308
3,72598581,131502946,dup,SP114951,1,,58904365
1,205865783,209516399,dup,SP114951,1,,3650616
7,148795522,149938165,dup,SP114951,1,,1142643
7,121721855,126201959,dup,SP114951,1,,4480104
14,20313818,20424507,dup,SP114951,1,,110689
2,211623562,212318238,dup,SP114946,1,,694676
12,57905317,58900477,dup,SP114951,1,,995160
12,62132,34762642,del,SP106839,1,,34700510
4,41289170,42478884,del,SP106839,1,,1189714
4,140047478,140930372,del,SP106839,1,,882894
1,20266424,20952262,del,SP106840,1,,685838
13,45121313,45521604,del,SP106839,1,,400291
12,62132,34762642,del,SP106840,1,,34700510
15,56207210,58603730,del,SP106840,1,,2396520
15,56207210,58603730,del,SP106839,1,,2396520
17,27269363,45970263,del,SP106840,1,,18700900
8,33622,37607558,del,SP106840,1,,37573936
17,27269363,45970263,del,SP106839,1,,18700900
1,20266424,20952262,del,SP106839,1,,685838
8,61368680,61933710,del,SP106839,1,,565030
4,140047478,140930372,del,SP106840,1,,882894
21,39828922,42844938,del,SP106839,1,,3016016
17,7261719,7901322,del,SP106839,1,,639603
17,7261719,7901322,del,SP106840,1,,639603
12,78934816,79486883,del,SP106839,1,,552067
16,47786267,90250581,del,SP106840,1,,42464314
8,33622,37607558,del,SP106839,1,,37573936
21,39828922,42844938,del,SP106840,1,,3016016
4,41289170,42478884,del,SP106840,1,,1189714
16,47786267,90250581,del,SP106839,1,,42464314
5,61672445,79976773,del,SP106834,1,,18304328
2,158714436,187749725,dup,SP106833,1,,29035289
17,39984746,43244034,dup,SP106833,1,,3259288
14,56358369,107283598,dup,SP106833,1,,50925229
17,5209837,8036060,dup,SP106837,1,,2826223
8,24116304,41846687,dup,SP106833,1,,17730383
18,11860,78015057,dup,SP106833,1,,78003197
16,48031154,56438301,dup,SP106834,1,,8407147
3,69378594,72891824,dup,SP106833,1,,3513230
16,48031154,56438301,dup,SP106833,1,,8407147
6,71211312,118992323,del,SP106827,1,,47781011
9,20142898,20488384,del,SP106828,1,,345486
7,153635375,157819902,del,SP106825,1,,4184527
18,60443299,76102284,del,SP106825,1,,15658985
5,67488074,70200526,del,SP106827,1,,2712452
6,87766033,129867683,del,SP106829,1,,42101650
10,22287722,49201407,del,SP106827,1,,26913685
9,3829188,6451579,del,SP106827,1,,2622391
3,73337168,197870883,dup,SP106825,1,,124533715
9,138174993,140048198,del,SP106825,1,,1873205
3,176723308,178037546,del,SP106827,1,,1314238
9,12839535,15923770,del,SP106827,1,,3084235
11,123821655,126636854,del,SP106825,1,,2815199
6,90474602,96784365,del,SP106825,1,,6309763
14,64044097,107289436,del,SP106825,1,,43245339
15,86239492,102487644,dup,SP106825,1,,16248152
21,40373397,42798173,del,SP106825,1,,2424776
6,115620313,129147080,del,SP106825,1,,13526767
11,117600518,118951642,del,SP106825,1,,1351124
10,77582,1172220,dup,SP106825,1,,1094638
19,49287211,49881991,del,SP106829,1,,594780
9,131828766,134342299,del,SP106825,1,,2513533
8,5897009,43000187,del,SP106829,1,,37103178
2,30396019,32611512,del,SP106828,1,,2215493
9,126218634,127052467,del,SP106825,1,,833833
6,35482522,36901339,del,SP106828,1,,1418817
11,112439252,116655600,del,SP106828,1,,4216348
14,62888070,64015320,del,SP106825,1,,1127250
18,60443299,76102284,del,SP106829,1,,15658985
10,21822856,25980906,del,SP106825,1,,4158050
2,109122414,160760972,del,SP106828,1,,51638558
13,31399111,35310680,del,SP106825,1,,3911569
17,42133398,45068388,del,SP106829,1,,2934990
3,9479413,69181552,dup,SP106825,1,,59702139
3,69181820,73337408,del,SP106829,1,,4155588
3,69181820,73337408,del,SP106825,1,,4155588
15,56203732,58858910,del,SP106825,1,,2655178
16,72745491,85000226,del,SP106825,1,,12254735
15,85060496,86236291,del,SP106825,1,,1175795
17,29642089,30078223,del,SP106828,1,,436134
10,79699678,87807390,del,SP106827,1,,8107712
16,11143620,72741267,del,SP106825,1,,61597647
21,46779962,47068336,dup,SP102633,1,,288374
8,144303706,145779413,dup,SP102633,1,,1475707
22,50301875,51072467,dup,SP102633,1,,770592
19,282513,2138314,dup,SP102633,1,,1855801
1,3262989,3723476,dup,SP102633,1,,460487
22,24343908,24392203,del,SP102633,1,,48295
14,105243024,105450450,dup,SP102633,1,,207426
17,1218621,1354464,del,SP102633,1,,135843
4,1768235,1834550,dup,SP102633,1,,66315
2,119426308,126277711,del,SP102633,1,,6851403
11,2706138,2959113,dup,SP102633,1,,252975
19,33514120,33810062,dup,SP102633,1,,295942
9,138004111,138867174,del,SP102633,1,,863063
1,2097466,2485616,dup,SP102633,1,,388150
19,10235082,10387007,del,SP102633,1,,151925
13,46098746,95677054,del,SP102633,1,,49578308
11,67298739,67372567,del,SP102633,1,,73828
6,80467204,121863302,del,SP102633,1,,41396098
5,998945,1298756,dup,SP102633,1,,299811
1,145105680,145337094,dup,SP102633,1,,231414
3,173201531,174160655,del,SP102633,1,,959124
X,1,2693433,dup,SP102633,1,,2693432
19,43848340,44060592,dup,SP102633,1,,212252
17,36567701,36909618,dup,SP102633,1,,341917
8,8094763,43767534,del,SP102633,1,,35672771
12,58113365,58153435,dup,SP102633,1,,40070
7,151850,1131520,dup,SP102633,1,,979670
19,40685121,40748005,dup,SP102633,1,,62884
17,78932129,81195210,dup,SP102633,1,,2263081
19,42746278,42924151,dup,SP102633,1,,177873
11,1,2460493,dup,SP102633,1,,2460492
8,143357316,143636431,dup,SP102633,1,,279115
2,79516965,80473465,del,SP102633,1,,956500
9,138867174,140396299,dup,SP102633,1,,1529125
16,90039054,90354753,del,SP102633,1,,315699
12,132618393,133199945,dup,SP102633,1,,581552
2,151764505,152148420,del,SP102633,1,,383915
17,78610844,78765022,del,SP102633,1,,154178
12,52391049,52817930,dup,SP102633,1,,426881
11,69383268,69449054,del,SP102633,1,,65786
8,1,7004147,del,SP102633,1,,7004146
16,49991147,88368747,del,SP102633,1,,38377600
9,136186294,136939184,dup,SP102633,1,,752890
14,106534342,106816366,dup,SP102633,1,,282024
16,89274606,89958164,del,SP102633,1,,683558
17,1354464,1670559,dup,SP102633,1,,316095
2,78762512,79129096,del,SP102633,1,,366584
19,38759348,39272377,del,SP102633,1,,513029
1,1,1715336,dup,SP102633,1,,1715335
X,153320862,153558373,del,SP102633,1,,237511
19,3018843,3543775,dup,SP102633,1,,524932
19,18212923,18284418,dup,SP102633,1,,71495
22,49993140,50301875,del,SP102633,1,,308735
1,3723476,3807779,del,SP102633,1,,84303
14,22401244,22968481,dup,SP102633,1,,567237
17,48616977,48719646,dup,SP102633,1,,102669
3,162272677,162681204,del,SP102633,1,,408527
20,60881066,62344800,dup,SP102633,1,,1463734
4,620391,1043186,dup,SP102633,1,,422795
19,3942508,4129017,dup,SP102633,1,,186509
2,117697061,118364369,del,SP102633,1,,667308
16,1,2338272,dup,SP102633,1,,2338271
10,88800270,90679220,del,SP102647,1,,1878950
4,115503776,119195054,del,SP102647,1,,3691278
17,25326941,43160396,del,SP102647,1,,17833455
1,5637088,9747977,del,SP102647,1,,4110889
5,111924236,126580689,del,SP102647,1,,14656453
6,83566900,94123092,del,SP102647,1,,10556192
16,78528028,88368747,del,SP102652,1,,9840719
22,44385578,47306307,del,SP102652,1,,2920729
17,1244575,1359833,del,SP102652,1,,115258
15,39336404,41162152,del,SP102652,1,,1825748
7,66577234,69647887,dup,SP102652,1,,3070653
2,206481817,207033442,dup,SP102652,1,,551625
7,120901769,123832977,del,SP102652,1,,2931208
17,78928921,81195210,dup,SP102652,1,,2266289
7,85183242,87557691,dup,SP102652,1,,2374449
11,1,2460493,dup,SP102652,1,,2460492
7,87557691,91484408,del,SP102652,1,,3926717
2,241272014,242468307,del,SP102652,1,,1196293
1,17773819,17879132,del,SP102652,1,,105313
5,1298756,1376435,del,SP102652,1,,77679
9,84695601,85827713,dup,SP102652,1,,1132112
8,23464434,24735147,del,SP102652,1,,1270713
20,14961168,15216065,dup,SP102652,1,,254897
19,19101885,19573069,del,SP102652,1,,471184
19,1203318,2343952,dup,SP102652,1,,1140634
4,1834550,1963169,del,SP102652,1,,128619
4,81595912,82916954,dup,SP102652,1,,1321042
13,41375287,44938719,del,SP102652,1,,3563432
6,31199693,31315220,dup,SP102652,1,,115527
7,155531362,157328219,dup,SP102652,1,,1796857
8,4861433,7004147,del,SP102652,1,,2142714
4,79795017,80475247,dup,SP102652,1,,680230
X,950835,2693433,dup,SP102652,1,,1742598
16,518040,2338272,dup,SP102652,1,,1820232
17,59955375,60860024,dup,SP102652,1,,904649
5,176605521,176727546,del,SP102652,1,,122025
22,49046770,51304566,del,SP102652,1,,2257796
7,112151357,120901769,dup,SP102652,1,,8750412
15,43618397,44958781,del,SP102652,1,,1340384
11,69426826,69449054,del,SP102652,1,,22228
3,152582760,155622145,dup,SP102652,1,,3039385
7,127215268,127815196,del,SP102652,1,,599928
12,10638250,14574950,del,SP102652,1,,3936700
7,61064518,62773465,dup,SP102652,1,,1708947
15,55111305,58398681,del,SP102652,1,,3287376
13,20886499,25797220,del,SP102652,1,,4910721
7,123832977,127215268,dup,SP102652,1,,3382291
5,14177227,39158953,dup,SP102652,1,,24981726
1,3652763,3813295,del,SP102652,1,,160532
1,2199124,2531221,dup,SP102652,1,,332097
13,32863014,34771843,del,SP102652,1,,1908829
20,60881066,62113065,dup,SP102652,1,,1231999
7,94176803,94762762,del,SP102652,1,,585959
5,39421828,45106824,dup,SP102652,1,,5684996
4,1765161,1834550,dup,SP102652,1,,69389
19,584625,1175943,dup,SP102652,1,,591318
5,172755665,175042043,del,SP102652,1,,2286378
7,103200228,112151357,del,SP102652,1,,8951129
3,156155357,157680483,dup,SP102652,1,,1525126
1,11860382,12051788,del,SP102652,1,,191406
9,93065288,130600177,dup,SP102652,1,,37534889
4,71841216,72412430,del,SP102652,1,,571214
19,10229023,10529391,del,SP102652,1,,300368
11,2706138,2959113,dup,SP102652,1,,252975
16,61980054,62309861,dup,SP102652,1,,329807
4,88691315,89618645,del,SP102652,1,,927330
13,94979402,115169878,dup,SP102652,1,,20190476
8,1,4491219,del,SP102652,1,,4491218
8,8094763,22846315,del,SP102652,1,,14751552
7,64185332,64918640,dup,SP102652,1,,733308
9,130950481,141213431,dup,SP102652,1,,10262950
13,48041621,52335506,del,SP102652,1,,4293885
22,42422163,43789045,del,SP102652,1,,1366882
16,89374044,89872736,del,SP102652,1,,498692
1,3514552,3652763,dup,SP102652,1,,138211
3,174176512,174685300,dup,SP102652,1,,508788
8,69496052,145759698,dup,SP102652,1,,76263646
2,151552538,163851231,dup,SP102652,1,,12298693
9,90229580,91169692,dup,SP102652,1,,940112
3,71982586,72839348,del,SP102652,1,,856762
7,127815196,150542580,dup,SP102652,1,,22727384
1,144966664,145337094,dup,SP102652,1,,370430
7,15252853,15673297,del,SP102652,1,,420444
7,150542580,152314078,del,SP102652,1,,1771498
11,67298739,67372567,del,SP102652,1,,73828
14,105794891,106194497,dup,SP102652,1,,399606
9,82318842,83671946,dup,SP102652,1,,1353104
7,70680093,83858919,dup,SP102652,1,,13178826
4,84197357,88691315,dup,SP102652,1,,4493958
1,89405809,89903481,del,SP102652,1,,497672
11,69449054,69473986,dup,SP102652,1,,24932
17,1400691,1804750,del,SP102652,1,,404059
7,152314078,154454243,dup,SP102652,1,,2140165
12,132648507,133185790,dup,SP102652,1,,537283
4,78272107,79207650,dup,SP102652,1,,935543
11,68813864,69183022,dup,SP102626,1,,369158
21,23545244,24182860,dup,SP102626,1,,637616
10,45493223,89354071,del,SP102626,1,,43860848
7,62420406,159138663,dup,SP102626,1,,96718257
11,54795357,55145349,del,SP102626,1,,349992
20,1,26309255,dup,SP102626,1,,26309254
2,212542153,212633595,dup,SP102626,1,,91442
4,43246449,43978168,dup,SP102626,1,,731719
4,110387381,110781086,del,SP102626,1,,393705
16,75440627,80944002,dup,SP102626,1,,5503375
11,1,843235,dup,SP102626,1,,843234
8,19264006,29021259,del,SP102626,1,,9757253
7,1,58025423,dup,SP102626,1,,58025422
17,78928921,81195210,dup,SP102626,1,,2266289
X,1,2693433,dup,SP102626,1,,2693432
9,70984372,133585959,dup,SP102626,1,,62601587
16,46461309,74494767,dup,SP102626,1,,28033458
8,83518920,84810873,del,SP102626,1,,1291953
19,505715,1320068,dup,SP102626,1,,814353
10,89592380,89632239,del,SP102626,1,,39859
4,62704810,62826477,dup,SP102626,1,,121667
6,127811358,171115067,dup,SP102626,1,,43303709
8,94235020,142051660,dup,SP102626,1,,47816640
20,29519156,63025520,dup,SP102626,1,,33506364
5,98187142,102250356,del,SP102626,1,,4063214
11,48497805,48967134,del,SP102626,1,,469329
4,133128178,134313343,dup,SP102626,1,,1185165
8,8094763,19264006,dup,SP102626,1,,11169243
19,55007742,56921202,del,SP102626,1,,1913460
8,84810873,93071758,dup,SP102626,1,,8260885
5,120933736,122213595,del,SP102626,1,,1279859
13,34469962,71113571,del,SP102626,1,,36643609
14,37745629,105412290,dup,SP102626,1,,67666661
4,111447116,113255033,del,SP102626,1,,1807917
8,43438810,43767534,del,SP102626,1,,328724
12,34539195,35800000,del,SP102626,1,,1260805
4,91732522,92060179,dup,SP102626,1,,327657
14,36995457,37745629,dup,SP102626,1,,750172
9,134145698,141213431,dup,SP102626,1,,7067733
6,1,58770502,dup,SP102626,1,,58770501
16,1,31756525,dup,SP102626,1,,31756524
17,1,2162394,del,SP102626,1,,2162393
12,77510272,90084251,del,SP102626,1,,12573979
8,29021259,39206029,dup,SP102626,1,,10184770
17,75700451,76417492,dup,SP102626,1,,717041
12,37902988,38413677,del,SP102626,1,,510689
8,142143110,146364022,dup,SP102626,1,,4220912
11,8421302,8601332,del,SP102626,1,,180030
11,69383268,70799470,dup,SP102626,1,,1416202
16,34231286,35271725,dup,SP102626,1,,1040439
2,226404632,243199373,dup,SP102626,1,,16794741
2,141536485,141677608,dup,SP102626,1,,141123
10,89354071,89592380,del,SP102626,1,,238309
6,80051369,127613823,del,SP102626,1,,47562454
2,213391168,213553960,dup,SP102626,1,,162792
3,71119348,84945419,del,SP102626,1,,13826071
9,1,39184065,dup,SP102626,1,,39184064
17,2687244,7660264,del,SP102626,1,,4973020
8,46896972,83518920,dup,SP102626,1,,36621948
16,81041426,82561121,del,SP102626,1,,1519695
8,39390007,43438810,dup,SP102626,1,,4048803
10,89632239,90184651,del,SP102626,1,,552412
5,66559619,67511448,del,SP102626,1,,951829
19,47293617,47773477,del,SP102626,1,,479860
10,96455681,97009145,del,SP102626,1,,553464
11,49678113,51407120,del,SP102626,1,,1729007
10,90411693,91394804,del,SP102626,1,,983111
3,1,37739698,dup,SP102626,1,,37739697
14,20219083,36995457,dup,SP102626,1,,16776374
9,133694896,134011574,dup,SP102626,1,,316678
7,61064518,62420406,del,SP102626,1,,1355888
4,180793970,181473600,dup,SP102626,1,,679630
6,62329495,79875715,dup,SP102626,1,,17546220
8,1,7004147,dup,SP102626,1,,7004146
5,45821529,46401271,del,SP102626,1,,579742
22,49993140,50301875,del,SP102626,1,,308735
5,78440501,80504148,del,SP102626,1,,2063647
X,128567267,128876096,del,SP102630,1,,308829
18,60774375,78077248,del,SP102630,1,,17302873
7,129702437,130119173,del,SP102630,1,,416736
9,133439059,133689820,del,SP102630,1,,250761
20,19582009,20213293,del,SP102630,1,,631284
9,132654927,132756156,del,SP102630,1,,101229
8,4867996,6380696,del,SP102630,1,,1512700
8,23419250,23745952,del,SP102630,1,,326702
8,38437319,39127073,del,SP102630,1,,689754
8,16420908,17338210,del,SP102630,1,,917302
15,72375698,72500784,dup,SP102630,1,,125086
8,27790466,31146665,del,SP102630,1,,3356199
20,5059344,7227571,del,SP102630,1,,2168227
10,79019560,79381578,del,SP102630,1,,362018
8,18465318,22415289,del,SP102630,1,,3949971
8,8094763,14295045,del,SP102630,1,,6200282
14,106062431,106182056,del,SP102630,1,,119625
11,69482669,69508928,dup,SP102630,1,,26259
10,89655396,92839150,del,SP102630,1,,3183754
19,28096925,28411490,dup,SP102630,1,,314565
18,30399184,46923154,del,SP102630,1,,16523970
4,71980218,73702426,del,SP102630,1,,1722208
8,37166087,38214818,del,SP102630,1,,1048731
8,3235386,3458825,del,SP102630,1,,223439
5,32104125,32181543,dup,SP102630,1,,77418
X,1,2693433,dup,SP102630,1,,2693432
2,206464042,207196222,dup,SP102630,1,,732180
8,41193859,42103267,del,SP102630,1,,909408
20,14192828,14313661,del,SP102630,1,,120833
8,25212597,26815746,del,SP102630,1,,1603149
9,134006524,135018842,del,SP102630,1,,1012318
14,22469796,22932733,dup,SP102620,1,,462937
13,97741474,99722732,del,SP102620,1,,1981258
1,220106351,237711404,del,SP102620,1,,17605053
19,42934627,46214875,del,SP102620,1,,3280248
2,16069551,16087942,dup,SP102620,1,,18391
9,114765157,115446044,del,SP102620,1,,680887
X,43733482,45484934,del,SP102620,1,,1751452
12,51746404,52228023,del,SP102620,1,,481619
19,42580560,42778079,del,SP102620,1,,197519
22,24397683,51304566,del,SP102620,1,,26906883
8,94201639,101578939,del,SP102620,1,,7377300
12,95883859,105042879,del,SP102620,1,,9159020
22,24343908,24397683,dup,SP102620,1,,53775
10,88818644,103853377,del,SP102620,1,,15034733
5,180343466,180915260,dup,SP102620,1,,571794
9,134006524,134123154,del,SP102620,1,,116630
16,48656727,50589148,del,SP102620,1,,1932421
14,105765332,106202607,dup,SP102620,1,,437275
22,16054713,22273171,del,SP102620,1,,6218458
7,128079009,129238871,del,SP102620,1,,1159862
1,110243644,112251930,del,SP102620,1,,2008286
X,1,2693433,dup,SP102620,1,,2693432
11,112302967,117981443,del,SP102620,1,,5678476
11,81719285,82159085,del,SP102620,1,,439800
10,88479196,88601120,del,SP102620,1,,121924
10,31074454,33367762,del,SP102620,1,,2293308
12,123984529,124766786,del,SP102620,1,,782257
6,80806823,82796349,del,SP102620,1,,1989526
18,18554307,59785684,del,SP102620,1,,41231377
22,22338206,24343908,del,SP102620,1,,2005702
18,76828623,78077248,del,SP102620,1,,1248625
21,39988436,42867981,del,SP102620,1,,2879545
10,6932650,18800757,del,SP102620,1,,11868107
8,17631133,24131767,del,SP102620,1,,6500634
8,1,4693128,del,SP102620,1,,4693127
1,51812980,110227064,del,SP102620,1,,58414084
9,133564498,133698080,del,SP102620,1,,133582
8,108859980,119517768,del,SP102620,1,,10657788
4,16091991,22840391,del,SP102622,1,,6748400
3,47062546,47155699,del,SP102622,1,,93153
12,20607312,21562657,dup,SP102622,1,,955345
4,158696947,160697914,del,SP102622,1,,2000967
3,59163958,86470568,del,SP102622,1,,27306610
5,108899933,109677060,del,SP102622,1,,777127
6,141227319,141758856,dup,SP102622,1,,531537
12,84583432,88012092,dup,SP102622,1,,3428660
8,134117980,135406904,del,SP102622,1,,1288924
2,105120862,143020772,del,SP102622,1,,37899910
10,46971831,47577294,del,SP102622,1,,605463
10,55242704,59343849,dup,SP102622,1,,4101145
4,144854304,145816916,del,SP102622,1,,962612
9,104728855,105913153,dup,SP102622,1,,1184298
10,19135472,20689684,del,SP102622,1,,1554212
13,82498353,83579074,dup,SP102622,1,,1080721
8,77853232,78818032,dup,SP102622,1,,964800
2,198683754,201127549,del,SP102622,1,,2443795
12,60645660,61927186,dup,SP102622,1,,1281526
7,118165446,119597048,dup,SP102622,1,,1431602
9,15220994,23868076,del,SP102622,1,,8647082
6,158524522,158956206,del,SP102622,1,,431684
8,115213489,116964668,dup,SP102622,1,,1751179
4,93250024,94122628,dup,SP102622,1,,872604
4,147305300,147906620,del,SP102622,1,,601320
12,73471604,75053229,dup,SP102622,1,,1581625
2,184889346,186233375,dup,SP102622,1,,1344029
4,162260271,162610247,dup,SP102622,1,,349976
3,17497074,19733592,del,SP102622,1,,2236518
8,3091797,4843935,del,SP102622,1,,1752138
4,114844561,132395728,del,SP102622,1,,17551167
1,148794708,149888036,dup,SP102622,1,,1093328
1,187891946,192117071,dup,SP102622,1,,4225125
13,39521438,78597558,del,SP102622,1,,39076120
3,7181695,8588432,del,SP102622,1,,1406737
21,14344537,19600301,del,SP102622,1,,5255764
14,83068314,83714410,dup,SP102622,1,,646096
1,74850438,99342156,del,SP102622,1,,24491718
2,82158952,83002200,dup,SP102622,1,,843248
12,75205487,75689230,dup,SP102622,1,,483743
14,46904028,48255921,dup,SP102622,1,,1351893
14,26731705,29346406,dup,SP102622,1,,2614701
8,88730245,91532189,del,SP102622,1,,2801944
6,155057957,156911968,del,SP102622,1,,1854011
18,1,15377471,del,SP102622,1,,15377470
7,55210752,55249907,dup,SP102622,1,,39155
5,85842851,105606371,del,SP102622,1,,19763520
4,164295039,165258568,del,SP102622,1,,963529
11,55313687,55931397,dup,SP102622,1,,617710
5,160529379,161989034,del,SP102622,1,,1459655
4,132601574,134103486,dup,SP102622,1,,1501912
13,83579074,86025834,del,SP102622,1,,2446760
13,92715048,97440351,del,SP102622,1,,4725303
4,162610247,163522735,del,SP102622,1,,912488
2,193574018,195564930,dup,SP102622,1,,1990912
14,106524357,106816366,dup,SP102622,1,,292009
4,58730055,62877409,dup,SP102622,1,,4147354
5,19005194,23099748,dup,SP102622,1,,4094554
5,162929823,166338291,del,SP102622,1,,3408468
12,23230307,24212051,dup,SP102622,1,,981744
6,128698397,130029133,del,SP102622,1,,1330736
10,66196607,68891660,dup,SP102622,1,,2695053
1,195526704,196365186,dup,SP102622,1,,838482
21,20127313,21521971,del,SP102622,1,,1394658
13,101548055,101795931,del,SP102622,1,,247876
3,94190647,96069048,dup,SP102622,1,,1878401
6,64949824,128414850,del,SP102622,1,,63465026
22,25630583,26015246,del,SP102622,1,,384663
8,83397607,84235695,dup,SP102622,1,,838088
21,25754514,48129895,del,SP102622,1,,22375381
18,18554307,78077248,del,SP102622,1,,59522941
4,91474984,91889807,dup,SP102622,1,,414823
14,36621223,37954672,del,SP102622,1,,1333449
12,83933755,84278672,dup,SP102622,1,,344917
8,107692519,113430973,del,SP102622,1,,5738454
X,1,2693433,dup,SP102622,1,,2693432
8,8094763,31371030,del,SP102622,1,,23276267
11,69485446,69507950,dup,SP102622,1,,22504
14,22358704,22932733,dup,SP102622,1,,574029
3,162390557,166726889,dup,SP102622,1,,4336332
14,40745215,44227158,dup,SP102622,1,,3481943
4,175980155,189158036,del,SP102622,1,,13177881
1,71651580,74148848,del,SP102622,1,,2497268
7,82396135,85582554,dup,SP102622,1,,3186419
9,14082447,14442413,del,SP102622,1,,359966
11,36843914,38075560,del,SP102622,1,,1231646
1,102973787,106885447,dup,SP102622,1,,3911660
5,70306678,85350072,del,SP102622,1,,15043394
8,113744198,114303931,dup,SP102622,1,,559733
4,24488912,49092454,del,SP102622,1,,24603542
3,144034445,145116545,dup,SP102622,1,,1082100
5,85350072,85842851,del,SP102622,1,,492779
2,212511618,213445677,dup,SP102622,1,,934059
4,66215558,67578131,dup,SP102622,1,,1362573
3,102883767,103788258,dup,SP102622,1,,904491
3,88434483,89426059,dup,SP102622,1,,991576
4,156612568,158076715,del,SP102622,1,,1464147
5,64307503,68828372,del,SP102622,1,,4520869
11,38866120,39857800,del,SP102622,1,,991680
4,134103486,136217617,del,SP102622,1,,2114131
13,103411686,108634106,del,SP102622,1,,5222420
2,143898336,149238604,del,SP102622,1,,5340268
4,154056108,155787003,del,SP102622,1,,1730895
4,112329639,113351531,del,SP102622,1,,1021892
4,63368009,65345249,dup,SP102622,1,,1977240
8,4861433,7004147,del,SP102622,1,,2142714
7,48545487,49636550,del,SP102622,1,,1091063
5,25046263,26232908,dup,SP102622,1,,1186645
4,98280989,98959225,del,SP102622,1,,678236
13,86025834,88511040,dup,SP102622,1,,2485206
9,4994595,5115591,dup,SP102624,1,,120996
6,86489690,93621186,del,SP102624,1,,7131496
2,141981058,148146382,del,SP102624,1,,6165324
14,106566869,106784498,del,SP102624,1,,217629
16,31235359,34728826,dup,SP102624,1,,3493467
5,179857293,180915260,dup,SP102624,1,,1057967
13,113960120,115169878,dup,SP102624,1,,1209758
9,140149847,141213431,dup,SP102624,1,,1063584
22,46981422,48735394,dup,SP102624,1,,1753972
11,129821222,135006516,dup,SP102624,1,,5185294
22,24343908,24392203,del,SP102624,1,,48295
X,1,2767609,dup,SP102624,1,,2767608
11,89330037,121008162,dup,SP102624,1,,31678125
8,144803357,145032257,del,SP102624,1,,228900
14,106784498,107240198,dup,SP102624,1,,455700
6,61000000,84569834,del,SP102624,1,,23569834
3,69805811,69845855,dup,SP102624,1,,40044
7,151887079,152138941,dup,SP102624,1,,251862
11,122826156,126041705,dup,SP102624,1,,3215549
1,231887140,232528228,del,SP102624,1,,641088
8,87829957,144803357,dup,SP102624,1,,56973400
11,54795357,89162183,dup,SP102624,1,,34366826
3,119687464,119812573,dup,SP102624,1,,125109
14,106287213,106534342,dup,SP102624,1,,247129
4,72273885,74015982,dup,SP102624,1,,1742097
8,50219702,86131708,dup,SP102624,1,,35912006
5,1,1310840,dup,SP102624,1,,1310839
8,145032257,146364022,dup,SP102624,1,,1331765
8,8094763,34317032,del,SP102624,1,,26222269
X,154923128,155270560,dup,SP102624,1,,347432
7,116352771,116377378,del,SP102624,1,,24607
9,96416401,114072800,del,SP23459,1,,17656399
12,25543501,47474000,del,SP23459,1,,21930499
19,47600640,47800000,del,SP23459,1,,199360
12,63125201,66621900,del,SP23459,1,,3496699
12,100000,25291800,del,SP23459,1,,25191800
9,1,17530700,del,SP23459,1,,17530699
13,34368101,115100000,del,SP23455,1,,80731899
12,4326201,5901900,del,SP23455,1,,1575699
21,40599401,42869100,del,SP23455,1,,2269699
12,12418101,13463000,del,SP23455,1,,1044899
16,78554701,90294600,del,SP23455,1,,11739899
2,102448501,103418200,del,SP23455,1,,969699
17,29262201,46258100,del,SP23455,1,,16995899
5,39879101,40726800,del,SP23455,1,,847699
12,132668101,133206100,del,SP23455,1,,537999
2,108790801,109541151,del,SP23455,1,,750350
8,10101,26914400,del,SP23455,1,,26904299
17,55944401,56664900,del,SP23455,1,,720499
5,148949501,150386700,del,SP23451,1,,1437199
19,230301,8016700,del,SP23451,1,,7786399
2,1,192962113,del,SP23451,1,,192962112
17,19419501,21524100,del,SP23451,1,,2104599
12,111521301,133841800,del,SP23451,1,,22320499
8,123719135,124251174,del,SP23451,1,,532039
19,52513739,52705860,del,SP23451,1,,192121
3,66437901,90504500,del,SP23451,1,,24066599
1,232003073,233191093,del,SP23451,1,,1188020
11,86666027,86990002,del,SP23451,1,,323975
11,3699001,4162100,del,SP23451,1,,463099
17,1,18751300,del,SP23451,1,,18751299
17,79506958,79922072,del,SP23451,1,,415114
8,122961101,123032600,del,SP23451,1,,71499
1,213165801,220956800,del,SP23451,1,,7790999
11,4723201,4941100,del,SP23451,1,,217899
19,33095801,36694000,del,SP23451,1,,3598199
11,33624478,36564396,del,SP23451,1,,2939918
5,118285101,118846500,del,SP23451,1,,561399
19,52815702,56192800,del,SP23451,1,,3377098
10,45303401,100665400,del,SP23451,1,,55361999
1,156547901,160155700,del,SP23447,1,,3607799
12,27490704,31394366,del,SP23447,1,,3903662
12,75997501,76800200,del,SP23447,1,,802699
2,150913101,152124600,del,SP23447,1,,1211499
12,53800000,54800000,del,SP23447,1,,1000000
10,49649701,51390800,del,SP23447,1,,1741099
3,170624701,171536500,del,SP23447,1,,911799
22,26765701,38008200,del,SP23447,1,,11242499
19,42687501,43727000,del,SP23447,1,,1039499
13,30915601,93506000,del,SP23447,1,,62590399
12,115017801,117471800,del,SP23447,1,,2453999
2,159100000,159600000,del,SP23447,1,,500000
6,45100000,45800000,del,SP23447,1,,700000
10,52974301,113100000,del,SP23447,1,,60125699
3,184654301,186704400,del,SP23447,1,,2050099
1,64291201,94343500,del,SP23447,1,,30052299
12,57200000,57900000,del,SP23447,1,,700000
12,46444701,49053200,del,SP23447,1,,2608499
21,39875674,42867868,del,SP23447,1,,2992194
3,109161001,109278200,del,SP23443,1,,117199
13,110586436,112514400,del,SP23443,1,,1927964
6,4549201,8959346,del,SP23443,1,,4410145
8,31800501,32202765,del,SP23443,1,,402264
5,141014301,143509300,del,SP23443,1,,2494999
10,89515377,90656057,del,SP23443,1,,1140680
4,7964001,8300000,del,SP23443,1,,335999
3,72134301,73872600,del,SP23443,1,,1738299
1,182316201,182554265,del,SP23443,1,,238064
12,77409513,78032927,del,SP23443,1,,623414
13,24603901,26565900,del,SP23443,1,,1961999
12,130592601,133434100,del,SP23443,1,,2841499
3,32811201,33136100,del,SP23443,1,,324899
10,73361901,90656057,del,SP23443,1,,17294156
12,60001,20937000,del,SP23443,1,,20876999
3,28930001,33837373,del,SP23443,1,,4907372
8,124781974,125942520,del,SP23443,1,,1160546
8,106907244,107756145,del,SP23443,1,,848901
1,187713035,187921604,del,SP23443,1,,208569
16,28250701,29926400,del,SP23443,1,,1675699
3,56732301,57172900,del,SP23443,1,,440599
8,32575212,32902110,del,SP23443,1,,326898
13,24406661,24528300,del,SP23443,1,,121639
10,75814216,77150601,del,SP23443,1,,1336385
18,64622301,77648800,del,SP23439,1,,13026499
2,31821501,59875100,del,SP23439,1,,28053599
16,68167410,90115000,del,SP23439,1,,21947590
13,22981701,52010800,del,SP23439,1,,29029099
8,357901,31750700,del,SP23439,1,,31392799
Y,14785701,28753300,del,SP23435,1,,13967599
6,74863901,104772200,del,SP23435,1,,29908299
21,39856001,42742600,del,SP23435,1,,2886599
4,84585601,87745900,del,SP23435,1,,3160299
8,100000,43800000,del,SP23435,1,,43700000
Y,2737201,4249500,del,SP23435,1,,1512299
16,73239501,90170500,del,SP23431,1,,16930999
20,43411801,44412800,del,SP23431,1,,1000999
8,29166001,43822300,del,SP23431,1,,14656299
12,29821901,33020500,del,SP23431,1,,3198599
12,34032401,34376600,del,SP23431,1,,344199
4,68701,40540600,del,SP23431,1,,40471899
7,39256601,39940200,del,SP23431,1,,683599
22,17600000,18000000,del,SP23431,1,,400000
13,71961401,75788000,del,SP23431,1,,3826599
12,130417801,133789000,del,SP23431,1,,3371199
8,21939601,27550800,del,SP23431,1,,5611199
20,49054101,50795100,del,SP23431,1,,1740999
20,1,25692500,del,SP23431,1,,25692499
7,42905101,58053400,del,SP23431,1,,15148299
12,128225201,130417800,del,SP23431,1,,2192599
12,190801,26159800,del,SP23431,1,,25968999
11,113969101,134887600,del,SP23431,1,,20918499
12,33270901,33888600,del,SP23431,1,,617699
2,38397001,85074500,del,SP23431,1,,46677499
13,114094001,114212400,del,SP23471,1,,118399
2,43882501,48093000,del,SP23471,1,,4210499
1,212890501,213136200,del,SP23471,1,,245699
6,147751301,153321500,del,SP23471,1,,5570199
6,42692901,43634500,del,SP23471,1,,941599
6,157841701,161276200,del,SP23471,1,,3434499
1,239604201,239968500,del,SP23471,1,,364299
3,70085701,74165400,del,SP23471,1,,4079699
10,21323801,23157600,del,SP23471,1,,1833799
8,19606801,24309100,del,SP23471,1,,4702299
3,182780301,196519600,del,SP23471,1,,13739299
21,39875197,42867820,del,SP23471,1,,2992623
8,25290301,27866900,del,SP23471,1,,2576599
12,17049501,17852100,del,SP23471,1,,802599
13,30682701,95726700,del,SP23471,1,,65043999
6,167811901,168829600,del,SP23471,1,,1017699
8,105804101,109759900,del,SP23471,1,,3955799
10,12398501,13008100,del,SP23471,1,,609599
3,74588801,75481100,del,SP23471,1,,892299
6,162656001,163539300,del,SP23471,1,,883299
1,208928901,209329800,del,SP23471,1,,400899
18,55948201,58260900,del,SP23471,1,,2312699
3,196558301,197705600,del,SP23471,1,,1147299
6,145595001,146084600,del,SP23471,1,,489599
6,154624901,155524700,del,SP23471,1,,899799
18,1,78001300,del,SP23467,1,,78001299
21,40102546,42871282,del,SP23467,1,,2768736
16,22710701,33441300,del,SP23467,1,,10730599
20,45358601,46625500,del,SP23467,1,,1266899
8,28585301,43080900,del,SP23467,1,,14495599
21,40858401,48077600,del,SP23467,1,,7219199
21,42744401,42870500,del,SP23467,1,,126099
16,71202001,90293100,del,SP23467,1,,19091099
6,85895601,96920600,del,SP23467,1,,11024999
3,23923701,24869800,del,SP23463,1,,946099
17,74497101,77901700,del,SP23463,1,,3404599
13,32949101,103828500,del,SP23463,1,,70879399
1,19979201,26562300,del,SP23463,1,,6583099
21,37551501,42856300,del,SP23463,1,,5304799
3,26311201,26907000,del,SP23463,1,,595799
17,4876701,9559400,del,SP23463,1,,4682699
21,43036501,43245400,del,SP23463,1,,208899
6,144453239,171055000,del,SP112775,1,,26601761
20,60001,26319569,del,SP112775,1,,26259568
16,50317058,90294753,del,SP112775,1,,39977695
16,46505821,50317058,dup,SP112775,1,,3811237
8,10001,41585870,del,SP112775,1,,41575869
4,180335469,181370427,del,SP112777,1,,1034958
19,1,2492172,dup,SP112777,1,,2492171
1,2199124,3652763,dup,SP112777,1,,1453639
8,8094763,31265252,del,SP112777,1,,23170489
8,144893853,145774026,dup,SP112777,1,,880173
4,1762852,1837195,dup,SP112777,1,,74343
5,112922631,128087816,del,SP112777,1,,15165185
19,10231505,10301933,del,SP112777,1,,70428
19,27754573,28411490,dup,SP112777,1,,656917
7,1,1646753,dup,SP112777,1,,1646752
14,105243024,106194497,dup,SP112777,1,,951473
9,138984400,140424060,dup,SP112777,1,,1439660
8,5977535,7004147,del,SP112777,1,,1026612
6,87762194,88613764,del,SP112777,1,,851570
5,150155072,151338842,del,SP112777,1,,1183770
12,37902988,38470257,dup,SP112777,1,,567269
4,6319241,7258088,del,SP112777,1,,938847
11,1,2245964,dup,SP112777,1,,2245963
X,153261580,153555088,del,SP112777,1,,293508
5,52484067,54787425,del,SP112777,1,,2303358
5,33887278,34027432,del,SP112777,1,,140154
16,1,402422,del,SP112777,1,,402421
5,85877328,88698540,del,SP112777,1,,2821212
9,15045645,16004526,del,SP112777,1,,958881
5,65058990,65913423,del,SP112777,1,,854433
X,1,2693433,dup,SP112777,1,,2693432
5,45905699,46401271,dup,SP112777,1,,495572
X,154923128,155270560,dup,SP112777,1,,347432
1,3652763,3817541,del,SP112777,1,,164778
3,63049995,75082697,del,SP112777,1,,12032702
6,80411453,80816992,del,SP112777,1,,405539
6,90143687,91628110,del,SP112777,1,,1484423
16,402422,2304205,dup,SP112777,1,,1901783
8,42737664,43767534,dup,SP112777,1,,1029870
6,66410943,67123462,del,SP112777,1,,712519
17,78922400,81195210,dup,SP112777,1,,2272810
6,31757041,31933510,del,SP112777,1,,176469
7,61064518,62444325,dup,SP112777,1,,1379807
8,145774026,146364022,del,SP112777,1,,589996
11,50471308,51575951,dup,SP112777,1,,1104643
8,41774459,42737664,del,SP112777,1,,963205
1,1,1698751,dup,SP112777,1,,1698750
16,88413688,89161264,dup,SP112777,1,,747576
4,1,1379806,dup,SP112777,1,,1379805
4,1837195,1984698,del,SP112777,1,,147503
12,132635028,133185790,dup,SP112777,1,,550762
5,179809110,180915260,dup,SP112779,1,,1106150
X,1,2530477,dup,SP112779,1,,2530476
15,22752399,46628014,del,SP112779,1,,23875615
22,29135852,31078551,del,SP112779,1,,1942699
21,40779245,42819521,del,SP112779,1,,2040276
17,19888643,22217883,dup,SP112779,1,,2329240
5,49441966,54385282,del,SP112779,1,,4943316
5,54637042,68828372,del,SP112779,1,,14191330
20,1,26309255,del,SP112779,1,,26309254
X,154923128,155270560,dup,SP112779,1,,347432
8,1,7004147,del,SP112779,1,,7004146
16,68785486,87590224,del,SP112779,1,,18804738
7,5317888,58025423,dup,SP112781,1,,52707535
19,42746278,42838132,dup,SP112781,1,,91854
8,1,7004147,del,SP112781,1,,7004146
11,69416756,69447626,del,SP112781,1,,30870
16,88932875,90354753,del,SP112781,1,,1421878
19,40707981,40733533,dup,SP112781,1,,25552
19,282513,2471526,dup,SP112781,1,,2189013
17,7075989,7386965,dup,SP112781,1,,310976
1,1043498,3040296,dup,SP112781,1,,1996798
5,1027402,1301363,dup,SP112781,1,,273961
4,843109,1878181,dup,SP112781,1,,1035072
8,8094763,42653367,del,SP112781,1,,34558604
17,79114984,81195210,dup,SP112781,1,,2080226
1,3723476,3813295,del,SP112781,1,,89819
22,18641222,21313767,del,SP112781,1,,2672545
11,1,2489186,dup,SP112781,1,,2489185
21,45643135,46466296,dup,SP112781,1,,823161
19,17378019,18284418,dup,SP112781,1,,906399
16,2007124,2338272,dup,SP112781,1,,331148
12,34443462,35800000,dup,SP112781,1,,1356538
8,145029764,145779413,dup,SP112781,1,,749649
19,10235082,10387007,del,SP112781,1,,151925
7,61064518,99989383,dup,SP112781,1,,38924865
12,132572234,133199945,dup,SP112781,1,,627711
X,1,2693433,dup,SP112781,1,,2693432
16,2792408,3206363,dup,SP112781,1,,413955
1,156040614,156059721,dup,SP112781,1,,19107
19,12715946,13255359,dup,SP112781,1,,539413
19,3018843,4727553,dup,SP112781,1,,1708710
18,77144786,77720863,dup,SP112781,1,,576077
3,187556738,188202460,del,SP112781,1,,645722
7,99989383,102061176,del,SP112781,1,,2071793
16,68233198,88690716,del,SP112781,1,,20457518
10,133923127,135534747,dup,SP112781,1,,1611620
16,1,1285563,dup,SP112781,1,,1285562
9,138867174,140517485,dup,SP112781,1,,1650311
15,39881500,41089647,del,SP112781,1,,1208147
11,69447626,69467952,dup,SP112781,1,,20326
21,46676236,47550915,dup,SP112781,1,,874679
1,3310467,3723476,dup,SP112781,1,,413009
7,581610,2510018,del,SP112781,1,,1928408
14,105243024,106248982,dup,SP112781,1,,1005958
20,60881066,63025520,dup,SP112781,1,,2144454
22,45679850,51304566,del,SP112781,1,,5624716
19,55566389,56226332,dup,SP112781,1,,659943
17,1230508,1354464,del,SP112783,1,,123956
16,73863738,75021281,dup,SP112783,1,,1157543
9,86315231,86842066,dup,SP112783,1,,526835
8,26525898,27233227,dup,SP112783,1,,707329
16,75021281,88413688,del,SP112783,1,,13392407
8,62041332,62445404,dup,SP112783,1,,404072
9,82859888,83972360,del,SP112783,1,,1112472
7,151787234,152370889,dup,SP112783,1,,583655
X,1,2693433,dup,SP112783,1,,2693432
8,41381583,41909358,del,SP112783,1,,527775
19,3172344,3651679,dup,SP112783,1,,479335
7,133424788,134846600,dup,SP112783,1,,1421812
9,104967686,110066385,dup,SP112783,1,,5098699
8,77204670,78108087,dup,SP112783,1,,903417
8,46896972,49783969,del,SP112783,1,,2886997
14,20219083,20602232,dup,SP112783,1,,383149
8,42554616,43767534,dup,SP112783,1,,1212918
X,153305141,153558373,del,SP112783,1,,253232
7,114451863,114952263,dup,SP112783,1,,500400
8,87263136,87551872,del,SP112783,1,,288736
7,139258915,139346495,dup,SP112783,1,,87580
2,142945656,143622973,del,SP112783,1,,677317
8,62556311,64324938,dup,SP112783,1,,1768627
16,388734,1373309,dup,SP112783,1,,984575
7,108246058,108767660,dup,SP112783,1,,521602
10,89550516,89635039,del,SP112783,1,,84523
11,1,930888,dup,SP112783,1,,930887
8,94484696,96072001,del,SP112783,1,,1587305
9,35396395,36800596,dup,SP112783,1,,1404201
10,89653084,89673169,del,SP112783,1,,20085
7,26588599,27723877,dup,SP112783,1,,1135278
9,80518000,82859888,dup,SP112783,1,,2341888
7,55564282,57515014,dup,SP112783,1,,1950732
8,27233227,28304725,del,SP112783,1,,1071498
8,87551872,93690703,dup,SP112783,1,,6138831
19,42746278,42906083,dup,SP112783,1,,159805
12,132618393,133185790,dup,SP112783,1,,567397
9,72495572,72903273,del,SP112783,1,,407701
7,8400043,9601146,dup,SP112783,1,,1201103
22,24343908,24403467,dup,SP112783,1,,59559
8,24942260,26525898,del,SP112783,1,,1583638
7,100792884,101111093,dup,SP112783,1,,318209
3,115019509,115745597,dup,SP112783,1,,726088
7,91133942,91754023,dup,SP112783,1,,620081
21,39894980,42867981,del,SP112783,1,,2973001
9,83972360,84379960,dup,SP112783,1,,407600
6,38419746,39887538,del,SP112783,1,,1467792
11,69413524,69448474,del,SP112783,1,,34950
8,29108187,29947000,del,SP112783,1,,838813
7,46292006,47216794,dup,SP112783,1,,924788
8,38243788,41381583,dup,SP112783,1,,3137795
16,89014679,90354753,del,SP112783,1,,1340074
7,77346516,79031152,dup,SP112783,1,,1684636
1,3723476,3813295,del,SP112783,1,,89819
7,117042,1685736,dup,SP112783,1,,1568694
X,54618930,55368022,del,SP112783,1,,749092
9,37460663,38622119,del,SP112783,1,,1161456
8,74989263,77204670,del,SP112783,1,,2215407
7,101762842,104435379,dup,SP112783,1,,2672537
19,288713,2368871,dup,SP112783,1,,2080158
17,78591319,78759828,del,SP112783,1,,168509
9,84379960,85684564,del,SP112783,1,,1304604
5,45987386,46401271,dup,SP112783,1,,413885
9,139970639,140396299,dup,SP112783,1,,425660
10,21528131,21889542,dup,SP112783,1,,361411
7,66366232,67870708,dup,SP112783,1,,1504476
10,89673169,90322993,del,SP112783,1,,649824
7,111245746,112495520,dup,SP112783,1,,1249774
1,212851970,213451370,dup,SP112783,1,,599400
8,96072001,146364022,dup,SP112783,1,,50292021
19,8269150,8715656,dup,SP112783,1,,446506
8,41909358,42554616,dup,SP112783,1,,645258
9,70984372,72495572,dup,SP112783,1,,1511200
8,10726664,12588373,del,SP112783,1,,1861709
8,57960364,62041332,del,SP112783,1,,4080968
8,8094763,9676054,del,SP112783,1,,1581291
8,1,7004147,del,SP112783,1,,7004146
7,54919266,55096744,dup,SP112783,1,,177478
7,136627576,137545096,dup,SP112783,1,,917520
9,86842066,89954211,del,SP112783,1,,3112145
7,61064518,62675344,dup,SP112783,1,,1610826
14,106021120,106248982,dup,SP112783,1,,227862
19,54260796,59128983,dup,SP112783,1,,4868187
22,50289819,51304566,dup,SP112783,1,,1014747
9,91601993,104967686,del,SP112783,1,,13365693
8,22949235,24356440,del,SP112783,1,,1407205
7,13202885,14156690,dup,SP112783,1,,953805
3,71721592,73461145,del,SP112783,1,,1739553
11,69448474,69472151,dup,SP112783,1,,23677
7,71660982,73546760,dup,SP112783,1,,1885778
16,2135827,2338272,dup,SP112783,1,,202445
21,46808269,46963419,dup,SP112783,1,,155150
9,89954211,91601993,dup,SP112783,1,,1647782
9,36800596,37329342,del,SP112783,1,,528746
11,67298739,67372567,del,SP112783,1,,73828
8,93926837,94484696,dup,SP112783,1,,557859
8,37114834,38243788,del,SP112783,1,,1128954
7,95504913,97931320,dup,SP112783,1,,2426407
8,52976724,53516748,del,SP112783,1,,540024
2,715398,1119358,del,SP112783,1,,403960
7,37452223,42081095,dup,SP112783,1,,4628872
1,216312183,240890117,del,SP112785,1,,24577934
5,86621990,128505575,del,SP112785,1,,41883585
6,81432291,97003532,del,SP112785,1,,15571241
13,32113741,68324242,del,SP112785,1,,36210501
10,86241491,109147756,del,SP112785,1,,22906265
1,78736324,90970605,del,SP112785,1,,12234281
2,91616029,92275027,dup,SP112883,1,,658998
7,10239,57957589,dup,SP112883,1,,57947350
9,43568801,46702435,dup,SP112883,1,,3133634
2,105490926,135023836,del,SP112883,1,,29532910
22,16054719,51244566,del,SP112883,1,,35189847
17,25263007,81060000,del,SP112883,1,,55796993
12,20494468,133779461,dup,SP112883,1,,113284993
19,60001,24595576,del,SP112883,1,,24535575
17,78918726,81195210,dup,SP112885,1,,2276484
19,33544624,33799173,dup,SP112885,1,,254549
1,3723476,3807779,del,SP112885,1,,84303
22,46555197,46745398,del,SP112885,1,,190201
19,18825842,19101885,dup,SP112885,1,,276043
11,69475291,69534090,del,SP112885,1,,58799
16,89374044,89872736,del,SP112885,1,,498692
9,138811420,140424060,dup,SP112885,1,,1612640
4,1834550,1973727,del,SP112885,1,,139177
20,62532676,63025520,del,SP112885,1,,492844
16,31952510,33928041,del,SP112885,1,,1975531
9,131680996,132306021,del,SP112885,1,,625025
18,77144786,77720863,dup,SP112885,1,,576077
16,388734,2309335,dup,SP112885,1,,1920601
8,143290718,143636431,dup,SP112885,1,,345713
7,151850,1156974,dup,SP112885,1,,1005124
13,19084823,19423828,del,SP112885,1,,339005
14,104693219,105012644,del,SP112885,1,,319425
22,19943530,20268652,dup,SP112885,1,,325122
17,37892335,37921844,dup,SP112885,1,,29509
19,2492172,3018843,del,SP112885,1,,526671
2,242496566,243199373,dup,SP112885,1,,702807
19,40695062,40733533,dup,SP112885,1,,38471
11,2734805,2959113,dup,SP112885,1,,224308
5,669423,1298756,dup,SP112885,1,,629333
11,69399532,69449054,del,SP112885,1,,49522
14,22633243,22981839,dup,SP112885,1,,348596
7,1269021,2759743,dup,SP112885,1,,1490722
19,42746278,42924151,dup,SP112885,1,,177873
10,43556629,43639591,dup,SP112885,1,,82962
11,1,2476163,dup,SP112885,1,,2476162
22,19696421,19823521,dup,SP112885,1,,127100
17,41285652,44450627,del,SP112885,1,,3164975
19,10231505,10387007,del,SP112885,1,,155502
X,1,2693433,dup,SP112885,1,,2693432
11,66508369,67298739,dup,SP112885,1,,790370
19,49826549,50403766,dup,SP112885,1,,577217
12,10372714,13265151,del,SP112885,1,,2892437
1,1,1715336,dup,SP112885,1,,1715335
12,25347417,25396563,del,SP112885,1,,49146
12,58113365,58153435,dup,SP112885,1,,40070
19,55566389,56259480,dup,SP112885,1,,693091
19,18223188,18284418,dup,SP112885,1,,61230
12,15999817,16411186,del,SP112885,1,,411369
11,69449054,69475291,dup,SP112885,1,,26237
1,156040614,156062332,dup,SP112885,1,,21718
22,50607452,51304566,dup,SP112885,1,,697114
19,19101885,19587972,del,SP112885,1,,486087
19,279205,2492172,dup,SP112885,1,,2212967
14,20219083,20589813,dup,SP112885,1,,370730
16,89872736,90120002,dup,SP112885,1,,247266
4,620391,1834550,dup,SP112885,1,,1214159
16,88342973,89374044,dup,SP112885,1,,1031071
19,3018843,4106515,dup,SP112885,1,,1087672
20,60462438,62532676,dup,SP112885,1,,2070238
9,137758106,138811420,del,SP112885,1,,1053314
12,132564710,133199945,dup,SP112885,1,,635235
21,46703017,46933947,dup,SP112885,1,,230930
1,1839387,3723476,dup,SP112885,1,,1884089
11,63748769,64095538,dup,SP112885,1,,346769
22,19823521,19943530,del,SP112885,1,,120009
17,1230508,1354464,del,SP112885,1,,123956
11,67298739,67376865,del,SP112885,1,,78126
22,24019389,24205155,dup,SP112885,1,,185766
10,134161348,135116642,dup,SP112885,1,,955294
14,105012644,106248982,dup,SP112885,1,,1236338
8,144333873,145783379,dup,SP112885,1,,1449506
17,48616977,48720276,dup,SP112885,1,,103299
X,153297267,153558373,del,SP112885,1,,261106
16,1,388734,del,SP112885,1,,388733
7,1,641590,dup,SP112867,1,,641589
3,99335562,103308797,dup,SP112867,1,,3973235
3,108247302,108692672,dup,SP112867,1,,445370
11,2234962,2706138,del,SP112867,1,,471176
X,153308196,153558373,del,SP112867,1,,250177
11,31251772,49379347,del,SP112867,1,,18127575
8,106811005,110370007,dup,SP112867,1,,3559002
7,46219176,46745961,del,SP112867,1,,526785
1,189089745,189620452,del,SP112867,1,,530707
22,24343908,24392203,del,SP112867,1,,48295
8,91217401,92000578,del,SP112867,1,,783177
21,46703017,46963419,dup,SP112867,1,,260402
8,1,7004147,del,SP112867,1,,7004146
22,48124685,48598620,dup,SP112867,1,,473935
6,77803451,79700375,del,SP112867,1,,1896924
16,46461309,63318548,del,SP112867,1,,16857239
3,143689649,144017363,del,SP112867,1,,327714
2,141403827,141701503,del,SP112867,1,,297676
19,1203318,2275597,dup,SP112867,1,,1072279
2,126963216,127265044,del,SP112867,1,,301828
6,81220110,84639633,del,SP112867,1,,3419523
8,8094763,41850944,del,SP112867,1,,33756181
6,86100329,101488554,del,SP112867,1,,15388225
8,112295126,113615923,del,SP112867,1,,1320797
3,179503860,198022430,del,SP112867,1,,18518570
1,2100168,3040296,dup,SP112867,1,,940128
18,34358403,39624897,del,SP112867,1,,5266494
11,67298739,67372567,del,SP112867,1,,73828
9,21981916,22004411,dup,SP112867,1,,22495
14,22339422,22959282,dup,SP112867,1,,619860
17,78918726,80211192,dup,SP112867,1,,1292466
12,1,34252187,del,SP112867,1,,34252186
16,89380549,89623627,del,SP112867,1,,243078
3,103308797,104550929,dup,SP112867,1,,1242132
8,87733739,88782254,dup,SP112867,1,,1048515
3,144017363,157087165,dup,SP112867,1,,13069802
2,81874622,82233891,del,SP112867,1,,359269
X,1,2693433,dup,SP112867,1,,2693432
1,859884,1336204,dup,SP112867,1,,476320
16,1557047,1967207,del,SP112867,1,,410160
13,33943868,56025839,del,SP112867,1,,22081971
17,1230508,1357392,del,SP112867,1,,126884
11,123223447,123784696,del,SP112867,1,,561249
21,19525643,20303080,del,SP112867,1,,777437
1,3723476,3813295,del,SP112867,1,,89819
7,50713677,58025423,del,SP112867,1,,7311746
2,143570296,144084700,del,SP112867,1,,514404
8,144991870,145779413,dup,SP112867,1,,787543
6,114166016,117030860,del,SP112867,1,,2864844
20,60881066,62206014,dup,SP112867,1,,1324948
7,147373247,147987078,dup,SP112867,1,,613831
6,117030860,129253236,del,SP112867,1,,12222376
6,102992387,114166016,del,SP112867,1,,11173629
4,181721908,182139593,dup,SP112867,1,,417685
8,62810715,64121224,del,SP112867,1,,1310509
12,77822890,78197878,del,SP112867,1,,374988
3,95171223,99335562,del,SP112867,1,,4164339
3,104550929,106359277,dup,SP112867,1,,1808348
8,68911955,71731531,dup,SP112867,1,,2819576
3,93517443,94708112,del,SP112867,1,,1190669
19,33542117,33799173,dup,SP112867,1,,257056
3,157894656,162507077,dup,SP112867,1,,4612421
11,1,2234962,dup,SP112867,1,,2234961
5,70306678,80587898,del,SP112867,1,,10281220
8,143228324,143690152,dup,SP112867,1,,461828
4,90749242,91776605,dup,SP112867,1,,1027363
8,113753651,115041538,del,SP112867,1,,1287887
5,160707705,162781950,del,SP112867,1,,2074245
12,132572234,133185790,dup,SP112867,1,,613556
7,76170889,76720510,dup,SP112867,1,,549621
18,14842109,15377471,del,SP112867,1,,535362
16,540021,1557047,dup,SP112867,1,,1017026
X,6260189,7452182,del,SP112867,1,,1191993
16,88368747,89085426,dup,SP112867,1,,716679
3,94708112,95171223,dup,SP112867,1,,463111
14,105243024,106248982,dup,SP112867,1,,1005958
13,108550496,108865275,del,SP112867,1,,314779
9,123438168,124179411,del,SP112867,1,,741243
7,888803,1646753,dup,SP112867,1,,757950
3,1,7628777,del,SP112867,1,,7628776
19,584625,1179055,dup,SP112867,1,,594430
3,118471194,143689649,dup,SP112867,1,,25218455
13,104253544,106162536,del,SP112867,1,,1908992
8,76861322,79360032,del,SP112867,1,,2498710
3,7628777,12063114,dup,SP112867,1,,4434337
3,44822546,45488656,dup,SP112867,1,,666110
21,20956656,21317642,del,SP112867,1,,360986
11,104670613,110024001,del,SP112867,1,,5353388
8,113651924,113753651,dup,SP112867,1,,101727
9,138852044,140396299,dup,SP112867,1,,1544255
1,3402140,3723476,dup,SP112867,1,,321336
3,112982117,117173814,dup,SP112867,1,,4191697
5,49441966,68828372,del,SP112867,1,,19386406
9,109939363,111486613,del,SP112867,1,,1547250
4,1756484,1858926,dup,SP112867,1,,102442
8,52748767,54449842,dup,SP112867,1,,1701075
3,32551932,40638932,dup,SP112867,1,,8087000
8,92253549,94719667,dup,SP112867,1,,2466118
5,44016636,44601786,dup,SP112867,1,,585150
3,162629883,179503860,dup,SP112867,1,,16873977
5,98092237,101526081,del,SP112867,1,,3433844
7,32033628,32587358,del,SP112867,1,,553730
19,10229023,10490956,del,SP112867,1,,261933
16,1967207,2304205,dup,SP112867,1,,336998
11,69413524,69448474,del,SP112867,1,,34950
11,2959113,3106977,del,SP112869,1,,147864
11,69383268,69446756,del,SP112869,1,,63488
1,17771528,17879132,del,SP112869,1,,107604
4,1840033,1967347,del,SP112869,1,,127314
22,25644313,25950057,del,SP112869,1,,305744
5,998945,1298756,dup,SP112869,1,,299811
17,78920856,81195210,dup,SP112869,1,,2274354
17,1244575,1354464,del,SP112869,1,,109889
20,60859716,62344800,dup,SP112869,1,,1485084
16,89877620,90120002,dup,SP112869,1,,242382
19,7151705,7290753,del,SP112869,1,,139048
X,1,2430610,dup,SP112869,1,,2430609
7,1,1796621,dup,SP112869,1,,1796620
19,10235082,10398461,del,SP112869,1,,163379
19,2492172,3018843,del,SP112869,1,,526671
1,1821395,3040296,dup,SP112869,1,,1218901
19,50900305,51223767,dup,SP112869,1,,323462
17,27533960,37748494,del,SP112869,1,,10214534
8,145009955,145779413,dup,SP112869,1,,769458
16,88368747,89380549,dup,SP112869,1,,1011802
17,48601144,48716051,dup,SP112869,1,,114907
14,22466851,22893143,dup,SP112869,1,,426292
1,23358543,25155721,del,SP112869,1,,1797178
19,33682658,33807307,dup,SP112869,1,,124649
9,133999082,134104191,del,SP112869,1,,105109
17,46595689,46735290,dup,SP112869,1,,139601
21,39859072,42873810,del,SP112869,1,,3014738
9,138839166,140517485,dup,SP112869,1,,1678319
8,61874532,64213353,del,SP112869,1,,2338821
8,60070179,61679232,del,SP112869,1,,1609053
8,15179665,17426586,del,SP112869,1,,2246921
19,291150,2492172,dup,SP112869,1,,2201022
11,1,2959113,dup,SP112869,1,,2959112
14,105237833,106194497,dup,SP112869,1,,956664
19,7290753,7753427,dup,SP112869,1,,462674
8,11858198,14515041,del,SP112869,1,,2656843
19,3018843,4066666,dup,SP112869,1,,1047823
9,138004111,138839166,del,SP112869,1,,835055
16,89551509,89810201,dup,SP112869,1,,258692
17,38530020,45137281,del,SP112869,1,,6607261
19,40685121,40797357,dup,SP112869,1,,112236
12,58113236,58169893,dup,SP112869,1,,56657
1,1,1715336,dup,SP112869,1,,1715335
4,605598,1840033,dup,SP112869,1,,1234435
11,69446756,69474676,dup,SP112869,1,,27920
12,132618393,133199945,dup,SP112869,1,,581552
16,388734,2338272,dup,SP112869,1,,1949538
9,133618461,133694896,del,SP112869,1,,76435
11,67298739,67372567,del,SP112869,1,,73828
17,37921844,38474799,del,SP112869,1,,552955
6,35149950,35443341,del,SP112869,1,,293391
12,93397713,94383158,del,SP112869,1,,985445
18,52628391,55279471,del,SP112869,1,,2651080
X,153308196,153555088,del,SP112869,1,,246892
8,143216149,143631476,dup,SP112869,1,,415327
17,48290671,48601144,del,SP112869,1,,310473
2,65331726,65771960,del,SP112869,1,,440234
16,89380549,89551509,del,SP112869,1,,170960
2,47607614,48851587,del,SP112869,1,,1243973
10,43526420,43639591,dup,SP112869,1,,113171
1,11860382,12064852,del,SP112869,1,,204470
16,87577316,87907297,del,SP112871,1,,329981
11,69475291,69574479,dup,SP112871,1,,99188
19,5275308,5749279,dup,SP112871,1,,473971
9,137633800,138969890,dup,SP112871,1,,1336090
19,42513154,42720039,dup,SP112871,1,,206885
1,17673605,17886160,dup,SP112871,1,,212555
1,6245454,6477568,dup,SP112871,1,,232114
19,38759348,39281617,dup,SP112871,1,,522269
10,46971831,48453284,dup,SP112871,1,,1481453
22,43426796,43774169,dup,SP112871,1,,347373
14,106215461,106950798,dup,SP112871,1,,735337
1,2097466,3040296,del,SP112871,1,,942830
7,67461786,67887103,dup,SP112871,1,,425317
19,10304672,11395349,dup,SP112871,1,,1090677
16,80916874,81422353,del,SP112871,1,,505479
20,59831885,60669341,dup,SP112871,1,,837456
17,77171881,78329627,dup,SP112871,1,,1157746
12,1279858,1513770,del,SP112871,1,,233912
8,8094763,43247616,del,SP112871,1,,35152853
19,18195476,18287397,del,SP112871,1,,91921
16,1953317,2588221,del,SP112871,1,,634904
X,1,2693433,dup,SP112871,1,,2693432
22,48536043,50289819,dup,SP112871,1,,1753776
11,63748769,63918687,del,SP112871,1,,169918
20,60881066,61476856,del,SP112871,1,,595790
16,89374044,89568917,dup,SP112871,1,,194873
22,24333003,24395343,dup,SP112871,1,,62340
22,19690936,19843335,del,SP112871,1,,152399
11,2959113,3106977,dup,SP112871,1,,147864
7,96753034,97017586,del,SP112871,1,,264552
19,3349585,4112985,del,SP112871,1,,763400
4,105278229,105590690,dup,SP112871,1,,312461
2,25372191,26776862,del,SP112871,1,,1404671
19,49013839,49515878,dup,SP112871,1,,502039
6,31637339,31926290,dup,SP112871,1,,288951
17,78915889,81195210,del,SP112871,1,,2279321
3,69066038,73443579,del,SP112871,1,,4377541
19,45956983,46256258,dup,SP112871,1,,299275
5,987553,1295326,del,SP112871,1,,307773
17,1327055,1400691,del,SP112871,1,,73636
17,48616977,48715058,del,SP112871,1,,98081
16,32546809,33928041,del,SP112871,1,,1381232
11,69434843,69449631,dup,SP112871,1,,14788
3,13139305,13453810,dup,SP112871,1,,314505
8,1,7004147,del,SP112871,1,,7004146
16,88368747,89374044,del,SP112871,1,,1005297
5,566607,987553,dup,SP112871,1,,420946
20,1,26309255,del,SP112871,1,,26309254
16,71691561,74254391,del,SP112871,1,,2562830
19,4112985,4435929,dup,SP112871,1,,322944
19,7229154,7561241,del,SP112871,1,,332087
6,168590641,169218829,dup,SP112871,1,,628188
16,572747,1587082,del,SP112871,1,,1014335
1,3652763,3815250,dup,SP112871,1,,162487
17,76861040,77062048,dup,SP112871,1,,201008
7,157418126,157977187,dup,SP112871,1,,559061
19,17091641,18195476,dup,SP112871,1,,1103835
21,45760837,46821705,dup,SP112871,1,,1060868
10,74171423,98354917,del,SP112871,1,,24183494
17,1,1327055,dup,SP112871,1,,1327054
17,37748494,37832387,del,SP112871,1,,83893
22,44866045,45302981,dup,SP112871,1,,436936
19,40746642,40780533,dup,SP112871,1,,33891
14,105841795,106215461,del,SP112871,1,,373666
17,78780039,78848189,dup,SP112871,1,,68150
22,19843335,19943530,dup,SP112871,1,,100195
8,46896972,47408734,dup,SP112871,1,,511762
19,2390058,3349585,dup,SP112871,1,,959527
1,3587071,3652763,del,SP112871,1,,65692
16,84905083,86316019,del,SP112871,1,,1410936
22,38248378,38743108,dup,SP112871,1,,494730
9,140396299,141213431,dup,SP112871,1,,817132
12,132618393,133185790,del,SP112871,1,,567397
20,61476856,61790586,dup,SP112871,1,,313730
11,68941816,69420774,dup,SP112871,1,,478958
19,50331736,50393650,del,SP112871,1,,61914
11,2812440,2959113,del,SP112871,1,,146673
14,22443892,22749062,dup,SP112871,1,,305170
1,11552495,12021404,dup,SP112871,1,,468909
19,1206268,2390058,del,SP112871,1,,1183790
19,19289236,19638028,dup,SP112871,1,,348792
11,69449631,69475291,del,SP112871,1,,25660
8,11560275,16313619,del,SP112873,1,,4753344
8,8094763,9724108,del,SP112873,1,,1629345
16,46461309,82974721,del,SP112873,1,,36513412
X,1,2711134,dup,SP112873,1,,2711133
21,40779245,42819521,del,SP112873,1,,2040276
16,84880375,87341672,del,SP112873,1,,2461297
X,154923128,155270560,dup,SP112873,1,,347432
13,19084823,67393188,del,SP112873,1,,48308365
8,1,7004147,del,SP112873,1,,7004146
17,19877003,22217883,dup,SP112873,1,,2340880
16,87622417,90354753,del,SP112873,1,,2732336
16,89380549,89551509,del,SP112875,1,,170960
4,1345117,1837195,dup,SP112875,1,,492078
8,143520734,143770217,dup,SP112875,1,,249483
10,24976459,26469135,del,SP112875,1,,1492676
1,215531437,216224860,del,SP112875,1,,693423
22,46540594,46745398,del,SP112875,1,,204804
1,3652763,3815250,del,SP112875,1,,162487
17,21506659,22217883,dup,SP112875,1,,711224
10,17630540,19706175,del,SP112875,1,,2075635
10,27033496,27804670,del,SP112875,1,,771174
5,87975515,96574725,del,SP112875,1,,8599210
X,153297267,153558373,del,SP112875,1,,261106
5,100869794,104605607,del,SP112875,1,,3735813
16,32047666,34777669,dup,SP112875,1,,2730003
2,139047872,142783487,del,SP112875,1,,3735615
10,19857745,23264917,del,SP112875,1,,3407172
17,78932129,81195210,dup,SP112875,1,,2263081
3,173984278,174672445,dup,SP112875,1,,688167
11,2476163,2843196,del,SP112875,1,,367033
X,1,2693433,dup,SP112875,1,,2693432
5,54042822,68828372,del,SP112875,1,,14785550
13,73852696,74539516,del,SP112875,1,,686820
5,180233794,180915260,dup,SP112875,1,,681466
9,138852044,140396299,dup,SP112875,1,,1544255
19,33607093,33796483,dup,SP112875,1,,189390
5,111865656,129677157,del,SP112875,1,,17811501
2,213391168,213518059,dup,SP112875,1,,126891
1,11858250,11975221,del,SP112875,1,,116971
12,132635028,133199945,dup,SP112875,1,,564917
22,19812350,19938495,del,SP112875,1,,126145
1,241006060,241379243,del,SP112875,1,,373183
20,15080374,15401714,dup,SP112875,1,,321340
6,154681588,155057957,dup,SP112875,1,,376369
11,69418603,69449054,del,SP112875,1,,30451
1,1,1715336,dup,SP112875,1,,1715335
19,3018843,3677998,dup,SP112875,1,,659155
1,2100168,3040296,dup,SP112875,1,,940128
11,66508369,67277061,dup,SP112875,1,,768692
5,98442149,100369421,del,SP112875,1,,1927272
16,87951793,88267811,del,SP112875,1,,316018
20,60509034,63025520,dup,SP112875,1,,2516486
17,1230508,1357392,del,SP112875,1,,126884
10,47020034,47557198,del,SP112875,1,,537164
21,46703017,46987215,dup,SP112875,1,,284198
4,170439715,177426336,del,SP112875,1,,6986621
5,100369421,100869794,del,SP112875,1,,500373
11,67277061,67372567,del,SP112875,1,,95506
8,144333873,145779413,dup,SP112875,1,,1445540
4,167657410,168619651,del,SP112875,1,,962241
5,104605607,105158828,dup,SP112875,1,,553221
1,3377883,3652763,dup,SP112875,1,,274880
8,145779413,146364022,del,SP112875,1,,584609
5,1012204,1298756,dup,SP112875,1,,286552
X,84829967,86045371,del,SP112875,1,,1215404
10,15455167,16236113,del,SP112875,1,,780946
22,19938495,20800922,dup,SP112875,1,,862427
11,2959113,3106977,del,SP112875,1,,147864
4,92232515,93173393,dup,SP112875,1,,940878
16,313106,2338272,dup,SP112875,1,,2025166
22,19696421,19812350,dup,SP112875,1,,115929
5,70306678,80034147,del,SP112875,1,,9727469
11,69449054,69474676,dup,SP112875,1,,25622
20,29519156,30496812,dup,SP112875,1,,977656
14,105243024,106248982,dup,SP112875,1,,1005958
10,12731346,15173047,del,SP112875,1,,2441701
12,99076411,99394495,dup,SP112875,1,,318084
19,10229023,10559643,del,SP112875,1,,330620
6,66700180,118973373,del,SP112875,1,,52273193
7,1,1785827,dup,SP112875,1,,1785826
11,1,2476163,dup,SP112875,1,,2476162
8,140933789,141771568,del,SP112875,1,,837779
5,96801294,98442149,del,SP112875,1,,1640855
19,304007,2492172,dup,SP112875,1,,2188165
16,88267811,89380549,dup,SP112875,1,,1112738
19,18212923,18284418,dup,SP112875,1,,71495
12,82770919,84792399,del,SP112875,1,,2021480
19,2492172,3018843,del,SP112875,1,,526671
19,50352131,50401343,dup,SP112875,1,,49212
11,65280802,65697704,dup,SP112875,1,,416902
17,48601144,48760550,dup,SP112875,1,,159406
6,57197653,58399858,dup,SP112875,1,,1202205
19,38759348,39272377,del,SP112875,1,,513029
3,130027765,130607312,dup,SP112875,1,,579547
6,31769939,31933510,del,SP112875,1,,163571
9,137758106,138852044,del,SP112875,1,,1093938
9,133608647,133670152,del,SP112877,1,,61505
6,44204551,50720362,dup,SP112877,1,,6515811
1,144009053,144945839,dup,SP112877,1,,936786
22,19880600,20130651,dup,SP112877,1,,250051
5,13146310,21843021,dup,SP112877,1,,8696711
6,52637273,57484730,dup,SP112877,1,,4847457
2,16071642,16093681,dup,SP112877,1,,22039
17,78781995,78922400,dup,SP112877,1,,140405
6,37359154,41624544,dup,SP112877,1,,4265390
17,72217492,73295298,dup,SP112877,1,,1077806
3,69807383,69883815,dup,SP112877,1,,76432
1,52999284,58051593,dup,SP112877,1,,5052309
3,49891057,49977567,dup,SP112877,1,,86510
4,128733245,135301412,dup,SP112877,1,,6568167
8,128795452,138489633,dup,SP112877,1,,9694181
7,24916376,27846500,dup,SP112877,1,,2930124
8,35514514,36964493,dup,SP112877,1,,1449979
11,48049287,49203695,dup,SP112877,1,,1154408
3,196913776,198022430,dup,SP112877,1,,1108654
3,119332058,119758072,dup,SP112877,1,,426014
11,105560451,107404143,dup,SP112877,1,,1843692
15,73145715,74928213,dup,SP112877,1,,1782498
4,107989519,110401001,dup,SP112877,1,,2411482
1,11266895,14830940,dup,SP112877,1,,3564045
1,180123704,181557681,dup,SP112877,1,,1433977
7,43878390,45949718,dup,SP112877,1,,2071328
21,34569948,35003105,del,SP112877,1,,433157
3,52679647,54659635,dup,SP112877,1,,1979988
7,47344275,55096189,dup,SP112877,1,,7751914
1,231634287,232773806,dup,SP112877,1,,1139519
7,89027016,94801518,dup,SP112877,1,,5774502
11,68063289,69420774,dup,SP112877,1,,1357485
7,140289364,140562593,dup,SP112877,1,,273229
7,15862983,16298752,dup,SP112877,1,,435769
7,121095482,123573144,dup,SP112877,1,,2477662
7,116347629,116434844,dup,SP112877,1,,87215
17,76167259,78522785,dup,SP112877,1,,2355526
16,56445402,56894678,del,SP112877,1,,449276
4,100292623,104676779,dup,SP112877,1,,4384156
11,97286167,101890138,dup,SP112877,1,,4603971
17,48722393,52750351,dup,SP112877,1,,4027958
8,39390007,41212578,dup,SP112877,1,,1822571
15,22752399,33223405,dup,SP112877,1,,10471006
7,157220902,159138663,dup,SP112877,1,,1917761
16,69366613,75228089,del,SP112877,1,,5861476
21,19220600,19888019,del,SP112877,1,,667419
1,147783408,151315049,dup,SP112877,1,,3531641
7,103890875,107089052,dup,SP112877,1,,3198177
15,45370061,48043570,dup,SP112877,1,,2673509
11,39345778,40960090,dup,SP112877,1,,1614312
1,188225391,194035658,dup,SP112877,1,,5810267
5,1,9056334,dup,SP112877,1,,9056333
3,179440877,180776670,dup,SP112877,1,,1335793
7,78050299,81299121,dup,SP112877,1,,3248822
7,34319484,36390831,dup,SP112877,1,,2071347
7,151698314,152093202,dup,SP112877,1,,394888
15,89146821,91389454,dup,SP112877,1,,2242633
4,141754892,143169730,dup,SP112877,1,,1414838
7,61064518,62682005,dup,SP112877,1,,1617487
3,138384720,139386337,dup,SP112877,1,,1001617
6,3633068,4723688,dup,SP112877,1,,1090620
21,25602790,27357634,del,SP112877,1,,1754844
4,188247695,191154276,dup,SP112877,1,,2906581
1,47477180,48393792,dup,SP112877,1,,916612
6,33693591,36724424,dup,SP112877,1,,3030833
8,102921789,124161311,dup,SP112877,1,,21239522
11,41460619,43898058,dup,SP112877,1,,2437439
17,37844480,37881585,dup,SP112877,1,,37105
1,25212487,31329755,dup,SP112877,1,,6117268
1,102524248,109343610,dup,SP112877,1,,6819362
20,14706098,14815554,del,SP112877,1,,109456
3,134698259,136484505,dup,SP112877,1,,1786246
4,156799587,158981204,dup,SP112877,1,,2181617
1,114095197,116099448,dup,SP112877,1,,2004251
1,1578537,2117614,dup,SP112877,1,,539077
20,62360137,63025520,dup,SP112877,1,,665383
3,156860832,170319943,dup,SP112877,1,,13459111
1,22832254,23750356,dup,SP112877,1,,918102
4,88218247,88797152,dup,SP112877,1,,578905
22,38106315,38743108,dup,SP112877,1,,636793
19,40745531,40780533,dup,SP112877,1,,35002
1,162136969,164236410,dup,SP112877,1,,2099441
3,97766996,101174249,dup,SP112877,1,,3407253
1,78950077,81408582,dup,SP112877,1,,2458505
1,8588045,9470211,dup,SP112877,1,,882166
1,87872253,95129467,dup,SP112877,1,,7257214
11,130209090,135006516,dup,SP112877,1,,4797426
3,115670507,117925796,dup,SP112877,1,,2255289
4,106104404,106383781,dup,SP112877,1,,279377
17,56745514,61670016,dup,SP112877,1,,4924502
4,120170680,121701331,dup,SP112877,1,,1530651
17,30214030,36198501,dup,SP112877,1,,5984471
1,68127811,75529338,dup,SP112877,1,,7401527
11,76369747,78573348,dup,SP112877,1,,2203601
18,3518780,5010511,dup,SP112877,1,,1491731
1,42986333,44595138,dup,SP112877,1,,1608805
14,106566869,106784498,dup,SP112877,1,,217629
3,191293420,193443773,dup,SP112877,1,,2150353
3,153106945,156449667,dup,SP112877,1,,3342722
7,1,5625594,dup,SP112877,1,,5625593
5,180331538,180915260,dup,SP112877,1,,583722
2,1,12834204,dup,SP112877,1,,12834203
6,22046499,22858564,dup,SP112877,1,,812065
3,83171711,89426059,dup,SP112877,1,,6254348
17,74319477,75301883,dup,SP112877,1,,982406
16,1,402422,dup,SP112877,1,,402421
6,51644383,51861752,dup,SP112877,1,,217369
2,27303456,27985662,dup,SP112877,1,,682206
3,63245601,69206051,dup,SP112877,1,,5960450
7,6755552,15074186,dup,SP112877,1,,8318634
7,65087552,69276099,dup,SP112877,1,,4188547
5,21975512,45470311,dup,SP112877,1,,23494799
X,1,2693433,dup,SP112877,1,,2693432
7,152565949,154385726,dup,SP112877,1,,1819777
15,69756882,71916579,dup,SP112877,1,,2159697
2,13599538,15043406,dup,SP112877,1,,1443868
7,17659010,20132348,dup,SP112877,1,,2473338
1,81744562,84557435,dup,SP112877,1,,2812873
8,69009996,101181719,dup,SP112877,1,,32171723
19,12265716,13124815,dup,SP112877,1,,859099
7,70221658,72801424,dup,SP112877,1,,2579766
3,75685262,80786573,dup,SP112877,1,,5101311
16,64937577,65344439,del,SP112877,1,,406862
10,46971831,47557198,del,SP112877,1,,585367
1,10676454,11144769,dup,SP112877,1,,468315
1,146786555,147277274,dup,SP112877,1,,490719
17,1,11768517,del,SP112877,1,,11768516
15,94632907,102531392,dup,SP112877,1,,7898485
7,102054447,103498655,dup,SP112877,1,,1444208
3,69912493,71422784,dup,SP112877,1,,1510291
4,153713972,154332954,dup,SP112877,1,,618982
6,42524184,43747530,dup,SP112877,1,,1223346
1,60722234,63905676,dup,SP112877,1,,3183442
17,38600834,41037992,dup,SP112877,1,,2437158
8,142919983,146364022,dup,SP112877,1,,3444039
16,75365063,89868478,del,SP112877,1,,14503415
7,95634042,100664642,dup,SP112877,1,,5030600
11,79710324,81050265,dup,SP112877,1,,1339941
4,113808620,115324738,dup,SP112877,1,,1516118
11,54795357,55674570,dup,SP112877,1,,879213
1,85697997,86452309,dup,SP112877,1,,754312
11,75168496,75903285,dup,SP112877,1,,734789
7,38324164,42803557,dup,SP112877,1,,4479393
15,77502162,78147097,dup,SP112877,1,,644935
11,103211147,105102535,dup,SP112877,1,,1891388
8,124555175,128761270,dup,SP112877,1,,4206095
17,79999194,81195210,dup,SP112877,1,,1196016
15,48612956,50639171,dup,SP112877,1,,2026215
11,87536378,94474010,dup,SP112877,1,,6937632
7,31664348,32628091,dup,SP112877,1,,963743
3,73732134,75445639,dup,SP112877,1,,1713505
1,116654206,121350934,dup,SP112877,1,,4696728
4,137002041,137718614,dup,SP112877,1,,716573
7,73239907,76833143,dup,SP112877,1,,3593236
1,157264033,158279814,dup,SP112877,1,,1015781
6,31589854,32154146,dup,SP112877,1,,564292
3,122889052,129934272,dup,SP112877,1,,7045220
8,1201391,2527098,dup,SP112877,1,,1325707
1,33550178,37341848,dup,SP112877,1,,3791670
1,3652763,7562825,dup,SP112877,1,,3910062
1,37656139,38761616,dup,SP112877,1,,1105477
3,50170003,52388372,dup,SP112877,1,,2218369
4,95146210,96176985,dup,SP112877,1,,1030775
3,183589374,186556246,dup,SP112877,1,,2966872
8,140626017,142386886,dup,SP112877,1,,1760869
3,194014045,195651753,dup,SP112877,1,,1637708
7,83127534,87077818,dup,SP112877,1,,3950284
17,66850357,69324071,dup,SP112877,1,,2473714
15,78899221,83441066,dup,SP112877,1,,4541845
17,11927182,22217883,dup,SP112877,1,,10290701
1,111963482,113112451,dup,SP112877,1,,1148969
4,124900813,125380675,dup,SP112877,1,,479862
22,43410897,43728528,dup,SP112877,1,,317631
17,27863574,29421493,dup,SP112877,1,,1557919
21,40872786,41467150,del,SP112877,1,,594364
8,67820384,68865039,dup,SP112877,1,,1044655
15,36422381,37675565,dup,SP112877,1,,1253184
3,141765275,148678107,dup,SP112877,1,,6912832
4,180635577,181427663,dup,SP112877,1,,792086
3,107887332,113620601,dup,SP112877,1,,5733269
7,132460681,133996414,dup,SP112877,1,,1535733
16,50807847,52061920,del,SP112877,1,,1254073
7,108353664,112460851,dup,SP112877,1,,4107187
7,145850727,147671793,dup,SP112877,1,,1821066
17,42007407,43367825,dup,SP112877,1,,1360418
22,24333003,24409208,dup,SP112877,1,,76205
1,175979372,178418931,dup,SP112877,1,,2439559
11,108684812,109759880,dup,SP112877,1,,1075068
7,55123209,58025423,dup,SP112877,1,,2902214
3,171041542,177344811,dup,SP112877,1,,6303269
1,95771792,99077392,dup,SP112877,1,,3305600
21,30237741,32132095,del,SP112877,1,,1894354
1,17661226,17922096,dup,SP112877,1,,260870
5,9912044,12247613,dup,SP112877,1,,2335569
17,46668875,48041540,dup,SP112877,1,,1372665
8,46896972,67097098,dup,SP112877,1,,20200126
1,183213814,186677959,dup,SP112877,1,,3464145
15,67056866,67729409,dup,SP112877,1,,672543
21,42462843,43025773,del,SP112877,1,,562930
11,69462738,69862904,dup,SP112877,1,,400166
11,62731010,65253516,dup,SP112877,1,,2522506
4,143505108,143779693,dup,SP112877,1,,274585
9,90627286,91209854,del,SP112877,1,,582568
7,135449669,137273663,dup,SP112877,1,,1823994
8,6597670,7004147,dup,SP112879,1,,406477
12,56490396,56619051,dup,SP112879,1,,128655
1,64779662,65874329,del,SP112879,1,,1094667
3,119410247,119704584,dup,SP112879,1,,294337
1,109392869,109993075,del,SP112879,1,,600206
13,95099578,95854785,del,SP112879,1,,755207
22,24335774,24397683,dup,SP112879,1,,61909
3,153513684,155029676,dup,SP112879,1,,1515992
13,48908755,48975226,del,SP112879,1,,66471
X,1,2693433,dup,SP112879,1,,2693432
16,56894678,57191771,dup,SP112879,1,,297093
10,90980661,91319667,del,SP112879,1,,339006
1,6555628,6972800,del,SP112879,1,,417172
1,144009053,145337094,dup,SP112879,1,,1328041
13,76954719,78896041,del,SP112879,1,,1941322
18,18554307,78077248,del,SP112881,1,,59522941
16,75424082,90354753,del,SP112881,1,,14930671
9,133430375,133670152,del,SP112881,1,,239777
18,1,15377471,del,SP112881,1,,15377470
17,7211540,22217883,del,SP112881,1,,15006343
20,13822495,13989425,del,SP112881,1,,166930
16,1557047,2124899,del,SP112881,1,,567852
4,162945377,167075076,del,SP112881,1,,4129699
X,1,2693433,dup,SP112881,1,,2693432
13,43532979,104418481,del,SP112881,1,,60885502
8,8372467,34239810,del,SP112881,1,,25867343
22,24231250,24472125,del,SP112881,1,,240875
16,1,921498,del,SP112881,1,,921497
17,27941137,28664130,del,SP112881,1,,722993
14,106384228,106784498,dup,SP112881,1,,400270
16,46461309,58177679,del,SP112881,1,,11716370
8,35889235,38149976,del,SP112881,1,,2260741
4,118220841,127790361,del,SP112881,1,,9569520
17,38530020,45777337,del,SP112881,1,,7247317
21,36220563,42879785,del,SP112881,1,,6659222
8,131797967,133409236,del,SP112881,1,,1611269
6,6871925,13539704,del,SP112881,1,,6667779
11,85301527,86937459,del,SP112881,1,,1635932
3,52609472,52711829,del,SP112881,1,,102357
10,46571122,47340886,dup,SP112881,1,,769764
16,34248996,34805185,dup,SP112881,1,,556189
11,69480387,69508928,dup,SP112881,1,,28541
9,76580070,78388874,dup,SP112861,1,,1808804
1,68310458,69792920,dup,SP112861,1,,1482462
7,47932932,48203000,dup,SP112861,1,,270068
9,113054500,114143703,dup,SP112861,1,,1089203
3,121386617,198022430,dup,SP112861,1,,76635813
8,68176881,146364022,dup,SP112861,1,,78187141
2,141664714,141811513,del,SP112861,1,,146799
2,140484256,141567155,del,SP112861,1,,1082899
12,83779170,84632865,dup,SP112861,1,,853695
16,32333565,35271725,dup,SP112861,1,,2938160
15,37477755,40102971,del,SP112861,1,,2625216
2,152474177,164017599,del,SP112861,1,,11543422
6,31277845,31340206,dup,SP112861,1,,62361
6,119690685,120503871,del,SP112861,1,,813186
16,71678840,86619638,del,SP112861,1,,14940798
3,116080554,119820183,dup,SP112861,1,,3739629
16,87079419,88039307,del,SP112861,1,,959888
17,78545830,78638652,del,SP112861,1,,92822
8,8094763,32065185,del,SP112861,1,,23970422
14,106369059,106534342,dup,SP112861,1,,165283
X,1,2693433,dup,SP112861,1,,2693432
9,127989113,130033021,dup,SP112861,1,,2043908
6,80977210,119123354,del,SP112861,1,,38146144
14,106566869,106784498,dup,SP112861,1,,217629
10,46571122,48315690,dup,SP112861,1,,1744568
8,1,7004147,del,SP112861,1,,7004146
6,124532264,125624054,del,SP112861,1,,1091790
9,135790950,136635556,dup,SP112861,1,,844606
2,142728357,145935959,del,SP112861,1,,3207602
22,25570840,25870051,dup,SP112861,1,,299211
9,107986607,109631753,dup,SP112861,1,,1645146
6,121045445,123162972,del,SP112861,1,,2117527
1,179334777,180622523,dup,SP112861,1,,1287746
3,1,263326,del,SP112861,1,,263325
1,198726770,249250621,dup,SP112861,1,,50523851
1,175923837,177939337,dup,SP112861,1,,2015500
15,35059533,35744409,del,SP112861,1,,684876
9,109920444,112143480,dup,SP112861,1,,2223036
22,24343908,24392203,del,SP112861,1,,48295
13,31693608,58493025,del,SP112861,1,,26799417
4,99273488,100166146,dup,SP112861,1,,892658
4,89983807,91368501,dup,SP112861,1,,1384694
1,146537262,152396605,dup,SP112861,1,,5859343
2,148351698,151536466,del,SP112861,1,,3184768
7,97835626,98122654,dup,SP112861,1,,287028
9,115029493,125152442,dup,SP112861,1,,10122949
15,32477443,34413256,del,SP112861,1,,1935813
7,1,46480493,dup,SP112861,1,,46480492
9,87151022,106706191,dup,SP112861,1,,19555169
17,57975942,58602612,del,SP112863,1,,626670
5,6937178,7974933,del,SP112863,1,,1037755
15,80235302,88597265,del,SP112863,1,,8361963
16,75527372,76027591,dup,SP112863,1,,500219
1,19072339,20420117,del,SP112863,1,,1347778
1,204096331,204947743,dup,SP112863,1,,851412
22,42019876,42388938,dup,SP112863,1,,369062
11,66008935,67261962,dup,SP112863,1,,1253027
5,94300272,96681669,del,SP112863,1,,2381397
9,128790886,130595217,dup,SP112863,1,,1804331
12,80598431,83169086,del,SP112863,1,,2570655
1,144009053,144946449,dup,SP112863,1,,937396
16,68506331,68847103,dup,SP112863,1,,340772
15,46253139,62511857,del,SP112863,1,,16258718
14,99680687,100713982,dup,SP112863,1,,1033295
5,50757761,52615712,del,SP112863,1,,1857951
4,106434760,106831525,dup,SP112863,1,,396765
21,16827447,19038557,dup,SP112863,1,,2211110
3,41383396,46415882,dup,SP112863,1,,5032486
5,167414331,167974550,dup,SP112863,1,,560219
17,43362925,45311171,del,SP112863,1,,1948246
5,44405171,45385237,del,SP112863,1,,980066
8,66328104,66678311,dup,SP112863,1,,350207
15,40777691,41769007,del,SP112863,1,,991316
12,7869683,8349450,del,SP112863,1,,479767
5,34767841,35293989,del,SP112863,1,,526148
12,86650951,87297515,del,SP112863,1,,646564
9,93945347,128429616,dup,SP112863,1,,34484269
1,28625549,29427462,del,SP112863,1,,801913
15,72535060,73072215,del,SP112863,1,,537155
19,5608176,8510720,dup,SP112863,1,,2902544
5,142154770,142861777,del,SP112863,1,,707007
6,26265923,27424046,dup,SP112863,1,,1158123
18,35346410,38216812,del,SP112863,1,,2870402
22,32817554,33490004,del,SP112863,1,,672450
5,160083349,161586165,del,SP112863,1,,1502816
9,138791286,141213431,dup,SP112863,1,,2422145
15,94786196,96379259,del,SP112863,1,,1593063
18,46250862,48809489,dup,SP112863,1,,2558627
X,47500159,48303963,del,SP112863,1,,803804
12,46702971,47651046,del,SP112863,1,,948075
2,159187827,159774009,dup,SP112863,1,,586182
1,39334912,40035070,del,SP112863,1,,700158
12,101056342,101657622,del,SP112863,1,,601280
17,63592747,64459415,del,SP112863,1,,866668
X,28455106,37356873,del,SP112863,1,,8901767
17,13726968,14808614,del,SP112863,1,,1081646
5,88188244,92274741,del,SP112863,1,,4086497
1,5918704,6996740,del,SP112863,1,,1078036
13,20416946,23674845,dup,SP112863,1,,3257899
7,61064518,64160698,dup,SP112863,1,,3096180
15,67309555,68332189,del,SP112863,1,,1022634
9,131866431,133430375,dup,SP112863,1,,1563944
1,11168194,11300505,del,SP112863,1,,132311
18,45399581,46250862,del,SP112863,1,,851281
X,133861900,139143373,dup,SP112863,1,,5281473
5,116686563,121453473,del,SP112863,1,,4766910
X,53562098,55727457,del,SP112863,1,,2165359
22,36377977,38557320,del,SP112863,1,,2179343
15,30023504,31448976,del,SP112863,1,,1425472
17,564062,1804750,del,SP112863,1,,1240688
17,73277781,73985334,del,SP112863,1,,707553
12,25347417,28632833,del,SP112863,1,,3285416
10,12623411,16225514,dup,SP112863,1,,3602103
10,4355069,5117458,dup,SP112863,1,,762389
1,17341768,17663704,del,SP112863,1,,321936
15,63470142,66162843,del,SP112863,1,,2692701
12,347692,553923,del,SP112863,1,,206231
5,19258986,22260366,dup,SP112863,1,,3001380
2,19045542,19441223,dup,SP112863,1,,395681
17,9637531,9945649,del,SP112863,1,,308118
3,168842218,170411823,dup,SP112863,1,,1569605
8,19116717,39231745,del,SP112863,1,,20115028
22,44810195,47358323,del,SP112863,1,,2548128
5,176600166,176717752,del,SP112863,1,,117586
1,21978283,22832254,del,SP112863,1,,853971
5,98776642,107336728,del,SP112863,1,,8560086
5,172224710,173859469,del,SP112863,1,,1634759
11,29034040,31644540,dup,SP112863,1,,2610500
8,70126187,79628109,dup,SP112863,1,,9501922
10,112038448,112960685,dup,SP112863,1,,922237
5,2224125,3248501,dup,SP112863,1,,1024376
12,877072,1586479,del,SP112863,1,,709407
16,15514330,16134181,dup,SP112863,1,,619851
16,10819805,11096013,dup,SP112863,1,,276208
12,58165837,61410989,del,SP112863,1,,3245152
5,132253135,132487323,del,SP112863,1,,234188
9,134358873,136943846,dup,SP112863,1,,2584973
12,38860176,42907552,del,SP112863,1,,4047376
10,75224361,76230126,dup,SP112863,1,,1005765
7,51400695,51822966,dup,SP112863,1,,422271
5,76943652,78366233,del,SP112863,1,,1422581
1,45803379,47477180,del,SP112863,1,,1673801
14,68587321,71738310,dup,SP112863,1,,3150989
11,58015287,58315962,dup,SP112863,1,,300675
17,7572149,7602787,del,SP112863,1,,30638
22,24343908,24787505,del,SP112863,1,,443597
17,29432746,29553977,del,SP112863,1,,121231
5,61323347,65644011,del,SP112863,1,,4320664
19,33514120,33781677,dup,SP112863,1,,267557
22,43587524,44190037,del,SP112863,1,,602513
12,15989571,18705293,del,SP112863,1,,2715722
15,102108695,102531392,del,SP112863,1,,422697
12,19130652,19520342,dup,SP112863,1,,389690
11,6335699,7055531,dup,SP112863,1,,719832
5,150982658,151859256,del,SP112863,1,,876598
12,72760960,74364855,del,SP112863,1,,1603895
8,79915258,83709330,dup,SP112863,1,,3794072
10,117433198,121723376,dup,SP112863,1,,4290178
12,31418894,33262405,del,SP112863,1,,1843511
19,10272256,10412067,del,SP112863,1,,139811
8,1,7004147,del,SP112863,1,,7004146
22,39270489,41602068,del,SP112863,1,,2331579
11,58515878,59172272,dup,SP112863,1,,656394
12,117812950,119280922,del,SP112863,1,,1467972
9,8256374,11043286,dup,SP112863,1,,2786912
17,5556308,5977194,del,SP112863,1,,420886
5,93502379,94300272,dup,SP112863,1,,797893
12,90583377,97012412,del,SP112863,1,,6429035
12,44691823,45620272,del,SP112863,1,,928449
21,25244819,25527697,dup,SP112863,1,,282878
5,3248501,5229346,del,SP112863,1,,1980845
5,39320476,42901018,del,SP112863,1,,3580542
16,13438094,14085035,dup,SP112863,1,,646941
5,55617399,59072034,del,SP112863,1,,3454635
12,20221906,20788098,del,SP112863,1,,566192
1,23219822,23829364,del,SP112863,1,,609542
19,40257163,40800481,dup,SP112863,1,,543318
15,91844024,94110077,del,SP112863,1,,2266053
12,104135682,107457874,del,SP112863,1,,3322192
15,26450135,27365830,del,SP112863,1,,915695
5,163444437,164823720,del,SP112863,1,,1379283
X,38208082,47008183,del,SP112863,1,,8800101
22,48371833,51304566,del,SP112863,1,,2932733
4,167359741,167667486,dup,SP112863,1,,307745
15,32514188,36512476,del,SP112863,1,,3998288
9,86537666,87151022,dup,SP112863,1,,613356
5,145192261,146005387,del,SP112863,1,,813126
1,158502585,161402639,dup,SP112863,1,,2900054
18,65647268,72758485,del,SP112863,1,,7111217
14,106384228,106641420,dup,SP112863,1,,257192
X,55782364,57903489,del,SP112863,1,,2121125
18,48809489,60412975,del,SP112863,1,,11603486
1,17771528,17880534,del,SP112863,1,,109006
2,102150246,102871916,dup,SP112863,1,,721670
1,2187585,2991942,dup,SP112863,1,,804357
5,67521538,68248798,del,SP112863,1,,727260
1,73590776,73950002,dup,SP112863,1,,359226
17,49205180,49424627,del,SP112863,1,,219447
15,41912314,43417984,del,SP112863,1,,1505670
15,89443395,90682123,del,SP112863,1,,1238728
22,34510146,35674732,del,SP112863,1,,1164586
18,73036918,78077248,del,SP112863,1,,5040330
8,8094763,18549980,del,SP112863,1,,10455217
17,41204071,41264581,del,SP112863,1,,60510
18,39751249,43075294,del,SP112863,1,,3324045
4,144218869,145364023,dup,SP112863,1,,1145154
5,71192378,75685281,del,SP112863,1,,4492903
10,43245916,43914218,dup,SP112863,1,,668302
5,18026640,19258986,del,SP112863,1,,1232346
1,49971136,52305923,del,SP112863,1,,2334787
4,72186842,73565842,dup,SP112863,1,,1379000
5,82037875,85653226,del,SP112863,1,,3615351
5,157662816,158212309,del,SP112863,1,,549493
2,206386621,208789761,dup,SP112863,1,,2403140
5,136924777,137761849,del,SP112863,1,,837072
4,125179567,125982320,dup,SP112863,1,,802753
17,69288675,70428330,del,SP112863,1,,1139655
5,36711977,37655932,del,SP112863,1,,943955
20,56392978,61720145,dup,SP112863,1,,5327167
15,99593180,100450875,del,SP112863,1,,857695
9,133694896,134006524,dup,SP112863,1,,311628
17,10979974,12878017,del,SP112863,1,,1898043
17,49925029,52181309,del,SP112863,1,,2256280
X,49133469,50975877,del,SP112863,1,,1842408
12,84615738,85992957,del,SP112863,1,,1377219
12,102451381,103255891,dup,SP112863,1,,804510
12,10027396,14813448,del,SP112863,1,,4786052
14,36270698,36722651,dup,SP112863,1,,451953
8,39390007,42603340,del,SP112863,1,,3213333
5,24655770,33561262,del,SP112863,1,,8905492
3,56447379,57397121,dup,SP112863,1,,949742
5,13722326,15549587,del,SP112863,1,,1827261
18,26695383,33994197,del,SP112863,1,,7298814
1,38025845,38453025,del,SP112863,1,,427180
5,168856295,169156747,del,SP112863,1,,300452
2,146112136,147928858,dup,SP112863,1,,1816722
22,42388938,42515209,del,SP112863,1,,126271
1,7778776,8904719,del,SP112863,1,,1125943
8,83709330,146364022,dup,SP112863,1,,62654692
22,28037994,29385497,del,SP112863,1,,1347503
17,3612558,4255259,del,SP112863,1,,642701
11,69446574,69898651,dup,SP112863,1,,452077
1,12355467,16328418,del,SP112863,1,,3972951
5,111839857,115700927,del,SP112863,1,,3861070
17,74787344,77800746,dup,SP112863,1,,3013402
X,51721007,53218145,del,SP112863,1,,1497138
X,1,2693433,dup,SP112863,1,,2693432
11,117994655,121481435,dup,SP112863,1,,3486780
3,185875988,186749467,dup,SP112863,1,,873479
12,48745631,49146260,del,SP112863,1,,400629
15,38190593,40497312,del,SP112863,1,,2306719
8,46896972,146364022,dup,SP112865,1,,99467050
6,1,58770502,dup,SP112865,1,,58770501
16,1,35271725,dup,SP112865,1,,35271724
8,1,7004147,del,SP112865,1,,7004146
8,8094763,40898235,del,SP112865,1,,32803472
3,123592990,171586718,dup,SP112865,1,,47993728
6,61000000,171115067,del,SP112865,1,,110115067
13,19084823,28823637,dup,SP112865,1,,9738814
13,28823637,115169878,del,SP112865,1,,86346241
20,29519156,63025520,dup,SP112865,1,,33506364
8,141409623,141965974,dup,SP112847,1,,556351
12,54755012,55327297,dup,SP112847,1,,572285
3,171982068,182132830,dup,SP112847,1,,10150762
1,58284129,58388565,del,SP112847,1,,104436
3,10217758,11209060,dup,SP112847,1,,991302
17,55547705,71732229,del,SP112847,1,,16184524
6,33539194,33661127,del,SP112847,1,,121933
9,121162158,121785025,dup,SP112847,1,,622867
9,101962761,102853149,dup,SP112847,1,,890388
21,14686828,27195000,dup,SP112847,1,,12508172
4,113353380,132108566,del,SP112847,1,,18755186
6,11264544,11787067,del,SP112847,1,,522523
7,50735512,51152059,dup,SP112847,1,,416547
8,104446512,112375754,dup,SP112847,1,,7929242
9,137422466,141153431,dup,SP112847,1,,3730965
9,115010315,115468756,dup,SP112847,1,,458441
3,187655345,187943103,dup,SP112847,1,,287758
19,31530513,32600680,dup,SP112847,1,,1070167
2,30011960,30069806,dup,SP112847,1,,57846
1,46297485,46628017,del,SP112847,1,,330532
11,46885483,47242038,dup,SP112847,1,,356555
2,23578971,23930549,dup,SP112847,1,,351578
15,26991818,27303099,dup,SP112847,1,,311281
21,36972068,48119895,dup,SP112847,1,,11147827
3,105521182,107844652,dup,SP112847,1,,2323470
7,150577041,159128663,del,SP112847,1,,8551622
12,51415376,52117110,dup,SP112847,1,,701734
3,118099811,118132276,del,SP112847,1,,32465
2,10001,3833516,dup,SP112847,1,,3823515
1,157934926,158023064,dup,SP112847,1,,88138
7,97012604,97182377,del,SP112847,1,,169773
2,100988835,101034132,dup,SP112847,1,,45297
17,46731404,51078138,del,SP112847,1,,4346734
10,343897,680486,dup,SP112847,1,,336589
1,202564093,202733705,dup,SP112847,1,,169612
20,59214303,59799775,dup,SP112847,1,,585472
2,233952850,234131611,dup,SP112847,1,,178761
3,9342265,10062590,dup,SP112847,1,,720325
12,5913675,6444889,dup,SP112847,1,,531214
8,144732434,146304022,dup,SP112847,1,,1571588
8,86208809,86352192,dup,SP112847,1,,143383
9,109084044,110759961,dup,SP112847,1,,1675917
2,15725080,15846826,dup,SP112847,1,,121746
9,87893524,89026432,dup,SP112847,1,,1132908
18,1500837,1990902,dup,SP112847,1,,490065
2,143881339,144103561,del,SP112847,1,,222222
15,25875701,26217209,dup,SP112847,1,,341508
11,109371008,132861797,del,SP112847,1,,23490789
22,19623373,20475914,del,SP112847,1,,852541
11,11990922,12050197,dup,SP112847,1,,59275
7,128608807,129311331,dup,SP112847,1,,702524
2,80520576,80567441,dup,SP112847,1,,46865
8,81431611,81828661,dup,SP112847,1,,397050
12,84900474,87797426,dup,SP112847,1,,2896952
8,98180910,101178122,dup,SP112847,1,,2997212
2,31445153,31508021,dup,SP112847,1,,62868
17,41941473,45377701,del,SP112847,1,,3436228
22,23004985,24066445,del,SP112847,1,,1061460
9,117836294,117964240,dup,SP112847,1,,127946
5,131394594,131407785,del,SP112847,1,,13191
7,149352859,150382436,del,SP112847,1,,1029577
20,43529356,45722180,dup,SP112847,1,,2192824
1,165760480,165830402,dup,SP112847,1,,69922
3,116328487,116781768,dup,SP112847,1,,453281
7,133996414,138451691,dup,SP112847,1,,4455277
17,72120538,72549181,del,SP112847,1,,428643
5,103892962,104412442,dup,SP112847,1,,519480
3,113850210,115310137,dup,SP112847,1,,1459927
10,3140081,3162771,dup,SP112847,1,,22690
1,223625636,223956444,dup,SP112847,1,,330808
8,83234197,86208809,dup,SP112847,1,,2974612
17,40214298,41670758,del,SP112847,1,,1456460
1,242005070,242029626,dup,SP112847,1,,24556
19,10395874,10781738,dup,SP112847,1,,385864
3,170191877,170720485,dup,SP112847,1,,528608
16,66405204,67946664,dup,SP112847,1,,1541460
14,24768382,24910852,dup,SP112847,1,,142470
2,54915621,55017523,dup,SP112847,1,,101902
22,36541079,36771075,del,SP112847,1,,229996
1,45228407,45509031,del,SP112847,1,,280624
8,101302136,104446512,dup,SP112847,1,,3144376
6,129643417,129689853,del,SP112847,1,,46436
7,106668358,107725452,dup,SP112847,1,,1057094
8,141965974,144732434,dup,SP112847,1,,2766460
15,24849145,25331348,dup,SP112847,1,,482203
9,104756119,107691878,dup,SP112847,1,,2935759
2,112411495,112669297,dup,SP112847,1,,257802
1,186015460,194004930,del,SP112847,1,,7989470
6,14584218,15246040,del,SP112847,1,,661822
19,13557147,14210496,dup,SP112847,1,,653349
8,10001,16068932,del,SP112847,1,,16058931
1,230385639,230504615,dup,SP112847,1,,118976
11,55797338,56086453,dup,SP112847,1,,289115
17,34207633,39498903,del,SP112847,1,,5291270
7,146862664,147265183,del,SP112847,1,,402519
9,126750107,127066988,dup,SP112847,1,,316881
1,154168012,155173664,dup,SP112847,1,,1005652
3,189265188,197962430,dup,SP112847,1,,8697242
7,103290713,104141305,dup,SP112847,1,,850592
10,132568848,132840023,dup,SP112847,1,,271175
16,3679242,3743874,del,SP112847,1,,64632
1,226088495,226611836,dup,SP112847,1,,523341
1,14308007,14671474,del,SP112847,1,,363467
12,107608560,107923650,dup,SP112847,1,,315090
4,175365117,175657628,del,SP112847,1,,292511
12,96286146,96360199,dup,SP112847,1,,74053
5,92024321,92400830,del,SP112847,1,,376509
7,42012140,45395855,dup,SP112847,1,,3383715
3,15075313,15509222,dup,SP112847,1,,433909
7,2846432,3043515,dup,SP112847,1,,197083
3,5214571,5325847,dup,SP112847,1,,111276
7,139191154,139725474,dup,SP112847,1,,534320
8,92061932,95241134,dup,SP112847,1,,3179202
21,28077610,30526384,dup,SP112847,1,,2448774
17,39623416,39981333,del,SP112847,1,,357917
20,59799775,60125209,dup,SP112847,1,,325434
2,38122069,38317755,dup,SP112847,1,,195686
8,81828661,83234197,dup,SP112847,1,,1405536
2,11027973,11151057,dup,SP112847,1,,123084
2,60678955,60831479,dup,SP112847,1,,152524
3,142402418,155544052,dup,SP112847,1,,13141634
11,132861797,132949123,dup,SP112847,1,,87326
1,212613898,212736380,dup,SP112847,1,,122482
2,16799314,16898453,dup,SP112847,1,,99139
2,185098143,185850547,dup,SP112847,1,,752404
9,82434270,83660774,dup,SP112847,1,,1226504
9,117803631,117826105,dup,SP112847,1,,22474
19,41344801,41423017,del,SP112847,1,,78216
18,64972210,78016181,del,SP112847,1,,13043971
2,88957456,89619446,dup,SP112847,1,,661990
14,52753845,52796837,dup,SP112847,1,,42992
9,131958101,136231869,dup,SP112847,1,,4273768
17,32992595,33219331,del,SP112847,1,,226736
11,90527958,90827484,dup,SP112847,1,,299526
2,101568969,101624203,dup,SP112847,1,,55234
1,27946745,28954443,del,SP112847,1,,1007698
7,94184056,94838928,dup,SP112847,1,,654872
12,119514873,119961204,dup,SP112847,1,,446331
8,116729948,125724067,dup,SP112847,1,,8994119
9,91114475,97364724,dup,SP112847,1,,6250249
19,22679371,22719201,dup,SP112847,1,,39830
8,137391901,140120741,dup,SP112847,1,,2728840
20,51100014,51303198,dup,SP112847,1,,203184
3,75315583,76118201,dup,SP112847,1,,802618
9,79920419,80394883,dup,SP112847,1,,474464
8,131936578,133429363,dup,SP112847,1,,1492785
8,69350544,80529934,dup,SP112847,1,,11179390
16,67946664,70604617,dup,SP112847,1,,2657953
8,97476819,98180910,dup,SP112847,1,,704091
20,47764965,48265908,dup,SP112847,1,,500943
8,133763626,134947109,dup,SP112847,1,,1183483
9,111547797,112071290,dup,SP112847,1,,523493
17,31835710,32287958,del,SP112847,1,,452248
7,21354724,42012140,dup,SP112847,1,,20657416
16,70604617,70876422,dup,SP112847,1,,271805
9,119839397,120440211,dup,SP112847,1,,600814
8,125765316,131889216,dup,SP112847,1,,6123900
12,121068777,121975953,dup,SP112847,1,,907176
1,181375716,181524706,dup,SP112847,1,,148990
3,25616590,25724507,dup,SP112847,1,,107917
3,93541117,94262477,dup,SP112847,1,,721360
22,42279085,43719444,del,SP112847,1,,1440359
19,5911519,7142357,dup,SP112847,1,,1230838
13,112299824,113055732,dup,SP112847,1,,755908
2,77944130,78379705,dup,SP112847,1,,435575
12,116401102,116713530,dup,SP112847,1,,312428
3,119502003,119533788,dup,SP112847,1,,31785
6,43830546,44293924,dup,SP112847,1,,463378
1,151331812,152169507,dup,SP112847,1,,837695
16,55192710,55512790,dup,SP112847,1,,320080
3,45987662,46638367,dup,SP112847,1,,650705
20,31614652,31777344,dup,SP112847,1,,162692
19,34552683,35268690,dup,SP112847,1,,716007
2,64816006,64928505,dup,SP112847,1,,112499
1,146625534,146765289,dup,SP112847,1,,139755
2,85952684,86049326,dup,SP112847,1,,96642
1,10001,3789504,del,SP112847,1,,3779503
1,156160145,156397030,dup,SP112847,1,,236885
3,38346042,39324903,dup,SP112847,1,,978861
7,45395855,46059077,dup,SP112847,1,,663222
1,160990717,161165917,dup,SP112847,1,,175200
10,5609945,5680904,dup,SP112847,1,,70959
19,8935266,10148968,dup,SP112847,1,,1213702
8,86953991,87892186,dup,SP112847,1,,938195
14,69062817,69189737,dup,SP112847,1,,126920
12,1897404,2943636,dup,SP112847,1,,1046232
8,16512429,39441204,del,SP112847,1,,22928775
9,97713448,99040463,dup,SP112847,1,,1327015
9,38211395,38660113,dup,SP112847,1,,448718
17,76866864,80146586,del,SP112847,1,,3279722
5,3248850,3543277,dup,SP112847,1,,294427
1,42944563,43407635,del,SP112847,1,,463072
12,81681727,82083528,dup,SP112847,1,,401801
14,92275131,92357697,dup,SP112847,1,,82566
5,33994224,35412620,del,SP112847,1,,1418396
16,49432309,49695616,dup,SP112847,1,,263307
7,104411886,106576087,dup,SP112847,1,,2164201
2,26960620,27817552,dup,SP112847,1,,856932
1,43980871,44125944,del,SP112847,1,,145073
2,70645538,70684102,dup,SP112847,1,,38564
8,96487963,97144391,dup,SP112847,1,,656428
12,57637412,58181032,dup,SP112847,1,,543620
12,107923650,112877149,dup,SP112847,1,,4953499
1,11465384,12594438,del,SP112847,1,,1129054
7,19001644,21001297,dup,SP112847,1,,1999653
6,18326401,18614372,del,SP112847,1,,287971
1,9564295,9953990,del,SP112847,1,,389695
8,140120741,140604165,dup,SP112847,1,,483424
22,18069566,18210513,del,SP112847,1,,140947
6,134551555,134730214,del,SP112847,1,,178659
22,29926211,30241210,del,SP112847,1,,314999
3,118132276,119244468,dup,SP112847,1,,1112192
17,32753212,32869725,del,SP112847,1,,116513
17,1,17507717,del,SP112847,1,,17507716
4,167118229,167877050,del,SP112847,1,,758821
6,15823015,15935028,del,SP112847,1,,112013
1,54293946,54758601,del,SP112847,1,,464655
18,27921528,62685720,del,SP112847,1,,34764192
3,133359473,138347972,dup,SP112847,1,,4988499
3,115310137,115559126,del,SP112847,1,,248989
13,86676775,86956640,dup,SP112847,1,,279865
7,21001297,21354724,dup,SP112847,1,,353427
5,100287344,103440669,dup,SP112847,1,,3153325
11,60001,2358849,dup,SP112847,1,,2298848
3,169339826,169666037,dup,SP112847,1,,326211
8,80529934,81431611,dup,SP112847,1,,901677
6,40748465,41299032,dup,SP112847,1,,550567
1,205383070,205683392,dup,SP112847,1,,300322
11,99929289,100349287,dup,SP112847,1,,419998
2,11597174,11828997,dup,SP112847,1,,231823
8,133511026,133763626,dup,SP112847,1,,252600
7,46059077,50658815,dup,SP112847,1,,4599738
3,13124894,14896388,dup,SP112847,1,,1771494
7,16611901,19001644,dup,SP112847,1,,2389743
2,113924899,114082200,dup,SP112847,1,,157301
8,112375754,113247111,dup,SP112847,1,,871357
9,33123448,33177966,dup,SP112847,1,,54518
2,78835111,79020041,dup,SP112847,1,,184930
7,10895330,16273006,dup,SP112847,1,,5377676
22,46714490,47094095,del,SP112847,1,,379605
3,8707269,8831712,dup,SP112847,1,,124443
9,128454939,131283515,dup,SP112847,1,,2828576
2,116863935,143411703,del,SP112847,1,,26547768
16,27359551,27436280,del,SP112847,1,,76729
14,95867079,95910124,dup,SP112847,1,,43045
7,115699397,116856400,del,SP112847,1,,1157003
4,89860613,90949460,del,SP112847,1,,1088847
2,21060793,21525153,dup,SP112847,1,,464360
8,131889216,131936578,dup,SP112847,1,,47362
12,48878787,48954286,dup,SP112847,1,,75499
16,49695616,55041013,dup,SP112847,1,,5345397
20,54086105,54515105,dup,SP112847,1,,429000
3,117173699,118099811,dup,SP112847,1,,926112
19,11229923,11965774,dup,SP112847,1,,735851
2,16050005,16408687,dup,SP112847,1,,358682
8,101178122,101302136,dup,SP112847,1,,124014
8,135287877,136753437,dup,SP112847,1,,1465560
8,97144391,97476819,dup,SP112847,1,,332428
5,149509190,149603970,del,SP112847,1,,94780
7,97313861,100373222,dup,SP112847,1,,3059361
7,100373222,102954559,dup,SP112847,1,,2581337
8,95241134,96487963,dup,SP112847,1,,1246829
9,117826105,117836294,dup,SP112847,1,,10189
2,239550197,240098753,dup,SP112847,1,,548556
12,114303793,116401102,dup,SP112847,1,,2097309
6,5174523,6007424,del,SP112847,1,,832901
8,41794918,43791691,dup,SP112847,1,,1996773
10,47595744,48442709,dup,SP112847,1,,846965
3,94262477,102053470,del,SP112847,1,,7790993
7,127234689,128073059,del,SP112847,1,,838370
11,133093333,134946516,dup,SP112847,1,,1853183
2,91795547,92196400,dup,SP112847,1,,400853
4,7419006,7703840,dup,SP112847,1,,284834
6,16375938,16736218,del,SP112847,1,,360280
9,34498087,34749789,dup,SP112847,1,,251702
1,20395976,20498091,del,SP112847,1,,102115
2,29002874,29323076,dup,SP112847,1,,320202
9,116034696,117437500,dup,SP112847,1,,1402804
17,28574414,30711135,del,SP112847,1,,2136721
2,73679763,73942527,dup,SP112847,1,,262764
7,83989210,86107188,dup,SP112847,1,,2117978
7,129766272,132137727,dup,SP112847,1,,2371455
3,49013297,50170171,dup,SP112847,1,,1156874
9,112500282,113115074,dup,SP112847,1,,614792
6,10224745,10349984,del,SP112847,1,,125239
10,44661027,44900657,dup,SP112847,1,,239630
1,156796873,156889501,del,SP112847,1,,92628
22,21277746,22329199,del,SP112847,1,,1051453
12,55509632,55918607,dup,SP112847,1,,408975
12,5518746,5697176,dup,SP112847,1,,178430
19,15423499,19279781,dup,SP112847,1,,3856282
8,134947109,135287877,dup,SP112847,1,,340768
19,29033531,30950117,dup,SP112847,1,,1916586
8,136753437,137391901,dup,SP112847,1,,638464
8,46857243,69350544,del,SP112847,1,,22493301
16,48558122,49432309,dup,SP112847,1,,874187
8,113531692,116729948,dup,SP112847,1,,3198256
5,6574912,6816175,dup,SP112847,1,,241263
1,229119420,229551826,dup,SP112847,1,,432406
19,12554993,13445176,dup,SP112847,1,,890183
9,103933660,104365469,dup,SP112847,1,,431809
2,75763743,75801587,dup,SP112847,1,,37844
20,45767651,47593646,dup,SP112847,1,,1825995
8,125724067,125765316,dup,SP112847,1,,41249
9,108357314,108505606,dup,SP112847,1,,148292
3,23769251,24143258,dup,SP112847,1,,374007
2,15281857,15372845,dup,SP112847,1,,90988
19,40765087,40846536,del,SP112847,1,,81449
20,48460778,50494745,dup,SP112847,1,,2033967
1,21780345,22355109,del,SP112847,1,,574764
16,55512790,55541753,dup,SP112847,1,,28963
16,55041013,55192710,dup,SP112847,1,,151697
2,42191396,42306733,dup,SP112847,1,,115337
12,52610190,53670775,dup,SP112847,1,,1060585
12,119961204,121068777,dup,SP112847,1,,1107573
1,66635583,66829513,del,SP112847,1,,193930
18,5477133,5645337,dup,SP112847,1,,168204
14,93363030,93520021,del,SP112847,1,,156991
20,23477738,23935930,dup,SP112847,1,,458192
2,86995808,88508393,dup,SP112847,1,,1512585
16,30518068,31200170,del,SP112847,1,,682102
3,108143896,113295847,dup,SP112847,1,,5151951
7,86368507,87266705,dup,SP112847,1,,898198
3,182478725,187466472,dup,SP112847,1,,4987747
8,39441204,41536181,dup,SP112847,1,,2094977
2,10400236,10697357,dup,SP112847,1,,297121
5,10001,2608449,dup,SP112847,1,,2598448
11,108219752,109371008,dup,SP112847,1,,1151256
2,71737155,72184692,dup,SP112847,1,,447537
1,64989208,65178897,del,SP112847,1,,189689
11,45129968,45623400,dup,SP112847,1,,493432
8,89207422,91947625,dup,SP112847,1,,2740203
11,72310832,72414419,del,SP112847,1,,103587
19,7276221,8160406,dup,SP112847,1,,884185
10,58498694,58960207,dup,SP112847,1,,461513
17,51890808,54740678,del,SP112847,1,,2849870
2,81456200,82065296,dup,SP112847,1,,609096
9,122906251,126276774,dup,SP112847,1,,3370523
5,123534674,124499281,del,SP112847,1,,964607
4,152762984,153110674,del,SP112847,1,,347690
9,90179331,90582171,dup,SP112847,1,,402840
20,60125209,62965520,dup,SP112847,1,,2840311
10,1081276,1718706,dup,SP112847,1,,637430
1,35781637,36940286,del,SP112847,1,,1158649
16,71127699,90294753,del,SP112847,1,,19167054
9,80791876,81098301,dup,SP112847,1,,306425
12,43878171,44108337,dup,SP112847,1,,230166
22,38820930,41938934,del,SP112847,1,,3118004
12,118027355,119514873,dup,SP112847,1,,1487518
12,121975953,133779461,del,SP112847,1,,11803508
3,138447209,141609167,dup,SP112847,1,,3161958
16,17221604,18469293,del,SP112847,1,,1247689
8,87892186,89207422,dup,SP112847,1,,1315236
17,45741904,46426028,del,SP112847,1,,684124
7,107861362,107922511,dup,SP112847,1,,61149
20,52741988,52873967,dup,SP112847,1,,131979
8,41536181,41794918,dup,SP112847,1,,258737
16,24016350,24111721,del,SP112847,1,,95371
9,84278615,85904919,dup,SP112847,1,,1626304
2,219985127,220335711,dup,SP112847,1,,350584
16,55541753,66405204,dup,SP112847,1,,10863451
22,45888460,45989856,del,SP112847,1,,101396
3,60898640,60957218,dup,SP112847,1,,58578
3,171106476,171776103,dup,SP112847,1,,669627
14,43615594,44011217,dup,SP112847,1,,395623
14,20457407,20490372,dup,SP112847,1,,32965
9,119397031,119711260,dup,SP112847,1,,314229
1,84672935,84726302,dup,SP112847,1,,53367
4,143253996,143461852,del,SP112847,1,,207856
7,90918822,91227164,del,SP112847,1,,308342
22,37322749,38643975,del,SP112847,1,,1321226
6,13169487,13270764,del,SP112847,1,,101277
2,97741586,98384843,dup,SP112847,1,,643257
9,75981938,77204238,dup,SP112847,1,,1222300
20,55090610,58714405,dup,SP112847,1,,3623795
3,102053470,105266405,dup,SP112847,1,,3212935
3,119747018,124117402,dup,SP112847,1,,4370384
3,80460609,80893600,dup,SP112847,1,,432991
7,16273006,16611901,dup,SP112847,1,,338895
3,44943246,45279709,dup,SP112847,1,,336463
11,67436625,67663084,dup,SP112847,1,,226459
17,72808545,76497785,del,SP112847,1,,3689240
7,55143405,55603607,dup,SP112847,1,,460202
3,156150320,168936087,dup,SP112847,1,,12785767
7,139725474,139948472,dup,SP112847,1,,222998
19,10388210,10395874,del,SP112847,1,,7664
9,99849059,101884939,dup,SP112847,1,,2035880
2,36560070,36608377,dup,SP112847,1,,48307
12,113423757,114303793,dup,SP112847,1,,880036
19,33007778,33371812,dup,SP112847,1,,364034
12,116713530,118027355,dup,SP112847,1,,1313825
1,165144654,165374285,dup,SP112847,1,,229631
16,19313795,19961720,del,SP112847,1,,647925
2,51978040,52655297,dup,SP112847,1,,677257
5,96377357,96446960,dup,SP112847,1,,69603
7,138451691,139191154,dup,SP112847,1,,739463
1,246770011,246985905,dup,SP112847,1,,215894
6,7768951,8451346,del,SP112847,1,,682395
20,41931801,43398238,dup,SP112847,1,,1466437
11,57054373,57386534,dup,SP112847,1,,332161
8,140604165,141409623,dup,SP112847,1,,805458
17,25940106,26088835,del,SP112847,1,,148729
2,107423911,107492848,dup,SP112847,1,,68937
5,121117268,121719900,del,SP112847,1,,602632
14,27909428,28151936,dup,SP112847,1,,242508
5,25451798,26435324,dup,SP112847,1,,983526
1,152913529,153671280,dup,SP112847,1,,757751
5,35412620,46363991,dup,SP112847,1,,10951371
6,72084250,97298062,del,SP112847,1,,25213812
8,86352192,86953991,dup,SP112847,1,,601799
8,91947625,92061932,dup,SP112847,1,,114307
8,133429363,133511026,dup,SP112847,1,,81663
16,46505821,48558122,dup,SP112847,1,,2052301
8,113247111,113531692,dup,SP112847,1,,284581
3,53714397,54209124,dup,SP112847,1,,494727
3,124281812,133173471,dup,SP112847,1,,8891659
14,76740449,76938574,dup,SP112847,1,,198125
21,31543423,36531941,dup,SP112847,1,,4988518
2,31168555,31222930,dup,SP112847,1,,54375
1,67901906,68279896,del,SP112847,1,,377990
9,71161373,72170869,dup,SP112847,1,,1009496
3,82341926,90331036,dup,SP112847,1,,7989110
15,72497977,72547366,del,SP112847,1,,49389
12,74130104,75380232,dup,SP112847,1,,1250128
1,204282739,204466540,dup,SP112847,1,,183801
2,56398345,56431248,dup,SP112847,1,,32903
17,17507717,18804390,dup,SP112847,1,,1296673
12,37902988,40447476,del,SP112849,1,,2544488
16,88287380,89374044,del,SP112849,1,,1086664
2,1,835001,del,SP112849,1,,835000
7,543224,672519,del,SP112849,1,,129295
X,2263285,2693433,dup,SP112849,1,,430148
10,103657832,104541666,del,SP112849,1,,883834
3,82001790,82910733,dup,SP112849,1,,908943
3,125732342,126262987,dup,SP112849,1,,530645
10,48501806,51791921,del,SP112849,1,,3290115
22,19812350,19943530,dup,SP112849,1,,131180
8,8094763,26236628,del,SP112849,1,,18141865
17,34416687,37834451,del,SP112849,1,,3417764
12,90719334,133851895,del,SP112849,1,,43132561
10,52571185,55364204,del,SP112849,1,,2793019
10,92712691,96173369,del,SP112849,1,,3460678
12,28716549,29364920,del,SP112849,1,,648371
17,25326941,27476454,del,SP112849,1,,2149513
19,2368871,2901687,dup,SP112849,1,,532816
16,83057759,83210353,del,SP112849,1,,152594
10,129639405,130209048,del,SP112849,1,,569643
16,59472324,61000057,del,SP112849,1,,1527733
17,37882467,44002799,del,SP112849,1,,6120332
10,35992261,39146676,del,SP112849,1,,3154415
8,46896972,47343415,dup,SP112849,1,,446443
2,4249596,5797843,del,SP112849,1,,1548247
10,30953576,31835891,del,SP112849,1,,882315
10,121758989,122352264,del,SP112849,1,,593275
1,2093618,2575876,del,SP112849,1,,482258
11,69449631,69473447,del,SP112849,1,,23816
12,9935677,11894987,del,SP112849,1,,1959310
16,27578699,28335774,del,SP112849,1,,757075
16,572747,1557047,del,SP112849,1,,984300
10,84407545,85509738,del,SP112849,1,,1102193
12,71045089,75047715,del,SP112849,1,,4002626
12,88991610,89583831,del,SP112849,1,,592221
19,47306698,47743983,del,SP112849,1,,437285
10,22188692,22878635,del,SP112849,1,,689943
3,162120101,162507077,dup,SP112849,1,,386976
16,72573585,74717436,del,SP112849,1,,2143851
19,49768840,51792441,del,SP112849,1,,2023601
12,50113545,52483207,del,SP112849,1,,2369662
17,78773982,78845651,dup,SP112849,1,,71669
21,29718479,31186431,del,SP112849,1,,1467952
10,117723515,118636027,del,SP112849,1,,912512
2,24181715,28272611,del,SP112849,1,,4090896
3,84031282,85127092,dup,SP112849,1,,1095810
8,145527717,145779413,del,SP112849,1,,251696
12,56674021,57483997,del,SP112849,1,,809976
10,112476775,113814053,del,SP112849,1,,1337278
10,68931568,70151606,del,SP112849,1,,1220038
14,57330366,100877983,del,SP112849,1,,43547617
21,46821705,47144169,del,SP112849,1,,322464
10,3501322,4093422,del,SP112849,1,,592100
12,21718119,27957664,del,SP112849,1,,6239545
12,80188243,82020808,del,SP112849,1,,1832565
17,1,21208532,del,SP112849,1,,21208531
21,39887757,42983270,del,SP112849,1,,3095513
10,108127301,111156979,del,SP112849,1,,3029678
12,43119931,46432124,del,SP112849,1,,3312193
16,67077885,69723834,del,SP112849,1,,2645949
13,19578224,27632266,del,SP112849,1,,8054042
12,4260336,6016369,del,SP112849,1,,1756033
3,128283418,128535532,dup,SP112849,1,,252114
7,914355,1122793,del,SP112849,1,,208438
19,54169950,55115718,del,SP112849,1,,945768
21,15553320,17233441,del,SP112849,1,,1680121
3,163201438,163651079,dup,SP112849,1,,449641
12,68655330,69163665,del,SP112849,1,,508335
8,1,7004147,del,SP112849,1,,7004146
12,58173617,65227680,del,SP112849,1,,7054063
19,15196562,15521046,del,SP112849,1,,324484
3,117635500,118132276,dup,SP112849,1,,496776
10,25399380,26693788,del,SP112849,1,,1294408
11,69473447,69550166,dup,SP112849,1,,76719
12,78253051,78418158,del,SP112849,1,,165107
18,1,15377471,del,SP112849,1,,15377470
3,154693715,155627725,dup,SP112849,1,,934010
18,18554307,78077248,del,SP112849,1,,59522941
2,2028663,2625473,del,SP112849,1,,596810
16,84896717,86929884,del,SP112849,1,,2033167
12,56407754,56483468,del,SP112849,1,,75714
10,114597136,115482894,del,SP112849,1,,885758
10,56951362,58335764,del,SP112849,1,,1384402
10,119355973,120556624,del,SP112849,1,,1200651
17,77171881,77645917,dup,SP112849,1,,474036
3,53380052,82001790,del,SP112849,1,,28621738
10,88499939,88691514,del,SP112849,1,,191575
10,134428360,135534747,del,SP112849,1,,1106387
2,5930667,16068328,del,SP112849,1,,10137661
19,1228731,2368871,del,SP112849,1,,1140140
12,57997888,58098248,del,SP112849,1,,100360
11,63748769,63912826,del,SP112849,1,,164057
10,11500784,13021085,del,SP112849,1,,1520301
19,42304937,42465527,del,SP112849,1,,160590
19,16490208,16874334,del,SP112849,1,,384126
10,32707576,35359063,del,SP112849,1,,2651487
14,102726131,103097781,del,SP112849,1,,371650
16,23009106,25348434,del,SP112849,1,,2339328
10,65830644,67139776,del,SP112849,1,,1309132
22,38542449,38743108,dup,SP112849,1,,200659
10,62962053,64704110,del,SP112849,1,,1742057
2,16093681,23689573,del,SP112849,1,,7595892
X,1,2263285,dup,SP112849,1,,2263284
12,12527686,16701560,del,SP112849,1,,4173874
13,28649609,115169878,del,SP112849,1,,86520269
16,1,572747,dup,SP112849,1,,572746
21,43561900,45947948,del,SP112849,1,,2386048
16,80899403,82136081,del,SP112849,1,,1236678
10,89938001,92025709,del,SP112849,1,,2087708
22,19696421,19812350,del,SP112849,1,,115929
14,106384228,106798215,dup,SP112849,1,,413987
X,1,2703851,dup,SP112851,1,,2703850
8,1,7004147,del,SP112851,1,,7004146
3,93517443,198022430,dup,SP112851,1,,104504987
16,1,35271725,dup,SP112851,1,,35271724
17,13062947,14824852,del,SP112853,1,,1761905
18,57919247,72758485,del,SP112853,1,,14839238
16,88482261,89009822,del,SP112853,1,,527561
10,89268612,89604082,del,SP112853,1,,335470
X,1,2693433,dup,SP112853,1,,2693432
10,47009423,47557198,del,SP112853,1,,547775
1,2093618,2497781,del,SP112853,1,,404163
16,572747,1178948,del,SP112853,1,,606201
19,2523645,3032233,dup,SP112853,1,,508588
18,3701692,6015640,del,SP112853,1,,2313948
22,16054713,17685348,dup,SP112853,1,,1630635
19,1217499,1320068,del,SP112853,1,,102569
9,139388854,139672494,del,SP112853,1,,283640
1,3270559,3652763,del,SP112853,1,,382204
18,74545778,76114492,del,SP112853,1,,1568714
18,826108,3188889,del,SP112853,1,,2362781
17,7583519,12884313,del,SP112853,1,,5300794
18,52699971,57088382,del,SP112853,1,,4388411
18,76854277,78077248,del,SP112853,1,,1222971
16,31952510,33928041,del,SP112853,1,,1975531
10,89641427,90308763,del,SP112853,1,,667336
21,37685638,38306106,del,SP112853,1,,620468
14,105988088,106215461,del,SP112853,1,,227373
21,46601979,48129895,del,SP112855,1,,1527916
22,25805042,26741552,del,SP112855,1,,936510
4,88862675,89409023,del,SP112855,1,,546348
X,1,2693433,dup,SP112855,1,,2693432
2,232944135,233688870,del,SP112855,1,,744735
8,27099857,27854845,del,SP112855,1,,754988
4,146853609,147799927,del,SP112855,1,,946318
1,163423894,164904919,del,SP112855,1,,1481025
10,116561534,117062218,del,SP112855,1,,500684
13,22777677,23956805,del,SP112855,1,,1179128
9,21985897,22003234,dup,SP112855,1,,17337
8,21997941,24277373,del,SP112855,1,,2279432
17,55186976,58009371,del,SP112855,1,,2822395
22,22309706,22582091,dup,SP112855,1,,272385
16,32047666,33727980,del,SP112855,1,,1680314
16,70521789,71268011,del,SP112855,1,,746222
6,49999187,50340450,del,SP112855,1,,341263
9,22003234,22129709,del,SP112855,1,,126475
17,75550132,75854702,del,SP112855,1,,304570
6,50748777,52053709,del,SP112855,1,,1304932
6,61000000,70895165,del,SP112855,1,,9895165
17,42007407,42411166,del,SP112855,1,,403759
6,73200264,73931285,del,SP112855,1,,731021
2,174613534,177409793,del,SP112855,1,,2796259
2,220723320,222824911,del,SP112855,1,,2101591
18,45701609,50026511,del,SP112855,1,,4324902
6,74741426,80286992,del,SP112855,1,,5545566
10,89160668,90184651,del,SP112855,1,,1023983
22,24343908,24392203,del,SP112855,1,,48295
2,72868806,74047668,del,SP112855,1,,1178862
6,80528501,102351179,del,SP112855,1,,21822678
9,98494282,98965450,del,SP112855,1,,471168
13,30957491,74396068,del,SP112855,1,,43438577
16,72328918,90354753,del,SP112855,1,,18025835
X,26218820,29290817,del,SP112857,1,,3071997
13,43648570,86669206,del,SP112857,1,,43020636
5,49441966,54530094,dup,SP112857,1,,5088128
6,94498033,95120999,del,SP112857,1,,622966
6,80393717,84224272,del,SP112857,1,,3830555
18,33319471,34033853,dup,SP112857,1,,714382
12,45784932,47752410,del,SP112857,1,,1967478
2,36784613,48118651,del,SP112857,1,,11334038
8,39390007,42907395,del,SP112857,1,,3517388
6,94023033,94179412,del,SP112857,1,,156379
X,87941274,91957820,del,SP112857,1,,4016546
20,29519156,63025520,dup,SP112857,1,,33506364
8,29055824,39264684,del,SP112857,1,,10208860
8,1,7004147,del,SP112857,1,,7004146
11,69383268,69427990,del,SP112857,1,,44722
7,122064953,122581311,del,SP112857,1,,516358
8,8094763,28322821,del,SP112857,1,,20228058
20,1,26309255,dup,SP112857,1,,26309254
8,142254070,146364022,dup,SP112857,1,,4109952
1,225696575,234758995,del,SP112857,1,,9062420
7,122872964,128007610,del,SP112857,1,,5134646
12,1,30165018,del,SP112857,1,,30165017
X,30597058,32622062,del,SP112857,1,,2025004
6,85666038,87495695,del,SP112857,1,,1829657
5,1,46401271,dup,SP112857,1,,46401270
11,69511638,70032484,del,SP112857,1,,520846
6,92454024,93444100,del,SP112857,1,,990076
8,100978397,142019895,dup,SP112857,1,,41041498
7,96162652,96732938,del,SP112857,1,,570286
X,1,2693433,dup,SP112857,1,,2693432
7,90569556,91754023,del,SP112857,1,,1184467
12,51221782,51958382,dup,SP112859,1,,736600
2,227546633,227764440,del,SP112859,1,,217807
X,153324163,153558373,del,SP112859,1,,234210
6,142874661,164808381,del,SP112859,1,,21933720
11,36936128,50456052,del,SP112859,1,,13519924
12,99555519,102050831,dup,SP112859,1,,2495312
2,185168025,186715942,del,SP112859,1,,1547917
9,133564498,133670152,del,SP112859,1,,105654
6,84268583,132715269,del,SP112859,1,,48446686
1,145034840,145337094,dup,SP112859,1,,302254
12,82212990,82650933,del,SP112859,1,,437943
12,11761723,14029198,del,SP112859,1,,2267475
4,127196462,127544018,del,SP112859,1,,347556
5,84788927,88364356,del,SP112859,1,,3575429
12,40494675,42067954,dup,SP112859,1,,1573279
19,10262326,10477352,del,SP112859,1,,215026
11,1,1684160,dup,SP112859,1,,1684159
13,45303726,81247714,del,SP112859,1,,35943988
5,65288870,68828372,del,SP112859,1,,3539502
5,70306678,80504148,del,SP112859,1,,10197470
16,1,1263755,dup,SP112859,1,,1263754
12,115291173,119387552,dup,SP112859,1,,4096379
12,19278736,23764357,dup,SP112859,1,,4485621
1,213610407,241235817,del,SP112859,1,,27625410
12,80798971,82212990,dup,SP112859,1,,1414019
3,174120648,181416768,del,SP112859,1,,7296120
1,170453538,171008394,del,SP112859,1,,554856
2,140981045,141062500,del,SP112859,1,,81455
12,60251078,66380269,dup,SP112859,1,,6129191
12,14029198,14417002,dup,SP112859,1,,387804
12,18913002,19278736,del,SP112859,1,,365734
16,2135827,2304205,dup,SP112859,1,,168378
12,84364068,88286429,dup,SP112859,1,,3922361
2,139347859,139793483,del,SP112859,1,,445624
X,1,2693433,dup,SP112859,1,,2693432
12,77475288,77914305,dup,SP112859,1,,439017
12,46472733,48067053,dup,SP112859,1,,1594320
12,24240868,28016230,dup,SP112859,1,,3775362
3,47062546,47184621,del,SP112859,1,,122075
5,98244788,130348281,del,SP112859,1,,32103493
18,26710297,27423157,dup,SP112859,1,,712860
12,14772971,18913002,dup,SP112859,1,,4140031
12,11054985,11479741,del,SP112859,1,,424756
5,151004814,154037179,del,SP112859,1,,3032365
2,141157418,164830059,del,SP112859,1,,23672641
6,80933037,81944492,del,SP112859,1,,1011455
11,69413524,69446574,del,SP112859,1,,33050
3,96302220,101386215,del,SP112859,1,,5083995
12,69237383,75501959,dup,SP112859,1,,6264576
12,54749337,55839759,dup,SP112859,1,,1090422
12,78531949,79542995,dup,SP112859,1,,1011046
16,1,1285563,dup,SP112839,1,,1285562
11,68291363,68703400,del,SP112839,1,,412037
16,29664735,32333565,dup,SP112839,1,,2668830
8,8094763,29928961,del,SP112839,1,,21834198
16,46461309,58177679,del,SP112839,1,,11716370
11,12030761,13167195,del,SP112839,1,,1136434
8,46896972,146364022,dup,SP112839,1,,99467050
X,1,2693433,dup,SP112839,1,,2693432
9,21955564,21975767,del,SP112839,1,,20203
1,14287487,15618663,del,SP112839,1,,1331176
11,9772375,11001064,del,SP112839,1,,1228689
14,106588216,106816366,dup,SP112839,1,,228150
16,89140893,90354753,del,SP112839,1,,1213860
17,5084542,5278541,del,SP112839,1,,193999
8,37836444,43767534,dup,SP112839,1,,5931090
3,71119348,72875441,del,SP112839,1,,1756093
14,106384228,106534342,dup,SP112839,1,,150114
22,41991570,43577005,del,SP112839,1,,1585435
16,58436153,88342973,del,SP112839,1,,29906820
16,33727980,35271725,dup,SP112839,1,,1543745
22,27146095,34388018,del,SP112839,1,,7241923
3,31506218,32137274,del,SP112839,1,,631056
17,5447050,6337459,del,SP112839,1,,890409
17,6952096,7733257,del,SP112839,1,,781161
4,158594276,162196002,del,SP112839,1,,3601726
8,33316255,37836444,del,SP112839,1,,4520189
8,1,7004147,del,SP112839,1,,7004146
8,32360617,33316255,dup,SP112839,1,,955638
6,85391033,126088449,del,SP112839,1,,40697416
16,2241338,28270706,dup,SP112839,1,,26029368
X,58036276,58470802,del,SP112841,1,,434526
Y,20810616,24510481,del,SP112841,1,,3699865
2,135816691,141066147,del,SP112841,1,,5249456
8,3475518,7004147,del,SP112841,1,,3528629
8,1,3453258,del,SP112841,1,,3453257
19,51807615,59128983,dup,SP112841,1,,7321368
8,8094763,33095952,del,SP112841,1,,25001189
8,33095952,43767534,dup,SP112841,1,,10671582
6,90739425,93774591,del,SP112841,1,,3035166
10,42413322,55213916,del,SP112841,1,,12800594
13,46132372,48656065,del,SP112841,1,,2523693
14,105917368,106287213,del,SP112841,1,,369845
1,238285654,249250621,dup,SP112841,1,,10964967
Y,16687201,19516141,del,SP112841,1,,2828940
16,6375771,22747411,dup,SP112841,1,,16371640
3,115269253,198022430,dup,SP112841,1,,82753177
1,144009053,215855477,dup,SP112841,1,,71846424
16,46461309,82136081,del,SP112841,1,,35674772
3,93517443,115269253,del,SP112841,1,,21751810
16,84880375,89067085,del,SP112841,1,,4186710
14,106287213,107349540,dup,SP112841,1,,1062327
X,1,2709287,dup,SP112841,1,,2709286
8,46997244,144803357,dup,SP112841,1,,97806113
16,22747411,35271725,del,SP112841,1,,12524314
18,20565733,78077248,del,SP112843,1,,57511515
21,39945036,42859011,del,SP112843,1,,2913975
X,1,2693433,dup,SP112843,1,,2693432
14,106384228,106650762,dup,SP112843,1,,266534
16,34468168,34823427,dup,SP112843,1,,355259
11,113406236,114838833,del,SP112843,1,,1432597
10,84548703,96704568,del,SP112843,1,,12155865
13,65664867,66030109,del,SP112843,1,,365242
10,79783252,81488105,del,SP112843,1,,1704853
22,51027528,51304566,dup,SP112843,1,,277038
22,24343908,24392203,del,SP112843,1,,48295
6,139238409,141627517,del,SP112843,1,,2389108
8,8094763,38615832,del,SP112843,1,,30521069
8,1,7004147,del,SP112843,1,,7004146
12,110171501,116192758,del,SP112843,1,,6021257
1,73392310,99628768,del,SP112843,1,,26236458
10,15949298,17484579,del,SP112843,1,,1535281
10,11545139,13638265,del,SP112843,1,,2093126
13,73514479,75693814,del,SP112843,1,,2179335
19,40685121,40793476,dup,SP112845,1,,108355
12,58114544,58163226,dup,SP112845,1,,48682
5,63497368,68828372,del,SP112845,1,,5331004
X,61732394,118686082,del,SP112845,1,,56953688
16,2038317,2318368,dup,SP112845,1,,280051
5,62670654,63497368,dup,SP112845,1,,826714
8,3932385,7004147,del,SP112845,1,,3071762
6,64992797,118209615,del,SP112845,1,,53216818
11,1,802466,dup,SP112845,1,,802465
5,27939958,28933279,del,SP112845,1,,993321
8,8094763,30956270,del,SP112845,1,,22861507
X,2693433,7342724,del,SP112845,1,,4649291
16,63425137,64909172,del,SP112845,1,,1484035
22,24343908,24392203,del,SP112845,1,,48295
Y,12500000,19516141,del,SP112845,1,,7016141
11,37403276,39484251,del,SP112845,1,,2080975
1,180582374,185722017,del,SP112845,1,,5139643
2,114861793,153593005,del,SP112845,1,,38731212
Y,5888143,10010068,del,SP112845,1,,4121925
5,82138567,99409947,del,SP112845,1,,17271380
5,162994516,164015601,del,SP112845,1,,1021085
X,8381750,58470802,del,SP112845,1,,50089052
2,185942782,187220182,del,SP112845,1,,1277400
5,70306678,80066418,del,SP112845,1,,9759740
X,1,2693433,dup,SP112845,1,,2693432
X,121150814,155270560,del,SP112845,1,,34119746
16,66488658,87129132,del,SP112845,1,,20640474
1,156836105,179684071,del,SP112845,1,,22847966
11,22426751,24510518,del,SP112845,1,,2083767
17,79929874,81195210,dup,SP112845,1,,1265336
3,117535657,118600047,del,SP112845,1,,1064390
Y,20810616,24510481,del,SP112845,1,,3699865
17,37748494,37981403,dup,SP112845,1,,232909
5,49441966,62670654,del,SP112845,1,,13228688
3,75203428,76688702,del,SP112845,1,,1485274
20,61807204,62344800,dup,SP112827,1,,537596
X,153308196,153558373,del,SP112827,1,,250177
8,144991870,145774026,dup,SP112827,1,,782156
16,1587082,1978692,del,SP112827,1,,391610
16,88354041,89374044,dup,SP112827,1,,1020003
17,77234625,78164629,del,SP112827,1,,930004
16,89877620,90020575,dup,SP112827,1,,142955
19,10229023,10387007,del,SP112827,1,,157984
17,7622972,7969688,del,SP112827,1,,346716
1,228196910,228453339,del,SP112827,1,,256429
6,31864624,31933510,del,SP112827,1,,68886
8,1,7004147,del,SP112827,1,,7004146
21,46779962,46963419,dup,SP112827,1,,183457
21,45255304,45822184,del,SP112827,1,,566880
11,67298739,67376865,del,SP112827,1,,78126
12,132648507,133185790,dup,SP112827,1,,537283
7,151850,1796621,dup,SP112827,1,,1644771
11,69399532,69449054,del,SP112827,1,,49522
19,42778079,42924151,dup,SP112827,1,,146072
11,2720642,2959113,dup,SP112827,1,,238471
2,242477232,242843713,dup,SP112827,1,,366481
19,1203318,2343952,dup,SP112827,1,,1140634
1,3654905,3813295,del,SP112827,1,,158390
15,39962150,40706095,del,SP112827,1,,743945
17,7520471,7602787,del,SP112827,1,,82316
5,137118469,139002940,del,SP112827,1,,1884471
9,138867174,140371343,dup,SP112827,1,,1504169
1,2100168,3040296,dup,SP112827,1,,940128
14,106309305,106784498,dup,SP112827,1,,475193
4,1834550,1948557,del,SP112827,1,,114007
10,46571122,47340886,dup,SP112827,1,,769764
5,112461903,136024438,del,SP112827,1,,23562535
1,227009051,227920921,del,SP112827,1,,911870
14,22545821,22767157,dup,SP112827,1,,221336
16,89374044,89877620,del,SP112827,1,,503576
1,3259523,3654905,dup,SP112827,1,,395382
1,212162626,212735697,del,SP112827,1,,573071
5,55465387,68828372,del,SP112827,1,,13362985
5,70306678,79500039,del,SP112827,1,,9193361
19,3018843,3695325,dup,SP112827,1,,676482
19,40685121,40730972,dup,SP112827,1,,45851
16,1978692,2304205,dup,SP112827,1,,325513
16,87922687,88354041,del,SP112827,1,,431354
17,78932129,81195210,dup,SP112827,1,,2263081
X,929884,2693433,dup,SP112827,1,,1763549
1,183141106,184892919,del,SP112827,1,,1751813
16,540021,1587082,dup,SP112827,1,,1047061
19,282513,1179055,dup,SP112827,1,,896542
8,8094763,43767534,del,SP112827,1,,35672771
11,69449054,69473447,dup,SP112827,1,,24393
17,1244575,1354464,del,SP112827,1,,109889
9,137495922,138867174,del,SP112827,1,,1371252
11,1,2489186,dup,SP112827,1,,2489185
14,105245534,106248982,dup,SP112827,1,,1003448
6,2326078,2911637,dup,SP112827,1,,585559
1,11860382,11944340,del,SP112827,1,,83958
5,1012204,1298756,dup,SP112827,1,,286552
1,838801,1734329,dup,SP112827,1,,895528
4,1765161,1834550,dup,SP112827,1,,69389
2,91795547,92196400,dup,SP112829,1,,400853
3,163183266,164101733,dup,SP112831,1,,918467
20,59444592,60069824,dup,SP112831,1,,625232
3,67846488,68781479,dup,SP112831,1,,934991
2,173872367,175602631,del,SP112831,1,,1730264
X,1,2693433,dup,SP112831,1,,2693432
20,51226082,52487896,dup,SP112831,1,,1261814
17,41657941,44450627,del,SP112831,1,,2792686
21,39859072,42879785,del,SP112831,1,,3020713
20,44573306,45038412,del,SP112831,1,,465106
3,182949060,184029937,dup,SP112831,1,,1080877
7,148684152,153898980,dup,SP112831,1,,5214828
10,48319950,98283682,del,SP112831,1,,49963732
20,47483466,47981554,del,SP112831,1,,498088
3,122649070,124844201,dup,SP112831,1,,2195131
2,16067039,16089487,dup,SP112831,1,,22448
20,37139369,37612525,del,SP112831,1,,473156
22,17659759,18573077,del,SP112831,1,,913318
7,125586728,139300889,dup,SP112831,1,,13714161
7,1,32127243,dup,SP112831,1,,32127242
3,135344347,140457394,dup,SP112831,1,,5113047
3,48458525,58765686,dup,SP112831,1,,10307161
12,57701901,57946607,del,SP112831,1,,244706
10,45023511,46571122,del,SP112831,1,,1547611
7,95687910,96732938,del,SP112831,1,,1045028
20,52864282,53462303,dup,SP112831,1,,598021
3,125659561,127410144,dup,SP112831,1,,1750583
22,21440795,24343908,del,SP112831,1,,2903113
3,165098422,177136858,dup,SP112831,1,,12038436
7,142207157,143133048,dup,SP112831,1,,925891
20,56392978,57555855,del,SP112831,1,,1162877
7,158341973,159138663,dup,SP112831,1,,796690
3,150176333,150967685,dup,SP112831,1,,791352
22,24392203,33643402,del,SP112831,1,,9251199
3,93517443,96893142,dup,SP112831,1,,3375699
3,132156593,133300397,dup,SP112831,1,,1143804
3,60052991,61001805,dup,SP112831,1,,948814
20,55672169,56392978,dup,SP112831,1,,720809
3,88350939,91000000,dup,SP112831,1,,2649061
20,30929407,31780829,dup,SP112831,1,,851422
1,224692671,226824137,del,SP112831,1,,2131466
3,114170744,119108139,dup,SP112831,1,,4937395
3,70599800,72875441,del,SP112831,1,,2275641
3,1,48396944,dup,SP112831,1,,48396943
9,4992648,5638158,del,SP112831,1,,645510
3,179355514,180805457,dup,SP112831,1,,1449943
20,61704279,62368953,dup,SP112831,1,,664674
20,54474530,54873511,dup,SP112831,1,,398981
7,155597114,156780425,dup,SP112831,1,,1183311
7,61064518,73799094,dup,SP112831,1,,12734576
7,74015760,95687910,dup,SP112831,1,,21672150
7,96732938,125388428,dup,SP112831,1,,28655490
20,49902545,50506465,del,SP112831,1,,603920
17,1,11895699,del,SP112831,1,,11895698
3,152665452,155632505,dup,SP112831,1,,2967053
3,61229082,65299225,dup,SP112831,1,,4070143
3,146884374,148800763,dup,SP112831,1,,1916389
20,57806043,58564320,del,SP112831,1,,758277
1,60378174,62321449,del,SP112831,1,,1943275
3,142201956,143537872,dup,SP112831,1,,1335916
20,42424884,43029354,del,SP112831,1,,604470
5,95676669,129029176,del,SP112831,1,,33352507
3,128266515,128894203,dup,SP112831,1,,627688
10,132701965,133835689,dup,SP112831,1,,1133724
9,2079404,3492232,del,SP112831,1,,1412828
6,31249193,31340206,dup,SP112831,1,,91013
3,77393430,81085725,dup,SP112831,1,,3692295
3,156820191,158506579,dup,SP112831,1,,1686388
1,3739897,3806035,dup,SP112831,1,,66138
15,74133049,74328062,dup,SP112831,1,,195013
22,18999647,20756179,dup,SP112831,1,,1756532
22,24343908,24392203,del,SP112831,1,,48295
16,68114025,90354753,del,SP112831,1,,22240728
7,139849184,140476574,dup,SP112831,1,,627390
14,22603547,22744559,del,SP112831,1,,141012
7,32379564,58025423,dup,SP112831,1,,25645859
10,845302,29431075,del,SP112831,1,,28585773
7,145439971,146771546,dup,SP112831,1,,1331575
3,134475564,134880682,dup,SP112831,1,,405118
11,69489156,69508928,dup,SP112831,1,,19772
20,45994331,47483466,dup,SP112831,1,,1489135
3,108436343,109681957,dup,SP112831,1,,1245614
1,3587071,3652763,del,SP112833,1,,65692
16,84085214,86300027,del,SP112833,1,,2214813
11,69473447,69543728,dup,SP112833,1,,70281
8,26466218,27408589,del,SP112833,1,,942371
4,176912337,177699947,del,SP112833,1,,787610
1,2100168,2490590,del,SP112833,1,,390422
21,39863440,42873810,del,SP112833,1,,3010370
22,38549636,38743108,dup,SP112833,1,,193472
3,9962640,10627564,del,SP112833,1,,664924
16,663651,1343822,del,SP112833,1,,680171
16,89161264,89623627,dup,SP112833,1,,462363
19,40745531,40779422,dup,SP112833,1,,33891
5,37727670,38184175,del,SP112833,1,,456505
19,3923091,4112985,del,SP112833,1,,189894
17,712342,1244575,dup,SP112833,1,,532233
3,128373057,128847834,dup,SP112833,1,,474777
10,79756437,90087471,del,SP112833,1,,10331034
17,42235290,43829827,del,SP112833,1,,1594537
X,1,2693433,dup,SP112833,1,,2693432
9,137407480,138471037,dup,SP112833,1,,1063557
11,69449631,69473447,del,SP112833,1,,23816
4,165815017,166404709,del,SP112833,1,,589692
4,181452753,183677903,del,SP112833,1,,2225150
16,20718088,22407759,del,SP112833,1,,1689671
8,5821882,6143780,del,SP112833,1,,321898
12,116724852,117197656,del,SP112833,1,,472804
3,11261088,12460116,del,SP112833,1,,1199028
1,3652763,3813295,dup,SP112833,1,,160532
22,19696421,19880600,del,SP112833,1,,184179
16,23120823,23569357,del,SP112833,1,,448534
2,99759781,100729183,del,SP112833,1,,969402
17,5312421,8147592,del,SP112833,1,,2835171
16,88413688,89161264,del,SP112833,1,,747576
9,139376315,140424060,del,SP112833,1,,1047745
22,50482728,50967743,del,SP112833,1,,485015
19,50354709,50403766,del,SP112833,1,,49057
20,61494027,61852061,dup,SP112833,1,,358034
6,1,391283,dup,SP112833,1,,391282
17,78932129,79363415,del,SP112833,1,,431286
1,11552495,12007888,dup,SP112833,1,,455393
20,35656882,37612525,del,SP112833,1,,1955643
3,71453457,82878665,del,SP112833,1,,11425208
19,1228731,1320068,del,SP112833,1,,91337
9,131889980,132603357,dup,SP112833,1,,713377
12,125033464,125321679,dup,SP112833,1,,288215
19,1,1882115,dup,SP112835,1,,1882114
19,51865705,59128983,dup,SP112835,1,,7263278
1,237510293,237936052,del,SP112835,1,,425759
16,81379980,82587479,del,SP112835,1,,1207499
10,42413322,43128024,dup,SP112835,1,,714702
8,46896972,47443236,dup,SP112835,1,,546264
12,56043873,57192306,dup,SP112835,1,,1148433
5,70306678,74114624,del,SP112835,1,,3807946
4,144993734,145849702,del,SP112835,1,,855968
12,37902988,38527992,dup,SP112835,1,,625004
8,144786051,146364022,dup,SP112835,1,,1577971
17,79419492,81195210,dup,SP112835,1,,1775718
3,184121447,186674261,dup,SP112835,1,,2552814
1,84180596,95342608,del,SP112835,1,,11162012
5,32107257,32196846,dup,SP112835,1,,89589
X,1,2693433,dup,SP112835,1,,2693432
14,93016955,93330076,del,SP112835,1,,313121
5,49441966,57667424,del,SP112835,1,,8225458
4,1,40766095,dup,SP112835,1,,40766094
1,232784502,233623325,del,SP112835,1,,838823
6,108566479,116801308,del,SP112835,1,,8234829
12,33523751,35800000,dup,SP112835,1,,2276249
1,95882437,101201054,del,SP112835,1,,5318617
13,40183050,41134728,del,SP112835,1,,951678
12,61085714,133851895,dup,SP112835,1,,72766181
16,85705514,86300027,del,SP112835,1,,594513
11,54795357,55480738,dup,SP112835,1,,685381
19,23856404,24544320,dup,SP112835,1,,687916
X,138550917,140233534,del,SP112835,1,,1682617
2,181184504,182520838,del,SP112835,1,,1336334
15,46811339,48414755,dup,SP112835,1,,1603416
19,27754573,28504451,dup,SP112835,1,,749878
3,98323559,139275709,dup,SP112835,1,,40952150
5,58285318,68828372,del,SP112835,1,,10543054
3,142274388,182087387,dup,SP112835,1,,39812999
6,66601169,73428591,del,SP112835,1,,6827422
1,224814281,229494738,del,SP112835,1,,4680457
16,65823804,66356816,del,SP112835,1,,533012
6,81179367,108413694,del,SP112835,1,,27234327
8,116423898,116612361,dup,SP112835,1,,188463
1,211816625,222443755,del,SP112835,1,,10627130
5,75293762,76876792,del,SP112835,1,,1583030
12,57807262,58016812,dup,SP112835,1,,209550
3,197169574,198022430,dup,SP112835,1,,852856
2,48242813,51342168,del,SP112835,1,,3099355
2,173835904,180832727,del,SP112837,1,,6996823
5,86694731,142079232,del,SP112837,1,,55384501
11,69482917,69507950,dup,SP112837,1,,25033
21,39930984,42867981,del,SP112837,1,,2936997
14,106384228,106816366,dup,SP112837,1,,432138
13,44825163,48875863,del,SP112837,1,,4050700
13,48898695,49071975,del,SP112837,1,,173280
3,100325096,100471002,dup,SP112837,1,,145906
X,1,2693433,dup,SP112837,1,,2693432
17,7570116,7589266,del,SP112837,1,,19150
17,38527530,42693149,del,SP112837,1,,4165619
5,59783499,61627522,dup,SP112837,1,,1844023
1,144943249,145288012,dup,SP112817,1,,344763
16,88287380,89374044,dup,SP112817,1,,1086664
17,1230508,1354464,del,SP112817,1,,123956
8,47542653,114040524,dup,SP112817,1,,66497871
12,11941096,12834706,del,SP112817,1,,893610
10,43560071,43639591,dup,SP112817,1,,79520
2,82228224,82710632,del,SP112817,1,,482408
8,39390007,43422025,dup,SP112817,1,,4032018
14,22538147,22754100,dup,SP112817,1,,215953
20,29519156,31232511,dup,SP112817,1,,1713355
16,1,2338272,dup,SP112817,1,,2338271
8,8094763,36772255,del,SP112817,1,,28677492
19,282513,2492172,dup,SP112817,1,,2209659
20,32018136,32288664,dup,SP112817,1,,270528
7,61064518,62444325,del,SP112817,1,,1379807
18,30446989,33085249,del,SP112817,1,,2638260
4,1765161,1834550,dup,SP112817,1,,69389
22,50607452,51072467,dup,SP112817,1,,465015
17,38465496,38530020,dup,SP112817,1,,64524
11,69475291,69511638,del,SP112817,1,,36347
1,3723476,3807779,del,SP112817,1,,84303
5,45894623,46401271,del,SP112817,1,,506648
12,4393703,4897937,del,SP112817,1,,504234
1,175022091,177291520,del,SP112817,1,,2269429
16,19910989,20749278,del,SP112817,1,,838289
16,72343229,72891938,del,SP112817,1,,548709
19,40695062,40733533,dup,SP112817,1,,38471
5,1027402,1295326,dup,SP112817,1,,267924
19,10231505,10551427,del,SP112817,1,,319922
17,37852664,37921844,dup,SP112817,1,,69180
22,28945780,32123996,del,SP112817,1,,3178216
11,50389257,51289351,del,SP112817,1,,900094
X,1,2693433,dup,SP112817,1,,2693432
1,180930779,192989649,del,SP112817,1,,12058870
20,33443831,63025520,dup,SP112817,1,,29581689
20,31232511,32018136,del,SP112817,1,,785625
5,73338221,74252507,del,SP112817,1,,914286
11,2234962,2812440,del,SP112817,1,,577478
7,914355,1549484,dup,SP112817,1,,635129
16,89374044,89623627,del,SP112817,1,,249583
19,42746278,42934627,dup,SP112817,1,,188349
1,1,1409374,dup,SP112817,1,,1409373
21,46703017,46963419,dup,SP112817,1,,260402
20,18190126,26309255,dup,SP112817,1,,8119129
11,69319304,69449054,del,SP112817,1,,129750
14,105012644,106248982,dup,SP112817,1,,1236338
17,48616977,48716608,dup,SP112817,1,,99631
8,36772255,39231745,dup,SP112817,1,,2459490
9,138839166,140424060,dup,SP112817,1,,1584894
7,151850,597442,dup,SP112817,1,,445592
1,2097466,3723476,dup,SP112817,1,,1626010
7,158058461,158948124,dup,SP112817,1,,889663
22,16054713,19913670,del,SP112817,1,,3858957
12,34566769,35800000,del,SP112817,1,,1233231
7,148472040,148617994,dup,SP112817,1,,145954
20,1,18190126,del,SP112817,1,,18190125
5,114290730,116664173,del,SP112817,1,,2373443
19,50352131,50403766,dup,SP112817,1,,51635
1,172434462,174077535,del,SP112817,1,,1643073
3,97174298,98562438,dup,SP112817,1,,1388140
2,242477232,243199373,dup,SP112817,1,,722141
12,58113236,58158726,dup,SP112817,1,,45490
17,7604160,7622972,dup,SP112817,1,,18812
17,78932129,81195210,dup,SP112817,1,,2263081
4,1834550,1963169,del,SP112817,1,,128619
16,89872736,90000104,dup,SP112817,1,,127368
12,854885,3121818,del,SP112817,1,,2266933
22,19988546,22273171,del,SP112817,1,,2284625
9,137758106,138839166,del,SP112817,1,,1081060
11,67277061,67375404,del,SP112817,1,,98343
11,1,2234962,dup,SP112817,1,,2234961
8,1,7004147,del,SP112817,1,,7004146
14,106300146,106784498,dup,SP112817,1,,484352
4,129363770,134059251,del,SP112817,1,,4695481
1,170286229,171204514,del,SP112817,1,,918285
12,21812174,24002090,del,SP112817,1,,2189916
4,12910873,13743818,del,SP112817,1,,832945
10,47005935,48307690,del,SP112817,1,,1301755
14,104693219,105012644,del,SP112817,1,,319425
5,95626106,112265415,del,SP112817,1,,16639309
19,3172344,4106515,dup,SP112817,1,,934171
16,87922687,88287380,del,SP112817,1,,364693
3,13158579,13527891,del,SP112817,1,,369312
20,32288664,33443831,del,SP112817,1,,1155167
X,153308196,153558373,del,SP112817,1,,250177
10,58632141,59115580,del,SP112817,1,,483439
6,72471604,123648502,del,SP112817,1,,51176898
9,113644893,116140781,dup,SP112817,1,,2495888
11,69449054,69475291,dup,SP112817,1,,26237
12,132618393,133469370,dup,SP112817,1,,850977
18,77126895,77720863,dup,SP112817,1,,593968
8,114048185,146364022,dup,SP112817,1,,32315837
17,46623101,46716396,dup,SP112817,1,,93295
11,2812440,2959113,dup,SP112817,1,,146673
5,19422030,38286065,dup,SP112819,1,,18864035
12,76175836,78364626,del,SP112819,1,,2188790
5,179872638,180915260,dup,SP112819,1,,1042622
X,1,2767609,dup,SP112819,1,,2767608
20,30937886,50551788,dup,SP112819,1,,19613902
3,118736644,119812573,dup,SP112819,1,,1075929
16,30653494,35271725,dup,SP112819,1,,4618231
7,116369438,138719605,dup,SP112819,1,,22350167
10,89576893,92883916,del,SP112819,1,,3307023
21,40808501,42819521,del,SP112819,1,,2011020
7,116346757,116369438,del,SP112819,1,,22681
19,46600276,49381237,del,SP112819,1,,2780961
7,61064518,116346757,dup,SP112819,1,,55282239
5,1,10480856,dup,SP112819,1,,10480855
7,140365311,159138663,dup,SP112819,1,,18773352
1,147100736,149778790,del,SP112819,1,,2678054
16,89948971,90354753,dup,SP112819,1,,405782
7,1,55092161,dup,SP112819,1,,55092160
X,154923128,155270560,dup,SP112819,1,,347432
20,52446109,63025520,dup,SP112819,1,,10579411
5,97899985,104488263,del,SP112821,1,,6588278
9,26945855,39184065,del,SP112823,1,,12238210
13,32881648,52758909,del,SP112823,1,,19877261
3,179198898,198022430,del,SP112823,1,,18823532
10,86550930,93472384,del,SP112823,1,,6921454
3,1,10964582,del,SP112823,1,,10964581
1,49000184,88628353,del,SP112823,1,,39628169
X,1,2709287,dup,SP112825,1,,2709286
17,19877003,22217883,dup,SP112825,1,,2340880
X,154923128,155270560,dup,SP112825,1,,347432
16,68860224,90294753,del,SP112807,1,,21434529
22,16267567,19007133,del,SP112807,1,,2739566
8,46857243,59965505,del,SP112807,1,,13108262
18,76669467,78016181,del,SP112807,1,,1346714
9,44057318,45727552,dup,SP112807,1,,1670234
21,14686828,48119895,del,SP112807,1,,33433067
14,38919081,68356440,dup,SP112807,1,,29437359
17,14863987,16726456,dup,SP112807,1,,1862469
18,10001,76669467,dup,SP112807,1,,76659466
9,79323707,141153431,dup,SP112807,1,,61829724
17,1,14863987,del,SP112807,1,,14863986
8,1679607,43791691,del,SP112807,1,,42112084
12,26032600,27257121,dup,SP112807,1,,1224521
2,91795547,92196400,dup,SP112809,1,,400853
17,6891230,11413714,del,SP112809,1,,4522484
17,36501056,46160223,del,SP112809,1,,9659167
20,60001,26319569,del,SP112809,1,,26259568
9,44057318,45727552,dup,SP112809,1,,1670234
5,70306678,72030427,del,SP112811,1,,1723749
14,106309305,106863920,dup,SP112811,1,,554615
X,154923128,155270560,dup,SP112811,1,,347432
18,1,15377471,del,SP112811,1,,15377470
17,19888643,22217883,dup,SP112811,1,,2329240
14,106863920,107349540,del,SP112811,1,,485620
X,1,2678150,dup,SP112811,1,,2678149
5,179872638,180915260,dup,SP112811,1,,1042622
18,18554307,78077248,del,SP112811,1,,59522941
13,45784433,47776607,del,SP112811,1,,1992174
5,66705825,68828372,del,SP112811,1,,2122547
4,15820082,35495484,del,SP112813,1,,19675402
1,221708640,242277631,del,SP112813,1,,20568991
7,61064518,78928236,del,SP112813,1,,17863718
12,120135268,129303934,del,SP112813,1,,9168666
16,24497241,31086425,del,SP112813,1,,6589184
8,5100942,7004147,del,SP112813,1,,1903205
7,85679424,152027799,dup,SP112813,1,,66348375
5,70306678,80808372,del,SP112813,1,,10501694
7,42947031,58025423,dup,SP112813,1,,15078392
5,102299552,105835932,dup,SP112813,1,,3536380
5,105835932,111480888,del,SP112813,1,,5644956
13,39395433,82441439,del,SP112813,1,,43046006
5,85063758,102299552,del,SP112813,1,,17235794
8,8094763,34317032,del,SP112813,1,,26222269
2,126091151,186178199,del,SP112813,1,,60087048
7,1,40183231,dup,SP112813,1,,40183230
7,40183231,42947031,del,SP112813,1,,2763800
10,83960346,109206511,del,SP112813,1,,25246165
7,152027799,159138663,del,SP112813,1,,7110864
17,1,22217883,dup,SP112813,1,,22217882
6,73086680,133831317,del,SP112813,1,,60744637
5,49441966,68828372,del,SP112813,1,,19386406
4,178319755,183677903,del,SP112813,1,,5358148
1,222256031,227182036,dup,SP112815,1,,4926005
3,3148658,6792638,del,SP112815,1,,3643980
8,31371030,32225295,dup,SP112815,1,,854265
5,97374972,100975036,del,SP112815,1,,3600064
8,128787045,130514984,dup,SP112815,1,,1727939
8,98090892,114290862,dup,SP112815,1,,16199970
13,105713667,106417691,del,SP112815,1,,704024
X,1,2693433,dup,SP112815,1,,2693432
10,89636150,92779443,del,SP112815,1,,3143293
8,143636431,144983888,dup,SP112815,1,,1347457
1,153947706,154866855,dup,SP112815,1,,919149
8,1184202,3053674,dup,SP112815,1,,1869472
10,105556761,106028114,del,SP112815,1,,471353
6,161825725,162212432,del,SP112815,1,,386707
8,47785128,71980350,dup,SP112815,1,,24195222
8,3566067,3881546,dup,SP112815,1,,315479
10,87259909,87724122,del,SP112815,1,,464213
1,210951791,211798681,dup,SP112815,1,,846890
1,203965891,204690208,dup,SP112815,1,,724317
4,90506728,91126783,dup,SP112815,1,,620055
8,131432662,141454084,dup,SP112815,1,,10021422
14,106384228,106611348,dup,SP112815,1,,227120
1,173209655,175035410,dup,SP112815,1,,1825755
1,194956887,198375549,dup,SP112815,1,,3418662
10,46971831,47577294,del,SP112815,1,,605463
10,94952799,98033063,del,SP112815,1,,3080264
1,242054586,248813225,dup,SP112815,1,,6758639
1,162531136,165096017,dup,SP112815,1,,2564881
13,49906894,51752866,del,SP112815,1,,1845972
8,72481406,97182838,dup,SP112815,1,,24701432
1,184956518,189659498,dup,SP112815,1,,4702980
10,103091395,104363435,del,SP112815,1,,1272040
1,199015270,199752133,dup,SP112815,1,,736863
1,214822762,221574985,dup,SP112815,1,,6752223
6,263895,658016,dup,SP112815,1,,394121
1,231607571,232587463,dup,SP112815,1,,979892
10,88524612,89613980,del,SP112815,1,,1089368
15,74154005,74344742,dup,SP112815,1,,190737
6,87627504,88070224,del,SP112815,1,,442720
11,69482669,69508928,dup,SP112815,1,,26259
8,4491219,4861433,dup,SP112815,1,,370214
1,144009053,147260521,dup,SP112815,1,,3251468
1,157566115,160508826,dup,SP112815,1,,2942711
5,32107257,32181543,dup,SP112815,1,,74286
1,176099622,182485786,dup,SP112815,1,,6386164
1,170231775,172605944,dup,SP112815,1,,2374169
16,31946977,33727980,dup,SP112815,1,,1781003
8,125531022,128763195,dup,SP112815,1,,3232173
8,114390443,124218720,dup,SP112815,1,,9828277
8,145783379,146364022,dup,SP112815,1,,580643
1,208218877,210225278,dup,SP112815,1,,2006401
1,150273115,151522084,dup,SP112815,1,,1248969
8,1,780451,dup,SP112815,1,,780450
1,232982673,241463048,dup,SP112815,1,,8480375
9,44057318,45727552,dup,SP112795,1,,1670234
21,39872681,42835086,del,SP112797,1,,2962405
1,210469520,228326773,del,SP112797,1,,17857253
X,1,2693433,dup,SP112797,1,,2693432
17,42280082,43573419,del,SP112797,1,,1293337
5,32107257,32166631,dup,SP112797,1,,59374
3,169379853,169900312,dup,SP112797,1,,520459
10,48615170,49635819,del,SP112797,1,,1020649
3,69608834,72875441,del,SP112797,1,,3266607
10,84783424,90550313,del,SP112797,1,,5766889
10,49931724,51553073,del,SP112797,1,,1621349
16,34468168,34823427,dup,SP112797,1,,355259
5,92077171,111071005,del,SP112797,1,,18993834
3,86717058,91000000,del,SP112797,1,,4282942
10,69400384,84079731,del,SP112797,1,,14679347
10,52383623,67688392,del,SP112797,1,,15304769
1,228792270,238897895,del,SP112797,1,,10105625
10,46971831,47577294,del,SP112797,1,,605463
12,12830249,13671528,del,SP112799,1,,841279
X,154923128,155270560,dup,SP112799,1,,347432
1,214652184,229494738,del,SP112799,1,,14842554
2,107321786,109030003,del,SP112799,1,,1708217
12,75992264,77749259,del,SP112799,1,,1756995
8,136984584,137998414,del,SP112799,1,,1013830
12,75435788,75926352,del,SP112799,1,,490564
3,108182031,115853766,del,SP112799,1,,7671735
X,1,2678150,dup,SP112799,1,,2678149
1,73263298,75540251,del,SP112799,1,,2276953
1,208633807,214452785,del,SP112799,1,,5818978
X,153242760,153555088,del,SP112799,1,,312328
12,103202438,104261138,del,SP112799,1,,1058700
5,82561599,83142177,del,SP112799,1,,580578
2,115186401,116058803,del,SP112799,1,,872402
6,78619914,120827522,del,SP112799,1,,42207608
5,97196689,120555396,del,SP112799,1,,23358707
5,70306678,81272293,del,SP112799,1,,10965615
12,20501323,22365297,del,SP112799,1,,1863974
12,16044257,17624479,del,SP112799,1,,1580222
10,92112728,92883916,del,SP112799,1,,771188
12,109131230,110362254,del,SP112799,1,,1231024
X,25949645,35718150,del,SP112799,1,,9768505
12,84632865,85782849,del,SP112799,1,,1149984
12,106356934,107405006,del,SP112799,1,,1048072
1,70375357,72715813,del,SP112799,1,,2340456
6,155518198,168220636,del,SP112799,1,,12702438
1,72715813,73263298,dup,SP112799,1,,547485
5,49566652,68828372,del,SP112799,1,,19261720
2,143276026,172282349,del,SP112801,1,,29006323
19,41387697,42975344,del,SP112801,1,,1587647
16,60688387,61435834,del,SP112801,1,,747447
16,27412990,27715113,del,SP112801,1,,302123
8,48161123,48867859,del,SP112801,1,,706736
17,19820634,21147730,del,SP112801,1,,1327096
6,89195593,90396462,del,SP112801,1,,1200869
11,69482669,69508928,dup,SP112801,1,,26259
17,1,15828576,del,SP112801,1,,15828575
8,117659744,117712730,dup,SP112801,1,,52986
14,106757937,107349540,del,SP112801,1,,591603
16,87837907,89161264,del,SP112801,1,,1323357
19,33397610,33695028,dup,SP112801,1,,297418
22,24337410,24392203,dup,SP112801,1,,54793
16,80845126,81338193,del,SP112801,1,,493067
5,32107257,32181543,dup,SP112801,1,,74286
13,37628846,50778151,del,SP112801,1,,13149305
16,84916971,85674280,del,SP112801,1,,757309
1,3738061,3817541,dup,SP112801,1,,79480
5,1,355647,dup,SP112801,1,,355646
14,20330422,22418309,del,SP112801,1,,2087887
14,23898134,99567367,del,SP112801,1,,75669233
21,39876718,42867981,del,SP112801,1,,2991263
X,1,2693433,dup,SP112801,1,,2693432
14,99855950,103310059,del,SP112801,1,,3454109
8,1,7004147,del,SP112801,1,,7004146
14,104218197,106277821,del,SP112801,1,,2059624
19,2368871,3032233,dup,SP112801,1,,663362
8,129663960,130701870,del,SP112801,1,,1037910
11,78361194,79414550,del,SP112801,1,,1053356
8,8094763,39231745,del,SP112801,1,,31136982
8,39390007,43767534,del,SP112801,1,,4377527
2,89285491,90245035,dup,SP112803,1,,959544
8,11573901,37267133,del,SP112803,1,,25693232
3,118644806,198022430,dup,SP112803,1,,79377624
8,144164807,146364022,dup,SP112803,1,,2199215
13,71071049,75643880,del,SP112803,1,,4572831
8,8270570,10399190,del,SP112803,1,,2128620
X,154923128,155270560,dup,SP112803,1,,347432
6,79750095,125705048,del,SP112803,1,,45954953
2,174364877,175192897,del,SP112803,1,,828020
21,39910304,42819521,del,SP112803,1,,2909217
6,167773542,168364964,del,SP112803,1,,591422
20,61550173,63025520,dup,SP112803,1,,1475347
14,20219083,20646935,dup,SP112803,1,,427852
19,40716085,40793476,dup,SP112803,1,,77391
19,51823059,56212753,dup,SP112803,1,,4389694
4,1,1833118,dup,SP112803,1,,1833117
14,106292885,107349540,dup,SP112803,1,,1056655
17,79439398,81195210,dup,SP112803,1,,1755812
X,1,2743761,dup,SP112803,1,,2743760
7,1,58025423,dup,SP112803,1,,58025422
10,42413322,89604082,del,SP112805,1,,47190760
4,89995966,91164785,dup,SP112805,1,,1168819
11,69480851,69508443,dup,SP112805,1,,27592
9,133576814,133647497,del,SP112805,1,,70683
5,147038128,149468075,dup,SP112805,1,,2429947
2,3832203,84574289,del,SP112805,1,,80742086
13,24080268,25217118,del,SP112805,1,,1136850
5,10160913,12679097,del,SP112805,1,,2518184
1,17693763,17773819,dup,SP112805,1,,80056
13,43880178,115169878,del,SP112805,1,,71289700
10,17773560,39146676,del,SP112805,1,,21373116
13,29364806,30179708,dup,SP112805,1,,814902
9,10265263,10657058,del,SP112805,1,,391795
10,1,17762262,del,SP112805,1,,17762261
17,6815372,7763482,del,SP112805,1,,948110
3,71292652,73158274,del,SP112805,1,,1865622
7,136077581,136545240,dup,SP112805,1,,467659
6,66700180,126942464,del,SP112805,1,,60242284
14,90257950,97249184,del,SP112805,1,,6991234
5,178876104,180215256,del,SP112805,1,,1339152
2,155297624,157183657,del,SP112805,1,,1886033
X,1,2693433,dup,SP112805,1,,2693432
13,26432263,27146483,dup,SP112805,1,,714220
10,89629138,135534747,del,SP112805,1,,45905609
1,53946347,112124335,del,SP112805,1,,58177988
16,72014966,90354753,del,SP112805,1,,18339787
14,22628646,23037640,del,SP112805,1,,408994
13,30930978,33224299,dup,SP112805,1,,2293321
14,106384228,106816366,dup,SP112805,1,,432138
16,2138670,2280001,dup,SP112787,1,,141331
3,77065379,80617750,del,SP112787,1,,3552371
19,48395308,49889757,del,SP112787,1,,1494449
1,23692104,24249652,del,SP112787,1,,557548
4,180500385,182480319,del,SP112787,1,,1979934
6,87291507,125071963,del,SP112787,1,,37780456
2,146755721,147109331,del,SP112787,1,,353610
2,52963778,56290353,del,SP112787,1,,3326575
22,24343908,24392203,del,SP112787,1,,48295
3,76013671,77065379,dup,SP112787,1,,1051708
11,69442840,69467952,dup,SP112787,1,,25112
19,45870765,48161256,del,SP112787,1,,2290491
5,88352148,89258787,del,SP112787,1,,906639
19,10235082,10304672,del,SP112787,1,,69590
2,114650764,146074127,del,SP112787,1,,31423363
19,42924151,44028432,del,SP112787,1,,1104281
11,67261962,67345082,del,SP112787,1,,83120
5,100029306,100703182,del,SP112787,1,,673876
3,81069143,91000000,del,SP112787,1,,9930857
4,605598,930622,dup,SP112787,1,,325024
12,58113236,58153435,dup,SP112787,1,,40199
5,89719485,98457972,del,SP112787,1,,8738487
16,88413688,88925350,dup,SP112787,1,,511662
4,182480319,183096224,dup,SP112787,1,,615905
16,518040,1314398,dup,SP112787,1,,796358
7,731923,1133067,dup,SP112787,1,,401144
4,179585654,180019122,del,SP112787,1,,433468
14,106433324,106937235,dup,SP112787,1,,503911
3,145867838,147832013,del,SP112787,1,,1964175
6,85232098,87068229,del,SP112787,1,,1836131
19,44441221,45479059,del,SP112787,1,,1037838
X,1,2693433,dup,SP112787,1,,2693432
4,136922573,137409109,del,SP112787,1,,486536
3,75348169,76013671,del,SP112787,1,,665502
X,66800574,66853953,del,SP112789,1,,53379
6,76189351,78180935,del,SP112789,1,,1991584
X,1,2693433,dup,SP112789,1,,2693432
X,141719920,142966070,del,SP112789,1,,1246150
X,135428368,136583559,del,SP112789,1,,1155191
16,46461309,48283478,dup,SP112789,1,,1822169
11,105457141,108631282,del,SP112789,1,,3174141
6,105564249,114137694,del,SP112789,1,,8573445
17,1,20905336,del,SP112789,1,,20905335
X,92665156,93441799,del,SP112789,1,,776643
19,53440471,53763085,dup,SP112789,1,,322614
6,114836640,127797534,del,SP112789,1,,12960894
X,151197214,151820316,del,SP112789,1,,623102
5,45865652,46401271,del,SP112789,1,,535619
10,62951444,64081600,del,SP112789,1,,1130156
12,54150929,54466702,del,SP112789,1,,315773
8,1,7004147,del,SP112789,1,,7004146
15,60698027,61925195,del,SP112789,1,,1227168
X,129354243,130943281,del,SP112789,1,,1589038
14,39972726,42564160,del,SP112789,1,,2591434
4,173882977,176529838,del,SP112789,1,,2646861
6,70342267,71501877,del,SP112789,1,,1159610
X,105176582,105937192,del,SP112789,1,,760610
10,73088121,73572789,del,SP112789,1,,484668
9,115676375,117388436,dup,SP112789,1,,1712061
X,120373092,124778407,del,SP112789,1,,4405315
16,48283478,90354753,del,SP112789,1,,42071275
X,85407992,88831947,del,SP112789,1,,3423955
X,111416308,114413888,del,SP112789,1,,2997580
X,80290251,80848111,del,SP112789,1,,557860
10,29329509,29965008,del,SP112789,1,,635499
6,168332928,168590641,dup,SP112789,1,,257713
10,55061968,59376291,del,SP112789,1,,4314323
9,102712439,104056157,dup,SP112789,1,,1343718
21,23349277,39808725,dup,SP112789,1,,16459448
17,21147730,22217883,dup,SP112789,1,,1070153
22,24343908,24392203,del,SP112789,1,,48295
X,81741415,82175119,del,SP112789,1,,433704
22,24392203,26890015,del,SP112789,1,,2497812
4,157414622,159352066,del,SP112789,1,,1937444
10,22123513,22965551,del,SP112789,1,,842038
X,76965479,79197184,del,SP112789,1,,2231705
14,75478842,75632806,del,SP112789,1,,153964
4,164246277,169569982,del,SP112789,1,,5323705
10,90503393,90723285,del,SP112789,1,,219892
6,102775582,103118241,del,SP112789,1,,342659
X,103651881,104414890,del,SP112789,1,,763009
8,46896972,146364022,dup,SP112789,1,,99467050
X,134658053,135182706,del,SP112789,1,,524653
X,108744176,109785289,del,SP112789,1,,1041113
X,125949032,128601675,del,SP112789,1,,2652643
15,50617110,51292529,del,SP112789,1,,675419
6,139879469,141699935,del,SP112789,1,,1820466
6,79517620,99537372,del,SP112789,1,,20019752
21,45908586,47702886,dup,SP112789,1,,1794300
X,91347324,91531041,del,SP112789,1,,183717
X,94180811,97982605,del,SP112789,1,,3801794
X,144912268,145715318,del,SP112789,1,,803050
20,23601227,25368865,del,SP112789,1,,1767638
6,73020839,75850432,del,SP112789,1,,2829593
3,69285067,75879661,del,SP112789,1,,6594594
9,108445955,109534870,dup,SP112789,1,,1088915
X,116299867,118628766,del,SP112789,1,,2328899
21,18537027,22052719,dup,SP112789,1,,3515692
X,65304727,65709164,del,SP112789,1,,404437
13,111709582,114229741,del,SP112789,1,,2520159
10,14222933,14902831,del,SP112789,1,,679898
11,69482917,69507950,dup,SP112789,1,,25033
12,43272215,46449894,del,SP112789,1,,3177679
6,67391162,68820002,del,SP112789,1,,1428840
8,8094763,43767534,del,SP112789,1,,35672771
4,154182116,156386952,del,SP112789,1,,2204836
10,116607626,117797501,del,SP112789,1,,1189875
8,5340884,7004147,del,SP112791,1,,1663263
6,79551342,82750660,del,SP112791,1,,3199318
2,181217832,182453099,del,SP112791,1,,1235267
14,106062431,106189463,dup,SP112791,1,,127032
3,10168528,10222877,dup,SP112791,1,,54349
11,69486551,69508928,dup,SP112791,1,,22377
8,9033108,18251838,del,SP112791,1,,9218730
2,151814294,152643089,del,SP112791,1,,828795
2,170889968,174665020,del,SP112791,1,,3775052
19,52270480,52617977,dup,SP112791,1,,347497
16,80138777,82921741,del,SP112791,1,,2782964
2,141082680,141299370,del,SP112791,1,,216690
16,87577316,87901921,del,SP112791,1,,324605
16,75846111,77408959,del,SP112791,1,,1562848
2,140798406,141052647,del,SP112791,1,,254241
6,95667746,124548984,del,SP112791,1,,28881238
8,19665883,22392346,del,SP112791,1,,2726463
16,71592435,75228089,del,SP112791,1,,3635654
6,76030500,77018463,del,SP112791,1,,987963
4,133128178,134255128,dup,SP112791,1,,1126950
2,145800034,146379799,del,SP112791,1,,579765
6,85951225,90088347,del,SP112791,1,,4137122
11,6620032,6799197,dup,SP112791,1,,179165
2,155179708,156136546,del,SP112791,1,,956838
3,104040559,108404833,del,SP112791,1,,4364274
8,8094763,8803159,del,SP112791,1,,708396
2,178180110,179319226,del,SP112791,1,,1139116
16,85223800,85592298,del,SP112791,1,,368498
6,125318867,127783747,del,SP112791,1,,2464880
6,143125394,145635328,del,SP112791,1,,2509934
16,77673525,78111283,del,SP112791,1,,437758
8,25193637,27285999,del,SP112791,1,,2092362
2,147527910,148884525,del,SP112791,1,,1356615
X,1,2693433,dup,SP112791,1,,2693432
4,65904631,68584229,del,SP112791,1,,2679598
2,141352417,144006347,del,SP112791,1,,2653930
12,56463492,56577507,dup,SP112791,1,,114015
2,134168251,138797689,del,SP112791,1,,4629438
6,130077525,140574928,del,SP112791,1,,10497403
22,24343908,24403467,dup,SP112791,1,,59559
X,154923128,155270560,dup,SP112793,1,,347432
12,9028018,14768837,del,SP112793,1,,5740819
8,12547212,23839946,del,SP112793,1,,11292734
7,107981447,109366353,del,SP112793,1,,1384906
7,109567081,110086974,del,SP112793,1,,519893
X,1,2678150,dup,SP112793,1,,2678149
15,32927425,45163492,del,SP112793,1,,12236067
4,178217136,191154276,del,SP112793,1,,12937140
5,102748236,135140316,del,SP112793,1,,32392080
13,46351270,64647814,del,SP112793,1,,18296544
14,106292885,106937235,dup,SP112793,1,,644350
15,22752399,30279124,dup,SP112793,1,,7526725
15,30279124,32404339,del,SP112793,1,,2125215
19,33663793,33799173,dup,SP112993,1,,135380
1,1,1734329,dup,SP112993,1,,1734328
14,106300146,106740806,dup,SP112993,1,,440660
11,69447626,69473986,dup,SP112993,1,,26360
14,68451033,95236613,del,SP112993,1,,26785580
8,8094763,43767534,del,SP112993,1,,35672771
19,1199871,2390058,dup,SP112993,1,,1190187
17,78932129,80065470,dup,SP112993,1,,1133341
12,101555252,102299401,del,SP112993,1,,744149
7,1,37280368,dup,SP112993,1,,37280367
11,2959113,3106977,del,SP112993,1,,147864
14,104218197,104549166,del,SP112993,1,,330969
10,88957684,89481483,del,SP112993,1,,523799
17,8074597,13862749,del,SP112993,1,,5788152
11,67298739,67372567,del,SP112993,1,,73828
12,7958150,12861679,del,SP112993,1,,4903529
1,3259523,3723476,dup,SP112993,1,,463953
8,1,7004147,del,SP112993,1,,7004146
15,65129083,69588585,del,SP112993,1,,4459502
12,132618393,133185790,dup,SP112993,1,,567397
16,31952510,33727980,del,SP112993,1,,1775470
16,26103077,26405719,dup,SP112993,1,,302642
17,1970652,7602787,del,SP112993,1,,5632135
4,1765161,1834550,dup,SP112993,1,,69389
21,46703017,46963419,dup,SP112993,1,,260402
12,2075676,3348272,del,SP112993,1,,1272596
22,24397683,38407320,del,SP112993,1,,14009637
19,40707981,40794913,dup,SP112993,1,,86932
10,89635039,90373582,del,SP112993,1,,738543
11,115245144,116510973,del,SP112993,1,,1265829
6,85781945,91652560,del,SP112993,1,,5870615
22,39205114,39783798,del,SP112993,1,,578684
20,60881066,62344800,dup,SP112993,1,,1463734
22,20894056,21303525,del,SP112993,1,,409469
1,154905989,155573181,dup,SP112993,1,,667192
10,89481483,89592380,del,SP112993,1,,110897
17,48716608,56463349,del,SP112993,1,,7746741
10,90373582,90776230,del,SP112993,1,,402648
17,37892335,38283659,dup,SP112993,1,,391324
16,89140893,90354753,del,SP112993,1,,1213860
9,138022872,138867174,del,SP112993,1,,844302
X,1,2693433,dup,SP112993,1,,2693432
21,39859072,42873810,del,SP112993,1,,3014738
15,85374429,89893018,del,SP112993,1,,4518589
22,19201218,19938495,del,SP112993,1,,737277
11,1,2502841,dup,SP112993,1,,2502840
16,72905889,88287380,del,SP112993,1,,15381491
4,1834550,1967347,del,SP112993,1,,132797
17,42191817,44845570,del,SP112993,1,,2653753
14,22418309,23053443,dup,SP112993,1,,635134
12,3690995,5568897,del,SP112993,1,,1877902
12,14331406,19752857,del,SP112993,1,,5421451
16,1,2338272,dup,SP112993,1,,2338271
22,38525371,38686896,del,SP112993,1,,161525
11,69383268,69447626,del,SP112993,1,,64358
11,2720642,2959113,dup,SP112993,1,,238471
16,71093900,72180747,del,SP112993,1,,1086847
17,1,1914093,del,SP112993,1,,1914092
17,48070484,48658528,del,SP112993,1,,588044
22,24337410,24397683,dup,SP112993,1,,60273
1,79329167,81476846,del,SP112993,1,,2147679
12,20261600,28654070,del,SP112993,1,,8392470
19,10229023,10387007,del,SP112993,1,,157984
7,37325087,37710599,del,SP112993,1,,385512
3,70512955,72875441,del,SP112993,1,,2362486
14,104549166,106248982,dup,SP112993,1,,1699816
10,89592380,89635039,del,SP112993,1,,42659
4,3943677,7938664,del,SP112993,1,,3994987
1,1821395,3045914,dup,SP112993,1,,1224519
17,69585310,71057939,del,SP112993,1,,1472629
14,104161500,104218197,dup,SP112993,1,,56697
4,151254423,151915783,del,SP112993,1,,661360
1,82768185,120243661,del,SP112993,1,,37475476
12,394288,1594490,del,SP112993,1,,1200202
1,3723476,3813295,del,SP112993,1,,89819
10,43423224,43593010,dup,SP112993,1,,169786
19,584625,1178158,dup,SP112993,1,,593533
9,133439059,133677569,del,SP112993,1,,238510
9,138867174,140355056,dup,SP112993,1,,1487882
5,1012204,1296987,dup,SP112993,1,,284783
3,185188176,186224192,del,SP112993,1,,1036016
15,56781006,62511857,del,SP112993,1,,5730851
7,1,584967,dup,SP112995,1,,584966
19,10231505,10331451,del,SP112995,1,,99946
12,34566769,35800000,del,SP112995,1,,1233231
17,37731338,37830738,dup,SP112995,1,,99400
4,133515855,134378829,dup,SP112995,1,,862974
20,62532676,63025520,del,SP112995,1,,492844
1,3652763,3817541,del,SP112995,1,,164778
16,663651,1604045,dup,SP112995,1,,940394
5,50999135,68828372,del,SP112995,1,,17829237
16,1953317,2338272,dup,SP112995,1,,384955
1,164851863,165399798,del,SP112995,1,,547935
6,85144425,100547722,del,SP112995,1,,15403297
1,144009053,145288012,dup,SP112995,1,,1278959
9,137633800,138852044,del,SP112995,1,,1218244
19,33512057,33777101,dup,SP112995,1,,265044
1,165686166,196290589,del,SP112995,1,,30604423
11,67298739,67372567,del,SP112995,1,,73828
5,45894623,46401271,del,SP112995,1,,506648
5,82202114,83876210,del,SP112995,1,,1674096
11,69475291,69534090,del,SP112995,1,,58799
X,1,2693433,dup,SP112995,1,,2693432
11,103675822,107632917,del,SP112995,1,,3957095
19,703981,2441910,dup,SP112995,1,,1737929
1,152600519,153316707,del,SP112995,1,,716188
17,13255046,13740988,dup,SP112995,1,,485942
16,88413688,89374044,dup,SP112995,1,,960356
11,50407876,51445585,del,SP112995,1,,1037709
11,2720642,2959113,dup,SP112995,1,,238471
4,1833118,1973727,del,SP112995,1,,140609
22,19812350,19943530,del,SP112995,1,,131180
10,46173470,47126844,dup,SP112995,1,,953374
22,24343908,24406725,dup,SP112995,1,,62817
5,70306678,80611592,del,SP112995,1,,10304914
7,61064518,62444325,del,SP112995,1,,1379807
1,1839387,3040296,dup,SP112995,1,,1200909
8,145009955,145779413,dup,SP112995,1,,769458
12,37902988,38426187,del,SP112995,1,,523199
16,89374044,89623627,del,SP112995,1,,249583
11,1976246,2245964,dup,SP112995,1,,269718
X,153296589,153555088,del,SP112995,1,,258499
5,1293142,1373164,del,SP112995,1,,80022
8,47133782,47836867,del,SP112995,1,,703085
2,103670820,127795064,del,SP112995,1,,24124244
1,11853432,12051788,del,SP112995,1,,198356
11,69418603,69452271,del,SP112995,1,,33668
5,998945,1293142,dup,SP112995,1,,294197
4,173766437,175108887,del,SP112995,1,,1342450
X,58098996,58470802,del,SP112995,1,,371806
14,104549166,105294923,dup,SP112995,1,,745757
21,46779962,46987215,dup,SP112995,1,,207253
13,62027676,63028855,del,SP112995,1,,1001179
19,42746278,42924151,dup,SP112995,1,,177873
1,3262989,3652763,dup,SP112995,1,,389774
14,22521588,22782043,dup,SP112995,1,,260455
3,10185006,10227133,dup,SP112995,1,,42127
12,10129671,19740921,del,SP112995,1,,9611250
5,106268001,111676214,del,SP112995,1,,5408213
5,96296219,102250356,del,SP112995,1,,5954137
11,2959113,3106977,del,SP112995,1,,147864
12,132648507,133199945,dup,SP112995,1,,551438
11,69452271,69475291,dup,SP112995,1,,23020
22,19943530,20297266,dup,SP112995,1,,353736
9,70984372,77208313,del,SP112995,1,,6223941
20,60881066,61476856,dup,SP112995,1,,595790
4,1768235,1833118,dup,SP112995,1,,64883
1,1,1715336,dup,SP112995,1,,1715335
17,78920856,81195210,dup,SP112995,1,,2274354
4,120871294,122860215,del,SP112995,1,,1988921
11,1,866467,dup,SP112995,1,,866466
4,175568247,180234853,del,SP112995,1,,4666606
12,58113365,58156753,dup,SP112995,1,,43388
11,2245964,2720642,del,SP112995,1,,474678
19,3383453,4072061,dup,SP112995,1,,688608
9,138852044,140424060,dup,SP112995,1,,1572016
4,171912860,172340450,del,SP112995,1,,427590
2,127859945,163619050,del,SP112995,1,,35759105
5,41295533,41610689,del,SP112995,1,,315156
22,25581178,25950057,del,SP112995,1,,368879
8,43438810,43767534,del,SP112995,1,,328724
16,1604045,1953317,del,SP112995,1,,349272
17,48658528,48720707,dup,SP112995,1,,62179
13,37448627,60880308,del,SP112995,1,,23431681
11,67298739,67372567,del,SP112997,1,,73828
21,39939192,42910593,del,SP112997,1,,2971401
17,37854224,37937149,dup,SP112997,1,,82925
3,66161316,73476251,del,SP112997,1,,7314935
17,79899921,81195210,dup,SP112997,1,,1295289
10,68705637,69203361,del,SP112997,1,,497724
12,10516731,27464504,del,SP112997,1,,16947773
9,139970639,140189423,dup,SP112997,1,,218784
2,164688329,165130385,del,SP112997,1,,442056
14,54961798,56357741,del,SP112997,1,,1395943
10,104440043,104955024,del,SP112997,1,,514981
3,149078412,156229981,del,SP112997,1,,7151569
X,153298433,153555088,del,SP112997,1,,256655
2,96029013,97637710,del,SP112997,1,,1608697
22,19201218,19943530,del,SP112997,1,,742312
10,85972024,86673565,del,SP112997,1,,701541
8,18042270,39264684,del,SP112997,1,,21222414
3,42065260,44377466,del,SP112997,1,,2312206
17,43375549,45241153,del,SP112997,1,,1865604
10,92896532,93719852,del,SP112997,1,,823320
1,100116518,102729742,del,SP112997,1,,2613224
10,26873263,28882193,del,SP112997,1,,2008930
1,11868205,12051788,del,SP112997,1,,183583
1,144009053,145337094,dup,SP112997,1,,1328041
4,38355431,38669084,del,SP112997,1,,313653
12,9616955,10173713,del,SP112997,1,,556758
X,1,2663125,dup,SP112997,1,,2663124
2,54002788,55735244,del,SP112997,1,,1732456
14,22142658,22624121,del,SP112997,1,,481463
6,109090463,120380113,del,SP112997,1,,11289650
6,66815047,108984650,del,SP112997,1,,42169603
7,1013873,1160770,dup,SP112997,1,,146897
3,131381580,134218828,del,SP112997,1,,2837248
11,69416354,69449631,del,SP112997,1,,33277
2,85056630,89191352,del,SP112997,1,,4134722
19,40695062,40793476,dup,SP112997,1,,98414
14,102254530,102783323,del,SP112997,1,,528793
22,17738265,18634551,del,SP112997,1,,896286
8,39390007,41102963,del,SP112997,1,,1712956
12,58111654,58158467,dup,SP112997,1,,46813
1,47267809,48375635,del,SP112997,1,,1107826
7,139248104,140880004,dup,SP112997,1,,1631900
14,31435850,31732547,del,SP112997,1,,296697
14,24059019,24471762,del,SP112997,1,,412743
3,130626001,131127750,del,SP112997,1,,501749
19,10256290,10412067,del,SP112997,1,,155777
10,69783397,70395403,del,SP112997,1,,612006
4,90540350,91682415,dup,SP112997,1,,1142065
1,3743466,3801130,del,SP112997,1,,57664
16,88287380,89364873,dup,SP112997,1,,1077493
1,92046294,99004633,del,SP112997,1,,6958339
10,88077371,90886416,del,SP112997,1,,2809045
16,1,1305072,dup,SP112997,1,,1305071
16,2135827,2338272,dup,SP112997,1,,202445
8,3155597,4823523,del,SP112999,1,,1667926
3,120123998,121166283,del,SP112999,1,,1042285
16,78511954,82918360,del,SP112999,1,,4406406
12,37902988,38470257,dup,SP112999,1,,567269
5,45987386,46401271,dup,SP112999,1,,413885
X,42701911,43129495,del,SP112999,1,,427584
19,27754573,28246600,dup,SP112999,1,,492027
16,71675436,75233555,del,SP112999,1,,3558119
2,169413478,170173417,del,SP112999,1,,759939
5,70306678,72315320,del,SP112999,1,,2008642
19,40743817,40777963,dup,SP112999,1,,34146
11,50365293,51575951,dup,SP112999,1,,1210658
20,25508470,26309255,dup,SP112999,1,,800785
17,29487863,29698893,del,SP112999,1,,211030
8,4867996,7004147,del,SP112999,1,,2136151
8,8094763,41365631,del,SP112999,1,,33270868
19,36931784,37569880,dup,SP112999,1,,638096
12,34566769,35800000,dup,SP112999,1,,1233231
3,69110553,73031301,del,SP112999,1,,3920748
16,83708019,86854098,del,SP112999,1,,3146079
16,89394507,89557779,del,SP112999,1,,163272
21,39881646,42873810,del,SP112999,1,,2992164
7,57235340,58025423,dup,SP112999,1,,790083
16,76088021,78111283,del,SP112999,1,,2023262
X,1,2693433,dup,SP112999,1,,2693432
8,2378269,2977233,del,SP112999,1,,598964
10,22092370,23350118,del,SP112999,1,,1257748
9,11808867,12145219,del,SP112999,1,,336352
14,106384228,106757937,dup,SP112999,1,,373709
3,121765538,123508826,del,SP112999,1,,1743288
17,78264244,78924195,del,SP113001,1,,659951
4,1840033,1973727,del,SP113001,1,,133694
19,40685121,40793476,dup,SP113001,1,,108355
1,3723476,3807779,del,SP113001,1,,84303
6,31769939,31929283,del,SP113001,1,,159344
16,89374044,89872736,del,SP113001,1,,498692
11,69414263,69449054,del,SP113001,1,,34791
3,30265880,30754209,del,SP113001,1,,488329
22,24343908,24392203,del,SP113001,1,,48295
17,38461489,38521625,dup,SP113001,1,,60136
18,20417057,22470154,dup,SP113001,1,,2053097
12,58080052,58111654,del,SP113001,1,,31602
16,1,3505538,dup,SP113001,1,,3505537
16,46461309,52041794,dup,SP113001,1,,5580485
5,130454587,145287161,del,SP113001,1,,14832574
19,10235082,10331451,del,SP113001,1,,96369
1,32072033,32304503,dup,SP113001,1,,232470
X,153296589,153555088,del,SP113001,1,,258499
10,89600823,103673001,del,SP113001,1,,14072178
16,52041794,88254221,del,SP113001,1,,36212427
19,2368871,3018843,del,SP113001,1,,649972
7,914355,1154085,dup,SP113001,1,,239730
16,3628234,35271725,dup,SP113001,1,,31643491
17,7623819,8003506,del,SP113001,1,,379687
8,143379143,143631476,dup,SP113001,1,,252333
20,22736421,26309255,dup,SP113001,1,,3572834
17,42039127,43115234,del,SP113001,1,,1076107
14,90662051,92121988,del,SP113001,1,,1459937
1,1061600,1409374,dup,SP113001,1,,347774
9,133987992,134097558,del,SP113001,1,,109566
11,2959113,3106977,del,SP113001,1,,147864
11,1,1500373,dup,SP113001,1,,1500372
1,183183853,184342809,del,SP113001,1,,1158956
1,10822799,11270829,del,SP113001,1,,448030
9,138867174,140424060,dup,SP113001,1,,1556886
20,29519156,63025520,dup,SP113001,1,,33506364
18,18554307,19565104,del,SP113001,1,,1010797
9,1,17109264,del,SP113001,1,,17109263
17,1111934,1357392,del,SP113001,1,,245458
1,144009053,145388648,dup,SP113001,1,,1379595
12,58111654,58143876,dup,SP113001,1,,32222
X,1,2623790,dup,SP113001,1,,2623789
19,33682658,33801712,dup,SP113001,1,,119054
15,74928213,75955942,del,SP113001,1,,1027729
1,11865883,12051788,del,SP113001,1,,185905
10,46571122,47340886,dup,SP113001,1,,769764
1,2097466,3723476,dup,SP113001,1,,1626010
12,102299401,116266065,del,SP113001,1,,13966664
21,39849464,42873810,del,SP113001,1,,3024346
20,1,22736421,del,SP113001,1,,22736420
5,998945,1298756,dup,SP113001,1,,299811
5,49441966,68828372,del,SP113001,1,,19386406
17,37748494,37937149,dup,SP113001,1,,188655
11,69449054,69474676,dup,SP113001,1,,25622
21,46703017,46987215,dup,SP113001,1,,284198
1,28147043,28963460,del,SP113001,1,,816417
12,132618393,133199945,dup,SP113001,1,,581552
9,17109264,22856327,dup,SP113001,1,,5747063
7,34763867,35148108,del,SP113001,1,,384241
22,50594539,51068661,dup,SP113001,1,,474122
18,23495878,78077248,del,SP113001,1,,54581370
19,3018843,3755181,dup,SP113001,1,,736338
18,7486603,7957268,del,SP113001,1,,470665
10,76614664,89594489,del,SP113001,1,,12979825
17,5479771,7602787,del,SP113001,1,,2123016
17,79852769,81195210,dup,SP113001,1,,1342441
5,70306678,89630070,del,SP113001,1,,19323392
11,67298739,67375404,del,SP113001,1,,76665
2,242477232,243199373,dup,SP113001,1,,722141
1,17771528,17880534,del,SP113001,1,,109006
19,42742450,42924151,dup,SP113001,1,,181701
17,48616977,48719646,dup,SP113001,1,,102669
7,75856003,129582275,del,SP113001,1,,53726272
8,19801367,39892391,del,SP113001,1,,20091024
6,164040775,164308654,del,SP113001,1,,267879
9,138004111,138867174,del,SP113001,1,,863063
10,113101716,126291764,del,SP113001,1,,13190048
11,2720642,2959113,dup,SP113001,1,,238471
19,288713,2368871,dup,SP113001,1,,2080158
16,89877620,90032668,dup,SP113003,1,,155048
11,2959113,3106977,del,SP113003,1,,147864
22,24343908,24400522,dup,SP113003,1,,56614
11,69448474,69475291,dup,SP113003,1,,26817
12,132618393,133185790,dup,SP113003,1,,567397
1,3723476,3807779,del,SP113003,1,,84303
1,1839387,3723476,dup,SP113003,1,,1884089
11,1,866467,dup,SP113003,1,,866466
16,1,1587082,dup,SP113003,1,,1587081
19,42746278,42924151,dup,SP113003,1,,177873
17,1400691,1834090,del,SP113003,1,,433399
10,43556629,43618053,dup,SP113003,1,,61424
17,46604642,46735290,dup,SP113003,1,,130648
18,77144786,77720863,dup,SP113003,1,,576077
17,37748494,37830738,dup,SP113003,1,,82244
21,46703017,46987215,dup,SP113003,1,,284198
17,5278541,7604160,del,SP113003,1,,2325619
16,2467896,3246025,dup,SP113003,1,,778129
11,67298739,67372567,del,SP113003,1,,73828
12,58113365,58154539,dup,SP113003,1,,41174
17,38461489,38521625,dup,SP113003,1,,60136
16,85690999,86352848,del,SP113003,1,,661849
X,153320862,153555088,del,SP113003,1,,234226
16,34468168,34787960,dup,SP113003,1,,319792
9,138004111,138867174,del,SP113003,1,,863063
4,498819,922268,dup,SP113003,1,,423449
9,139392008,140424060,dup,SP113003,1,,1032052
19,2824618,3455216,del,SP113003,1,,630598
10,134494051,134895816,dup,SP113003,1,,401765
21,39957774,42697798,del,SP113003,1,,2740024
15,42434028,43701019,del,SP113003,1,,1266991
17,2850809,3428268,del,SP113003,1,,577459
17,37852664,37921844,dup,SP113003,1,,69180
7,117042,1154085,dup,SP113003,1,,1037043
19,10254176,10367827,del,SP113003,1,,113651
7,103104337,123297805,del,SP113003,1,,20193468
1,11858250,11935501,del,SP113003,1,,77251
8,64826860,65205222,del,SP113003,1,,378362
19,40317590,40797357,dup,SP113003,1,,479767
16,88368747,89374044,dup,SP113003,1,,1005297
15,44947465,45370061,del,SP113003,1,,422596
X,1,2663125,dup,SP113003,1,,2663124
11,69413524,69448474,del,SP113003,1,,34950
11,2720642,2959113,dup,SP113003,1,,238471
16,1978692,2338272,dup,SP113003,1,,359580
17,48616977,48719646,dup,SP113003,1,,102669
1,1,1715336,dup,SP113003,1,,1715335
17,1244575,1357392,del,SP113003,1,,112817
16,89374044,89877620,del,SP113003,1,,503576
19,288713,2368871,dup,SP113003,1,,2080158
5,137272014,137666246,del,SP113003,1,,394232
17,78928921,81195210,dup,SP113003,1,,2266289
14,106002977,106202607,dup,SP113003,1,,199630
1,144009053,145388648,dup,SP113003,1,,1379595
8,33423471,43482923,del,SP113005,1,,10059452
8,1,7004147,del,SP113005,1,,7004146
12,1259808,19098871,del,SP113005,1,,17839063
12,394288,981119,del,SP113005,1,,586831
X,1,2693433,dup,SP113005,1,,2693432
10,86007871,87833791,del,SP113005,1,,1825920
18,1,9160949,del,SP113005,1,,9160948
18,9348065,15377471,del,SP113005,1,,6029406
16,32047666,34199407,del,SP113005,1,,2151741
8,16197307,20085004,del,SP113005,1,,3887697
6,143291749,171115067,del,SP113005,1,,27823318
3,47315339,49446776,dup,SP112989,1,,2131437
6,44094470,44943765,dup,SP112989,1,,849295
1,144009053,210882057,dup,SP112989,1,,66873004
5,15114967,18183949,dup,SP112989,1,,3068982
3,119078047,140621740,dup,SP112989,1,,21543693
17,38218299,45477609,del,SP112989,1,,7259310
6,36405257,39098853,dup,SP112989,1,,2693596
19,1,446938,dup,SP112989,1,,446937
15,24650707,26250992,dup,SP112989,1,,1600285
1,100224250,103419810,del,SP112989,1,,3195560
7,139924448,140428858,dup,SP112989,1,,504410
7,50650450,51088412,dup,SP112989,1,,437962
9,98252348,99645249,dup,SP112989,1,,1392901
3,9780741,11205087,dup,SP112989,1,,1424346
21,38962349,39745694,dup,SP112989,1,,783345
9,133687472,133999082,dup,SP112989,1,,311610
4,184815126,188067638,dup,SP112989,1,,3252512
11,69481815,69511638,dup,SP112989,1,,29823
19,33514120,33810062,dup,SP112989,1,,295942
1,76858404,87764853,del,SP112989,1,,10906449
19,37536466,40810743,dup,SP112989,1,,3274277
20,3377922,4178177,dup,SP112989,1,,800255
11,126568569,126960621,dup,SP112989,1,,392052
4,76377390,78756643,dup,SP112989,1,,2379253
11,64533108,67306831,dup,SP112989,1,,2773723
1,72688682,76203415,del,SP112989,1,,3514733
13,109407297,111075688,dup,SP112989,1,,1668391
3,62557124,66345150,dup,SP112989,1,,3788026
4,82124551,83197610,dup,SP112989,1,,1073059
14,38103154,65162568,del,SP112989,1,,27059414
3,19846245,20530557,dup,SP112989,1,,684312
9,70984372,71666179,dup,SP112989,1,,681807
8,46896972,74308484,dup,SP112989,1,,27411512
17,62660856,78912372,dup,SP112989,1,,16251516
9,132471698,133618461,dup,SP112989,1,,1146763
9,137736930,138492538,dup,SP112989,1,,755608
9,115497961,117573146,dup,SP112989,1,,2075185
3,79619678,91000000,dup,SP112989,1,,11380322
17,1,22217883,del,SP112989,1,,22217882
5,1,9080069,dup,SP112989,1,,9080068
11,126041705,126568569,del,SP112989,1,,526864
19,28173473,30118447,dup,SP112989,1,,1944974
13,98748970,109012494,dup,SP112989,1,,10263524
11,108252687,124378101,del,SP112989,1,,16125414
7,26305723,27602413,dup,SP112989,1,,1296690
4,1858926,1963169,del,SP112989,1,,104243
13,84113032,85179273,dup,SP112989,1,,1066241
7,156804562,159138663,dup,SP112989,1,,2334101
16,32047666,33727980,del,SP112989,1,,1680314
1,231063451,237267986,dup,SP112989,1,,6204535
7,66794383,67883665,dup,SP112989,1,,1089282
11,108113961,108252687,del,SP112989,1,,138726
13,19084823,19589127,dup,SP112989,1,,504304
17,29138124,38083615,del,SP112989,1,,8945491
13,29202659,31770432,dup,SP112989,1,,2567773
17,62176676,62660856,dup,SP112989,1,,484180
1,118320834,121350934,dup,SP112989,1,,3030100
22,24343908,24392203,del,SP112989,1,,48295
9,95563714,97143736,dup,SP112989,1,,1580022
13,31770432,76422224,del,SP112989,1,,44651792
19,7137996,7515014,dup,SP112989,1,,377018
3,72563130,73285540,dup,SP112989,1,,722410
21,40420329,41236717,del,SP112989,1,,816388
12,57688899,57940912,dup,SP112989,1,,252013
20,46177733,46922963,del,SP112989,1,,745230
16,46461309,90354753,del,SP112989,1,,43893444
22,49146332,49586968,dup,SP112989,1,,440636
X,1,2623790,dup,SP112989,1,,2623789
19,41453723,41866908,dup,SP112989,1,,413185
20,52604172,54820216,del,SP112989,1,,2216044
19,34351387,35613694,dup,SP112989,1,,1262307
7,154743120,155814974,dup,SP112989,1,,1071854
7,5814544,6768644,dup,SP112989,1,,954100
14,27967074,29120930,del,SP112989,1,,1153856
21,37465249,38962349,del,SP112989,1,,1497100
9,135559650,135818325,dup,SP112989,1,,258675
13,20516954,21576377,dup,SP112989,1,,1059423
8,80048337,146364022,dup,SP112989,1,,66315685
6,41518844,43744880,dup,SP112989,1,,2226036
11,86542547,108113961,del,SP112989,1,,21571414
7,74484294,75931307,dup,SP112989,1,,1447013
17,45477609,48768077,dup,SP112989,1,,3290468
17,25326941,28900575,del,SP112989,1,,3573634
1,210882057,211536585,del,SP112989,1,,654528
9,118709564,119974529,dup,SP112989,1,,1264965
1,239698284,247113682,dup,SP112989,1,,7415398
14,100829226,103220981,del,SP112989,1,,2391755
7,55036431,55095143,dup,SP112989,1,,58712
3,104428218,117831958,dup,SP112989,1,,13403740
17,48792374,61053376,dup,SP112989,1,,12261002
13,91389711,97664562,dup,SP112989,1,,6274851
1,90608962,91102960,del,SP112989,1,,493998
5,10342459,11484998,dup,SP112989,1,,1142539
1,63103304,65195071,del,SP112989,1,,2091767
1,228513626,229112158,dup,SP112989,1,,598532
19,31085682,32666729,dup,SP112989,1,,1581047
11,67345082,67652302,dup,SP112989,1,,307220
16,5652324,6085477,dup,SP112989,1,,433153
9,34507658,35023587,dup,SP112989,1,,515929
17,61911941,62176676,dup,SP112989,1,,264735
14,106950798,107349540,del,SP112989,1,,398742
11,133400252,135006516,dup,SP112989,1,,1606264
7,148770234,151225036,dup,SP112989,1,,2454802
13,111247179,115169878,dup,SP112989,1,,3922699
1,211536585,227312072,dup,SP112989,1,,15775487
15,39517530,40384500,del,SP112989,1,,866970
3,194650590,195587722,dup,SP112989,1,,937132
15,78011700,78841915,del,SP112989,1,,830215
8,74504954,79784147,dup,SP112989,1,,5279193
5,175853167,180915260,dup,SP112989,1,,5062093
14,65459844,99581309,del,SP112989,1,,34121465
17,61053376,61911941,dup,SP112989,1,,858565
3,142999925,143433815,dup,SP112989,1,,433890
20,36655030,40514613,del,SP112989,1,,3859583
8,1,7004147,del,SP112989,1,,7004146
7,33624987,34888596,dup,SP112989,1,,1263609
1,104440383,105384030,del,SP112989,1,,943647
8,8094763,43767534,del,SP112989,1,,35672771
14,104227593,106300146,del,SP112989,1,,2072553
11,126960621,127706403,del,SP112989,1,,745782
2,91795547,92196400,dup,SP112991,1,,400853
9,44057318,45727552,dup,SP112991,1,,1670234
15,20088939,27280061,dup,SP112991,1,,7191122
17,2953288,4255259,del,SP112971,1,,1301971
1,33566034,33895158,dup,SP112971,1,,329124
8,30354773,32465087,del,SP112971,1,,2110314
1,149941264,155734420,dup,SP112971,1,,5793156
8,19682445,20099168,del,SP112971,1,,416723
5,62449399,64987526,del,SP112971,1,,2538127
12,111988970,112601253,del,SP112971,1,,612283
2,98302453,99052957,del,SP112971,1,,750504
1,29527392,30780573,dup,SP112971,1,,1253181
8,16051180,16650873,del,SP112971,1,,599693
21,39868213,42867981,del,SP112971,1,,2999768
8,23450550,27285999,del,SP112971,1,,3835449
8,38615832,39231745,del,SP112971,1,,615913
13,33323000,48875863,del,SP112971,1,,15552863
3,9235665,9528634,del,SP112971,1,,292969
1,40222965,40713237,dup,SP112971,1,,490272
1,48135293,50589314,dup,SP112971,1,,2454021
3,3148658,5680539,del,SP112971,1,,2531881
1,11173588,11266377,del,SP112971,1,,92789
17,8039362,8699217,del,SP112971,1,,659855
8,8094763,9736258,del,SP112971,1,,1641495
11,69486551,69508928,dup,SP112971,1,,22377
8,21179459,22398603,del,SP112971,1,,1219144
3,7601454,8667251,del,SP112971,1,,1065797
5,67526773,68299949,del,SP112971,1,,773176
8,18042270,18206416,del,SP112971,1,,164146
1,44958484,45290362,dup,SP112971,1,,331878
1,31932838,32179680,dup,SP112971,1,,246842
8,3913190,4492795,del,SP112971,1,,579605
8,28279374,29164978,del,SP112971,1,,885604
2,106166315,107273027,del,SP112971,1,,1106712
1,42581897,43825200,dup,SP112971,1,,1243303
1,46446823,46682216,dup,SP112971,1,,235393
17,5671827,7405972,del,SP112971,1,,1734145
13,81488131,83278727,del,SP112971,1,,1790596
3,1,1270158,del,SP112971,1,,1270157
8,41676595,41982792,del,SP112971,1,,306197
13,48898695,80205287,del,SP112971,1,,31306592
3,71677756,76013671,del,SP112971,1,,4335915
4,133320800,134447264,del,SP112971,1,,1126464
22,29097344,30512033,del,SP112971,1,,1414689
X,1,2693433,dup,SP112971,1,,2693432
8,14202790,14756436,del,SP112971,1,,553646
10,83564859,110462617,del,SP112971,1,,26897758
18,21925432,22306896,del,SP112971,1,,381464
10,16640946,17484579,del,SP112971,1,,843633
8,5042599,7004147,del,SP112971,1,,1961548
X,1,2693433,dup,SP112973,1,,2693432
19,40743817,40778521,dup,SP112973,1,,34704
3,26196167,27608301,del,SP112973,1,,1412134
18,74840347,76657853,del,SP112973,1,,1817506
11,134625635,135006516,dup,SP112973,1,,380881
1,172742093,174345093,dup,SP112973,1,,1603000
21,39859072,48129895,del,SP112973,1,,8270823
18,1,15377471,del,SP112973,1,,15377470
1,144943249,145267073,dup,SP112973,1,,323824
2,208401130,227904893,del,SP112973,1,,19503763
8,122170636,122849997,dup,SP112973,1,,679361
14,106534342,106832786,dup,SP112973,1,,298444
3,195380133,198022430,del,SP112973,1,,2642297
8,23540514,42748052,del,SP112973,1,,19207538
10,46571122,47340886,dup,SP112973,1,,769764
6,167051420,168336848,del,SP112973,1,,1285428
3,175393875,176517890,dup,SP112973,1,,1124015
9,13292483,18291044,del,SP112973,1,,4998561
16,70535653,89288772,del,SP112973,1,,18753119
17,27281236,35818888,del,SP112973,1,,8537652
4,177327611,191154276,del,SP112973,1,,13826665
22,16054713,21633605,del,SP112973,1,,5578892
5,49441966,58472798,del,SP112973,1,,9030832
2,46897568,47461907,del,SP112975,1,,564339
12,132618393,133199945,dup,SP112975,1,,581552
1,1,1578537,dup,SP112975,1,,1578536
5,50774316,62683446,del,SP112975,1,,11909130
X,153297267,153558373,del,SP112975,1,,261106
8,143710221,144985596,del,SP112975,1,,1275375
18,18554307,19695930,del,SP112975,1,,1141623
18,55864386,78077248,del,SP112975,1,,22212862
2,154267351,154822700,del,SP112975,1,,555349
6,121232368,121668269,del,SP112975,1,,435901
16,89180842,90354753,del,SP112975,1,,1173911
1,81683436,82397339,del,SP112975,1,,713903
1,74457849,80956268,del,SP112975,1,,6498419
10,64661125,68993169,del,SP112975,1,,4332044
5,109891340,110339093,del,SP112975,1,,447753
13,38359999,82309800,del,SP112975,1,,43949801
2,186761726,187256338,del,SP112975,1,,494612
6,55175358,55834503,del,SP112975,1,,659145
17,7602787,7622972,dup,SP112975,1,,20185
2,110878811,112207535,del,SP112975,1,,1328724
18,20792304,21169309,del,SP112975,1,,377005
11,2720642,2959113,dup,SP112975,1,,238471
8,39390007,40531139,dup,SP112975,1,,1141132
14,83414719,88907271,del,SP112975,1,,5492552
5,1012204,1298756,dup,SP112975,1,,286552
11,69448474,69474676,dup,SP112975,1,,26202
1,3262989,3723476,dup,SP112975,1,,460487
20,60686558,62344800,dup,SP112975,1,,1658242
X,1,2693433,dup,SP112975,1,,2693432
16,69366613,88342973,del,SP112975,1,,18976360
8,48695622,134250272,dup,SP112975,1,,85554650
9,136174548,136893902,dup,SP112975,1,,719354
4,1,1837195,dup,SP112975,1,,1837194
11,67298739,67372567,del,SP112975,1,,73828
6,120391293,120887575,del,SP112975,1,,496282
3,144082857,145352029,del,SP112975,1,,1269172
4,1837195,1967347,del,SP112975,1,,130152
11,69418603,69448474,del,SP112975,1,,29871
6,122342761,123075805,del,SP112975,1,,733044
4,96156827,97937762,del,SP112975,1,,1780935
8,134655142,143188225,del,SP112975,1,,8533083
16,1,2338272,dup,SP112975,1,,2338271
2,212371684,213711288,del,SP112975,1,,1339604
1,217385292,242585098,del,SP112975,1,,25199806
19,2492172,3018843,del,SP112975,1,,526671
2,141135684,142494987,del,SP112975,1,,1359303
8,1,7004147,del,SP112975,1,,7004146
6,61000000,120231890,del,SP112975,1,,59231890
5,32107257,32181543,dup,SP112975,1,,74286
2,116806705,126432992,del,SP112975,1,,9626287
2,135950620,136866289,del,SP112975,1,,915669
3,20093191,21346610,del,SP112975,1,,1253419
19,10235082,10367827,del,SP112975,1,,132745
14,104207419,104549166,del,SP112975,1,,341747
17,1230508,1354464,del,SP112975,1,,123956
2,138548437,139505767,del,SP112975,1,,957330
5,97387572,98961530,del,SP112975,1,,1573958
2,58946270,59443873,del,SP112975,1,,497603
22,24343908,24392203,dup,SP112975,1,,48295
8,145779413,146364022,del,SP112975,1,,584609
7,117042,1796621,dup,SP112975,1,,1679579
9,138839166,140396299,dup,SP112975,1,,1557133
6,57287454,58039241,del,SP112975,1,,751787
8,36485526,37175811,dup,SP112975,1,,690285
17,38283659,38462678,del,SP112975,1,,179019
19,288713,2492172,dup,SP112975,1,,2203459
1,17771528,17879132,del,SP112975,1,,107604
16,31952510,33928041,del,SP112975,1,,1975531
20,7699086,8185059,del,SP112975,1,,485973
9,133564498,133694896,del,SP112975,1,,130398
2,55138667,55694068,del,SP112975,1,,555401
16,62068927,64699345,del,SP112975,1,,2630418
1,3723476,3813295,del,SP112975,1,,89819
20,5746611,6664070,del,SP112975,1,,917459
1,2100168,3045914,dup,SP112975,1,,945746
15,95100856,98447880,del,SP112975,1,,3347024
11,2959113,3106977,del,SP112975,1,,147864
2,157065328,157583876,del,SP112975,1,,518548
8,8094763,36485526,del,SP112975,1,,28390763
20,5315210,5668601,del,SP112975,1,,353391
9,8290313,8897151,del,SP112975,1,,606838
2,208914124,212261216,del,SP112975,1,,3347092
2,61328107,61938345,del,SP112975,1,,610238
21,46703017,46933947,dup,SP112975,1,,230930
19,3018843,4106515,dup,SP112975,1,,1087672
2,88547175,88928183,del,SP112975,1,,381008
10,69279321,107656358,del,SP112975,1,,38377037
14,104549166,106248982,dup,SP112975,1,,1699816
17,78918726,81195210,dup,SP112975,1,,2276484
9,26068701,38678575,del,SP112975,1,,12609874
11,1,2489186,dup,SP112975,1,,2489185
22,50575084,51072467,dup,SP112975,1,,497383
6,161816688,162596961,del,SP112977,1,,780273
2,237939561,238369592,del,SP112977,1,,430031
4,112912775,113770208,dup,SP112977,1,,857433
3,69804781,69834928,dup,SP112977,1,,30147
21,25348776,25740361,del,SP112977,1,,391585
16,70229771,90354753,del,SP112977,1,,20124982
20,9648817,9724185,dup,SP112977,1,,75368
3,34427907,36292763,dup,SP112977,1,,1864856
4,143658745,143776627,dup,SP112977,1,,117882
10,77927438,78953360,dup,SP112977,1,,1025922
10,34572060,39146676,dup,SP112977,1,,4574616
4,79703517,80643120,dup,SP112977,1,,939603
15,90821152,91187654,dup,SP112977,1,,366502
4,52684891,53066643,dup,SP112977,1,,381752
1,176612336,177831764,dup,SP112977,1,,1219428
20,25125748,26188570,dup,SP112977,1,,1062822
8,86513812,88576237,dup,SP112977,1,,2062425
7,66773805,68787479,dup,SP112977,1,,2013674
2,5801128,6146050,dup,SP112977,1,,344922
12,99962414,101222707,dup,SP112977,1,,1260293
8,128795452,144893853,dup,SP112977,1,,16098401
2,98984988,99076563,dup,SP112977,1,,91575
8,8094763,39231745,del,SP112977,1,,31136982
3,79290021,80957787,dup,SP112977,1,,1667766
1,11301782,11835967,dup,SP112977,1,,534185
11,54795357,59683564,dup,SP112977,1,,4888207
7,52080852,55096744,dup,SP112977,1,,3015892
15,98918077,99205127,dup,SP112977,1,,287050
4,91260877,93190550,dup,SP112977,1,,1929673
8,1,7004147,del,SP112977,1,,7004146
8,58104632,58888032,dup,SP112977,1,,783400
22,37227747,38050575,del,SP112977,1,,822828
12,60392876,60859669,dup,SP112977,1,,466793
15,25394984,26300049,dup,SP112977,1,,905065
19,40719473,40779422,dup,SP112977,1,,59949
7,102460466,102770006,dup,SP112977,1,,309540
14,46394626,46964233,del,SP112977,1,,569607
10,91805912,92674640,dup,SP112977,1,,868728
8,92543036,93123372,dup,SP112977,1,,580336
18,1,15377471,del,SP112977,1,,15377470
10,42413322,76055610,dup,SP112977,1,,33642288
4,55888420,56935399,dup,SP112977,1,,1046979
10,126023370,128851886,dup,SP112977,1,,2828516
10,106917533,107820652,dup,SP112977,1,,903119
8,51339273,52351808,dup,SP112977,1,,1012535
4,185866886,191154276,dup,SP112977,1,,5287390
22,46092146,46795096,del,SP112977,1,,702950
7,39859978,41553270,dup,SP112977,1,,1693292
8,39390007,43767534,del,SP112977,1,,4377527
15,29434906,30279124,dup,SP112977,1,,844218
6,127071384,128309575,del,SP112977,1,,1238191
4,64451273,66076134,dup,SP112977,1,,1624861
4,181081112,184653996,dup,SP112977,1,,3572884
15,54926102,56609440,dup,SP112977,1,,1683338
14,106062431,106182056,dup,SP112977,1,,119625
4,98856417,100205634,dup,SP112977,1,,1349217
3,84599529,89227041,dup,SP112977,1,,4627512
6,37069935,57608775,dup,SP112977,1,,20538840
12,102854823,103771788,dup,SP112977,1,,916965
6,163430141,168344175,del,SP112977,1,,4914034
6,131040125,131583269,del,SP112977,1,,543144
4,130717479,133787484,dup,SP112977,1,,3070005
3,76776195,77643323,dup,SP112977,1,,867128
22,24343908,24392203,del,SP112977,1,,48295
6,140484107,142533752,del,SP112977,1,,2049645
4,82151977,82950834,dup,SP112977,1,,798857
7,93449603,94931056,dup,SP112977,1,,1481453
2,1,4326137,dup,SP112977,1,,4326136
20,11629665,12196010,dup,SP112977,1,,566345
4,178846682,180138559,dup,SP112977,1,,1291877
21,40541110,45689405,del,SP112977,1,,5148295
16,1,4288440,dup,SP112977,1,,4288439
7,115807379,116324612,dup,SP112977,1,,517233
10,115840390,117911958,dup,SP112977,1,,2071568
10,132013233,134208540,dup,SP112977,1,,2195307
8,145053152,146364022,dup,SP112977,1,,1310870
15,36452988,37611126,dup,SP112977,1,,1158138
6,112776775,113628464,del,SP112977,1,,851689
15,99474545,102531392,dup,SP112977,1,,3056847
4,118942644,121673456,dup,SP112977,1,,2730812
12,73042018,75420660,dup,SP112977,1,,2378642
4,108072076,109727611,dup,SP112977,1,,1655535
8,97571120,103461739,dup,SP112977,1,,5890619
13,55171117,55666769,del,SP112977,1,,495652
4,58286221,59571359,dup,SP112977,1,,1285138
11,61906134,135006516,dup,SP112977,1,,73100382
3,18221166,27508587,del,SP112977,1,,9287421
17,77409152,78329627,dup,SP112977,1,,920475
12,58143876,58187866,dup,SP112977,1,,43990
13,62239323,63417275,del,SP112977,1,,1177952
4,149631241,149983122,dup,SP112977,1,,351881
1,3695429,3813295,dup,SP112977,1,,117866
22,38853265,41613872,del,SP112977,1,,2760607
14,96106924,96572399,del,SP112977,1,,465475
12,56472707,56593876,dup,SP112977,1,,121169
8,104899841,128767361,dup,SP112977,1,,23867520
14,93258276,95014374,del,SP112977,1,,1756098
18,18554307,78077248,del,SP112977,1,,59522941
12,85846031,86397259,dup,SP112977,1,,551228
15,74244764,74351253,dup,SP112977,1,,106489
4,155225839,158005802,dup,SP112977,1,,2779963
7,27223115,27835076,dup,SP112977,1,,611961
5,32024162,32323529,dup,SP112977,1,,299367
7,55211461,55247461,dup,SP112977,1,,36000
7,44876070,45940815,dup,SP112977,1,,1064745
10,83635713,84451111,dup,SP112977,1,,815398
1,144009053,147041542,dup,SP112977,1,,3032489
20,62206014,63025520,dup,SP112977,1,,819506
20,15917677,17839810,dup,SP112977,1,,1922133
3,15772510,18221166,dup,SP112977,1,,2448656
15,94079324,98510406,dup,SP112977,1,,4431082
12,106771355,107463206,del,SP112977,1,,691851
21,15810341,18240552,del,SP112977,1,,2430211
3,163201438,164101733,dup,SP112977,1,,900295
4,137002041,137718614,dup,SP112977,1,,716573
4,54610052,55114178,dup,SP112977,1,,504126
5,1,936312,dup,SP112977,1,,936311
6,160481666,161776725,del,SP112977,1,,1295059
6,58039241,58770502,dup,SP112977,1,,731261
X,1,2663125,dup,SP112977,1,,2663124
5,121825890,122120652,dup,SP112977,1,,294762
6,102518379,103093824,del,SP112977,1,,575445
5,180077774,180915260,dup,SP112977,1,,837486
3,105372522,105798856,dup,SP112979,1,,426334
6,141684394,142193215,del,SP112979,1,,508821
3,94014228,102569619,dup,SP112979,1,,8555391
8,53491256,67712016,del,SP112979,1,,14220760
13,113948773,115169878,dup,SP112979,1,,1221105
11,69449054,69497276,dup,SP112979,1,,48222
3,183612955,186490418,dup,SP112979,1,,2877463
3,41432415,46069682,dup,SP112979,1,,4637267
12,7083463,14772971,del,SP112979,1,,7689508
1,156191971,156807909,del,SP112979,1,,615938
3,4465205,5878115,dup,SP112979,1,,1412910
3,111654027,121343242,dup,SP112979,1,,9689215
11,50335799,51330202,del,SP112979,1,,994403
3,166004259,182549510,dup,SP112979,1,,16545251
3,77470574,80446364,dup,SP112979,1,,2975790
14,106641420,106937235,dup,SP112979,1,,295815
5,45927593,46401271,del,SP112979,1,,473678
3,140770021,142301805,dup,SP112979,1,,1531784
20,23223064,23810730,dup,SP112979,1,,587666
10,101235220,103579789,del,SP112979,1,,2344569
1,144009053,145267073,dup,SP112979,1,,1258020
17,48616977,48720707,dup,SP112979,1,,103730
3,47209420,55439145,dup,SP112979,1,,8229725
8,42962074,43371276,dup,SP112979,1,,409202
3,17300032,18206201,dup,SP112979,1,,906169
3,56800711,62805914,dup,SP112979,1,,6005203
3,66801449,71359144,dup,SP112979,1,,4557695
8,1,7004147,del,SP112979,1,,7004146
3,194544955,195543421,dup,SP112979,1,,998466
22,20894056,21307157,del,SP112979,1,,413101
22,49993140,51304566,del,SP112979,1,,1311426
3,25849883,27131293,dup,SP112979,1,,1281410
8,8094763,42349247,del,SP112979,1,,34254484
3,14246791,15172146,dup,SP112979,1,,925355
16,2226831,2338272,dup,SP112979,1,,111441
6,87647228,87836771,del,SP112979,1,,189543
7,652660,1162197,dup,SP112979,1,,509537
8,68948018,100390184,del,SP112979,1,,31442166
22,29807501,30545018,del,SP112979,1,,737517
22,42406103,43366490,del,SP112979,1,,960387
16,34468168,34787960,dup,SP112979,1,,319792
1,49291157,52272946,del,SP112979,1,,2981789
X,1,2663125,dup,SP112979,1,,2663124
22,33940905,35299847,del,SP112979,1,,1358942
3,84945419,90333243,dup,SP112979,1,,5387824
3,72486330,76833746,dup,SP112979,1,,4347416
11,6412051,6723550,dup,SP112979,1,,311499
3,134619297,139405805,dup,SP112979,1,,4786508
3,193156180,193771464,dup,SP112979,1,,615284
8,42583617,42962074,del,SP112979,1,,378457
3,164477277,165223446,dup,SP112979,1,,746169
2,232962689,236034389,del,SP112979,1,,3071700
1,31960988,32304503,dup,SP112979,1,,343515
22,21388965,22266692,del,SP112979,1,,877727
17,7606566,7668942,dup,SP112979,1,,62376
1,6340191,11540037,del,SP112979,1,,5199846
1,156914738,157336652,del,SP112979,1,,421914
19,40685121,40777079,dup,SP112979,1,,91958
7,61064518,62444325,del,SP112979,1,,1379807
22,45985866,46647364,del,SP112979,1,,661498
1,53800931,55672738,del,SP112979,1,,1871807
3,1918108,3552490,dup,SP112979,1,,1634382
8,46896972,52498990,del,SP112979,1,,5602018
1,41998436,43731100,del,SP112979,1,,1732664
3,63956977,64970696,dup,SP112979,1,,1013719
13,35717658,36585733,dup,SP112979,1,,868075
17,38530020,39873730,del,SP112979,1,,1343710
10,77898135,100209338,del,SP112979,1,,22311203
3,142968299,163860484,dup,SP112979,1,,20892185
1,45315129,45636349,del,SP112979,1,,321220
1,46559777,47528947,del,SP112979,1,,969170
6,88844051,89267376,del,SP112979,1,,423325
12,58113365,58161990,dup,SP112979,1,,48625
3,122829802,131688687,dup,SP112979,1,,8858885
3,1,436811,dup,SP112979,1,,436810
12,37902988,38426187,del,SP112979,1,,523199
17,37937149,38462678,del,SP112979,1,,525529
2,1391653,1891498,dup,SP112979,1,,499845
3,19905336,22837056,dup,SP112979,1,,2931720
12,328869,6790744,del,SP112979,1,,6461875
22,24343908,24392203,del,SP112979,1,,48295
1,156023132,156191971,dup,SP112979,1,,168839
3,15772510,16417007,dup,SP112979,1,,644497
11,69422188,69449054,del,SP112979,1,,26866
3,106293668,109125317,dup,SP112979,1,,2831649
11,67298739,67369357,del,SP112979,1,,70618
16,2480076,3192264,dup,SP112979,1,,712188
21,39903822,42867981,del,SP112979,1,,2964159
3,6960682,11838657,dup,SP112979,1,,4877975
3,28659872,37093871,dup,SP112979,1,,8433999
2,141554119,143141590,del,SP112981,1,,1587471
3,64043519,73766526,del,SP112981,1,,9723007
16,62599680,90354753,del,SP112981,1,,27755073
6,162631712,162838358,del,SP112981,1,,206646
19,40674539,40779422,dup,SP112981,1,,104883
17,6952096,8083503,del,SP112981,1,,1131407
16,58074161,59977715,del,SP112981,1,,1903554
10,48319950,50874285,del,SP112981,1,,2554335
2,154841241,155574832,del,SP112981,1,,733591
21,39922722,42859011,del,SP112981,1,,2936289
X,1,2663125,dup,SP112981,1,,2663124
10,103138724,108184587,del,SP112981,1,,5045863
10,82321114,94095963,del,SP112981,1,,11774849
3,114860255,115209369,dup,SP112981,1,,349114
8,46896972,49201661,del,SP112981,1,,2304689
8,8094763,43767534,del,SP112981,1,,35672771
4,126711800,134331235,del,SP112981,1,,7619435
6,80393717,98338326,del,SP112981,1,,17944609
8,50518141,52685921,del,SP112981,1,,2167780
5,55567691,56467262,del,SP112981,1,,899571
10,111081404,111964246,del,SP112981,1,,882842
8,1,7004147,del,SP112981,1,,7004146
4,116555912,119545692,del,SP112981,1,,2989780
10,57003075,70470323,del,SP112981,1,,13467248
8,61111015,65667095,del,SP112981,1,,4556080
11,69482669,69508928,dup,SP112981,1,,26259
2,138548437,139141440,del,SP112981,1,,593003
10,51690095,54043259,del,SP112981,1,,2353164
1,162875763,169473021,dup,SP112983,1,,6597258
10,73175449,73518427,del,SP112985,1,,342978
8,8094763,32418229,del,SP112985,1,,24323466
22,24343908,24400522,dup,SP112985,1,,56614
3,10150249,10202366,dup,SP112985,1,,52117
11,69418603,69459431,del,SP112985,1,,40828
19,3261585,3886067,dup,SP112985,1,,624482
8,2794576,7004147,del,SP112985,1,,4209571
8,48870159,49816037,del,SP112985,1,,945878
12,7068604,18226087,del,SP112985,1,,11157483
10,89637066,89707925,del,SP112985,1,,70859
14,89509432,90355006,del,SP112985,1,,845574
12,328869,3654401,del,SP112985,1,,3325532
11,134340965,135006516,dup,SP112985,1,,665551
19,1220604,1320068,del,SP112985,1,,99464
10,68093981,69325314,del,SP112985,1,,1231333
21,39894980,42656750,del,SP112985,1,,2761770
10,43556629,43639591,dup,SP112985,1,,82962
8,1,2679519,del,SP112985,1,,2679518
X,1,2599206,dup,SP112985,1,,2599205
12,3662090,6790744,del,SP112985,1,,3128654
10,76726795,77460244,del,SP112985,1,,733449
7,1119048,1167665,dup,SP112985,1,,48617
8,38627281,43767534,del,SP112985,1,,5140253
5,134555771,137774051,del,SP112985,1,,3218280
8,46896972,47563048,del,SP112985,1,,666076
7,62071108,76297910,dup,SP112967,1,,14226802
1,61836440,65363490,del,SP112967,1,,3527050
17,1218621,1354464,del,SP112967,1,,135843
10,75843550,97490753,del,SP112967,1,,21647203
16,73105984,73520768,dup,SP112967,1,,414784
4,1967347,6227069,dup,SP112967,1,,4259722
1,80745820,85263089,del,SP112967,1,,4517269
5,66075012,68828372,del,SP112967,1,,2753360
12,48309552,49040439,del,SP112967,1,,730887
8,100427558,101563858,dup,SP112967,1,,1136300
10,15333393,31448101,del,SP112967,1,,16114708
17,45311171,49059521,dup,SP112967,1,,3748350
2,108583019,111481575,dup,SP112967,1,,2898556
14,22418309,22981839,dup,SP112967,1,,563530
17,43829827,45106884,dup,SP112967,1,,1277057
5,70306678,81528342,del,SP112967,1,,11221664
1,17771528,17880534,del,SP112967,1,,109006
8,8094763,27876210,del,SP112967,1,,19781447
5,156035367,156592443,dup,SP112967,1,,557076
4,90689009,91723074,dup,SP112967,1,,1034065
11,69449054,69475291,dup,SP112967,1,,26237
3,140522425,193395010,dup,SP112967,1,,52872585
18,4358700,5137251,dup,SP112967,1,,778551
13,30053216,48875863,del,SP112967,1,,18822647
19,10254176,10477352,del,SP112967,1,,223176
13,114135114,115169878,del,SP112967,1,,1034764
1,156018498,156059721,dup,SP112967,1,,41223
11,2225237,2826569,del,SP112967,1,,601332
2,112813089,116097691,dup,SP112967,1,,3284602
15,101883720,102172369,del,SP112967,1,,288649
7,1,6747134,dup,SP112967,1,,6747133
2,242614683,243199373,dup,SP112967,1,,584690
7,123168355,123546018,del,SP112967,1,,377663
16,70020227,71879040,del,SP112967,1,,1858813
10,135171787,135534747,del,SP112967,1,,362960
17,49259222,72861736,dup,SP112967,1,,23602514
3,137378862,139527178,dup,SP112967,1,,2148316
1,3738061,3813295,del,SP112967,1,,75234
6,72098956,89551524,del,SP112967,1,,17452568
19,703981,1179055,dup,SP112967,1,,475074
3,193457861,198022430,dup,SP112967,1,,4564569
11,67298739,67372567,del,SP112967,1,,73828
X,1,2693433,dup,SP112967,1,,2693432
17,49059521,49259222,del,SP112967,1,,199701
3,59637761,60237691,dup,SP112967,1,,599930
3,97697765,98490919,dup,SP112967,1,,793154
8,75399940,85123089,dup,SP112967,1,,9723149
8,1,7004147,del,SP112967,1,,7004146
2,37487774,42329847,del,SP112967,1,,4842073
19,34692198,36107377,del,SP112967,1,,1415179
11,69367485,69449054,del,SP112967,1,,81569
14,106534342,106885024,dup,SP112967,1,,350682
13,48897550,93529134,del,SP112967,1,,44631584
9,132759933,133689820,del,SP112967,1,,929887
6,31145976,31587433,del,SP112967,1,,441457
2,111744710,112813089,del,SP112967,1,,1068379
4,1,1878181,dup,SP112967,1,,1878180
12,1,35800000,dup,SP112969,1,,35799999
12,108556132,133851895,dup,SP112969,1,,25295763
16,663651,1509942,dup,SP112969,1,,846291
16,1953317,2309335,dup,SP112969,1,,356018
1,1043498,1715336,dup,SP112969,1,,671838
7,137520334,159138663,dup,SP112969,1,,21618329
17,78928921,81195210,dup,SP112969,1,,2266289
19,10254176,10353061,del,SP112969,1,,98885
8,8094763,43767534,dup,SP112969,1,,35672771
9,133692065,133777830,dup,SP112969,1,,85765
11,67298739,67372567,del,SP112969,1,,73828
9,70984372,133621158,dup,SP112969,1,,62636786
8,1,7004147,dup,SP112969,1,,7004146
9,134112597,141213431,dup,SP112969,1,,7100834
11,103561812,104642584,dup,SP112969,1,,1080772
18,7078600,7587027,dup,SP112969,1,,508427
7,1,58025423,dup,SP112969,1,,58025422
2,206152855,207045112,dup,SP112969,1,,892257
11,69426826,69446756,del,SP112969,1,,19930
8,47122799,146364022,dup,SP112969,1,,99241223
7,61064518,70110616,dup,SP112969,1,,9046098
7,113366541,135169502,dup,SP112969,1,,21802961
17,1230508,1354464,del,SP112969,1,,123956
13,31140888,74309110,del,SP112969,1,,43168222
7,70556929,107698247,dup,SP112969,1,,37141318
11,1,930888,dup,SP112969,1,,930887
19,33535177,33810062,dup,SP112969,1,,274885
16,88368747,89014679,dup,SP112969,1,,645932
14,22637424,22794022,dup,SP112969,1,,156598
12,37902988,106692737,dup,SP112969,1,,68789749
2,213027536,214169620,dup,SP112969,1,,1142084
19,584625,2138314,dup,SP112969,1,,1553689
X,1,2693433,dup,SP112969,1,,2693432
9,1,39184065,dup,SP112969,1,,39184064
13,97960346,98497911,del,SP112965,1,,537565
4,91653467,91973351,dup,SP112965,1,,319884
13,44210028,48656065,del,SP112965,1,,4446037
6,145379829,145961201,del,SP112965,1,,581372
3,183076468,184621876,dup,SP112965,1,,1545408
6,61000000,62410832,dup,SP112965,1,,1410832
12,99078228,103255891,dup,SP112965,1,,4177663
20,39360078,47422004,dup,SP112965,1,,8061926
6,18365111,19710782,dup,SP112965,1,,1345671
3,53607228,59193834,dup,SP112965,1,,5586606
1,156983982,169270081,dup,SP112965,1,,12286099
19,50883180,57241949,dup,SP112965,1,,6358769
20,21982563,26309255,dup,SP112965,1,,4326692
2,16071642,16093681,dup,SP112965,1,,22039
18,63323634,64260412,del,SP112965,1,,936778
20,14885765,15151460,dup,SP112965,1,,265695
11,97641483,99047384,dup,SP112965,1,,1405901
7,140254620,149601883,dup,SP112965,1,,9347263
10,74941610,78743522,del,SP112965,1,,3801912
19,10477352,11047864,dup,SP112965,1,,570512
12,53163853,58082292,dup,SP112965,1,,4918439
6,55101378,58770502,dup,SP112965,1,,3669124
20,55653534,59061302,dup,SP112965,1,,3407768
4,61826838,62563140,dup,SP112965,1,,736302
12,1,18390595,dup,SP112965,1,,18390594
3,48695125,52376561,dup,SP112965,1,,3681436
6,121786566,122945139,del,SP112965,1,,1158573
1,115740818,115925758,dup,SP112965,1,,184940
12,40256365,45356066,dup,SP112965,1,,5099701
11,69446574,75646502,dup,SP112965,1,,6199928
X,1,2693433,dup,SP112965,1,,2693432
5,119015283,119713738,dup,SP112965,1,,698455
11,82521281,83012947,dup,SP112965,1,,491666
19,1651351,3423186,dup,SP112965,1,,1771835
18,65554172,65983656,del,SP112965,1,,429484
7,155135678,159138663,dup,SP112965,1,,4002985
11,128645707,128851117,dup,SP112965,1,,205410
7,93679320,95827808,dup,SP112965,1,,2148488
16,7737123,22308001,dup,SP112965,1,,14570878
11,118397511,121921228,dup,SP112965,1,,3523717
3,45783452,46578171,dup,SP112965,1,,794719
5,161916747,162495887,dup,SP112965,1,,579140
5,179746462,180915260,dup,SP112965,1,,1168798
16,46461309,90354753,del,SP112965,1,,43893444
16,1,1856944,dup,SP112965,1,,1856943
5,127323426,131475535,dup,SP112965,1,,4152109
7,39946484,46578288,dup,SP112965,1,,6631804
1,200155943,220603924,dup,SP112965,1,,20447981
19,15587447,16749011,dup,SP112965,1,,1161564
15,28528205,30023504,dup,SP112965,1,,1495299
5,124719451,125098302,dup,SP112965,1,,378851
13,48898695,49054679,del,SP112965,1,,155984
19,47692309,49244362,dup,SP112965,1,,1552053
5,102595733,105478796,dup,SP112965,1,,2883063
12,32875326,35800000,dup,SP112965,1,,2924674
12,119268003,132224726,dup,SP112965,1,,12956723
7,1,1287670,dup,SP112965,1,,1287669
7,123124245,127909681,dup,SP112965,1,,4785436
5,144365892,145384816,dup,SP112965,1,,1018924
3,32120627,38704368,dup,SP112965,1,,6583741
5,92666870,94855048,dup,SP112965,1,,2188178
3,119270622,119837382,dup,SP112965,1,,566760
2,227647028,228790154,dup,SP112965,1,,1143126
5,176526922,176575781,dup,SP112965,1,,48859
5,15698485,25937750,dup,SP112965,1,,10239265
6,102602460,103093824,del,SP112965,1,,491364
11,56383824,59064509,dup,SP112965,1,,2680685
18,50217076,50695094,del,SP112965,1,,478018
5,36324338,45775634,dup,SP112965,1,,9451296
3,66823736,70016178,dup,SP112965,1,,3192442
5,57797701,58285318,dup,SP112965,1,,487617
8,17582270,42864687,del,SP112965,1,,25282417
11,117089726,118325108,dup,SP112965,1,,1235382
12,67177224,68037863,dup,SP112965,1,,860639
9,1,39184065,dup,SP112965,1,,39184064
2,242377514,243199373,dup,SP112965,1,,821859
4,54330425,55114178,dup,SP112965,1,,783753
7,130520530,131635024,dup,SP112965,1,,1114494
1,60210813,60722234,del,SP112965,1,,511421
14,20772132,25002080,dup,SP112965,1,,4229948
2,95429197,99076563,dup,SP112965,1,,3647366
7,108353664,109109455,dup,SP112965,1,,755791
7,98299281,104106091,dup,SP112965,1,,5806810
5,78103910,78938445,dup,SP112965,1,,834535
16,2241338,3806068,dup,SP112965,1,,1564730
20,1,11379066,dup,SP112965,1,,11379065
12,87867022,91268829,dup,SP112965,1,,3401807
13,68640678,69657702,del,SP112965,1,,1017024
12,47244756,50131555,dup,SP112965,1,,2886799
3,132976570,164088695,dup,SP112965,1,,31112125
5,95471039,95826968,dup,SP112965,1,,355929
19,32666729,33781677,dup,SP112965,1,,1114948
7,25872334,36646839,dup,SP112965,1,,10774505
7,11622387,21405164,dup,SP112965,1,,9782777
12,69228397,71231892,dup,SP112965,1,,2003495
1,172556962,174517689,dup,SP112965,1,,1960727
3,185821550,187490806,dup,SP112965,1,,1669256
20,59799317,60903414,dup,SP112965,1,,1104097
6,33103755,50603374,dup,SP112965,1,,17499619
5,1510487,8417451,dup,SP112965,1,,6906964
12,91764692,94904702,dup,SP112965,1,,3140010
5,106198614,113914987,dup,SP112965,1,,7716373
1,170117366,171896427,dup,SP112965,1,,1779061
7,77612431,84197909,dup,SP112965,1,,6585478
7,2095970,4891165,dup,SP112965,1,,2795195
3,73145324,91000000,dup,SP112965,1,,17854676
1,243661884,249250621,dup,SP112965,1,,5588737
2,239108192,241462301,dup,SP112965,1,,2354109
13,51921178,52393627,del,SP112965,1,,472449
19,34527792,46327713,dup,SP112965,1,,11799921
13,64411356,64973863,del,SP112965,1,,562507
18,62291390,63203385,del,SP112965,1,,911995
20,29519156,38625249,dup,SP112965,1,,9106093
5,121412164,123672474,dup,SP112965,1,,2260310
3,93517443,117891279,dup,SP112965,1,,24373836
18,54345395,56092157,del,SP112965,1,,1746762
6,20455684,28412705,dup,SP112965,1,,7957021
3,70568489,73145324,del,SP112965,1,,2576835
7,121110146,122463431,dup,SP112965,1,,1353285
6,168332928,168590641,dup,SP112965,1,,257713
16,5120927,7711719,dup,SP112965,1,,2590792
7,115807379,118994350,dup,SP112965,1,,3186971
7,106403159,107211344,dup,SP112965,1,,808185
2,1375374,1765444,dup,SP112965,1,,390070
20,15326506,21169674,dup,SP112965,1,,5843168
7,151208224,152138941,dup,SP112965,1,,930717
20,11629665,14618593,dup,SP112965,1,,2988928
7,23841295,25242870,dup,SP112965,1,,1401575
12,106238300,116887991,dup,SP112965,1,,10649691
5,28888459,33093661,dup,SP112965,1,,4205202
16,23593147,31931688,dup,SP112965,1,,8338541
19,27754573,31329934,dup,SP112965,1,,3575361
5,132305948,137217427,dup,SP112965,1,,4911479
5,115160222,117397290,dup,SP112965,1,,2237068
6,115661277,116518703,del,SP112965,1,,857426
7,47299148,58025423,dup,SP112965,1,,10726275
6,31348170,32720222,dup,SP112965,1,,1372052
20,47830939,52745713,dup,SP112965,1,,4914774
22,24392203,25436173,del,SP112965,1,,1043970
22,24343908,24392203,del,SP112965,1,,48295
11,62110502,62941151,dup,SP112965,1,,830649
2,99145290,99206468,dup,SP112965,1,,61178
19,4117740,7515014,dup,SP112965,1,,3397274
15,24159893,26235001,dup,SP112965,1,,2075108
2,42943841,43484359,dup,SP112965,1,,540518
7,6451088,8223942,dup,SP112965,1,,1772854
5,10617605,11531569,dup,SP112965,1,,913964
7,109912622,111994063,dup,SP112965,1,,2081441
4,56257385,56893842,dup,SP112965,1,,636457
11,76638227,77766524,dup,SP112965,1,,1128297
12,72990604,86665487,dup,SP112965,1,,13674883
7,38713877,39335460,dup,SP112965,1,,621583
11,80242604,81050265,dup,SP112965,1,,807661
7,61064518,70009171,dup,SP112965,1,,8944653
3,59901865,65688248,dup,SP112965,1,,5786383
3,129365608,131593832,dup,SP112965,1,,2228224
1,193155120,196046837,dup,SP112965,1,,2891717
7,70729807,77093033,dup,SP112965,1,,6363226
9,116824864,117607589,dup,SP112965,1,,782725
15,22752399,23421513,dup,SP112965,1,,669114
5,176959473,178169638,dup,SP112965,1,,1210165
12,58111654,66322890,dup,SP112965,1,,8211236
6,51005276,54611417,dup,SP112965,1,,3606141
13,77984291,78896041,del,SP112965,1,,911750
11,64612368,69423697,dup,SP112965,1,,4811329
7,87215441,90403392,dup,SP112965,1,,3187951
3,121886884,127370980,dup,SP112965,1,,5484096
19,678873,1206268,dup,SP112965,1,,527395
1,175059838,187624015,dup,SP112965,1,,12564177
13,105847238,115169878,dup,SP112965,1,,9322640
5,97765086,98710953,dup,SP112965,1,,945867
1,144009053,156722023,dup,SP112965,1,,12712970
11,113111426,114838833,dup,SP112965,1,,1727407
3,41284209,43982148,dup,SP112965,1,,2697939
5,74985369,76164644,dup,SP112965,1,,1179275
6,1,396938,dup,SP112965,1,,396937
11,131113182,135006516,dup,SP112965,1,,3893334
1,222250655,224692671,dup,SP112965,1,,2442016
13,59114889,59671570,del,SP112965,1,,556681
21,39863440,42873810,del,SP112965,1,,3010370
12,51145974,52934933,dup,SP112965,1,,1788959
3,128308503,129091570,dup,SP112965,1,,783067
6,111660941,111787308,del,SP112965,1,,126367
9,140088700,141213431,dup,SP112965,1,,1124731
3,24380513,31553003,dup,SP112965,1,,7172490
6,2326078,4432273,dup,SP112965,1,,2106195
5,148966594,159077267,dup,SP112965,1,,10110673
7,128582983,129225078,dup,SP112965,1,,642095
2,113311633,114012147,dup,SP112965,1,,700514
1,11170791,11269538,del,SP112965,1,,98747
6,29612018,30946079,dup,SP112965,1,,1334061
11,93171482,93907866,dup,SP112965,1,,736384
12,18975834,32475382,dup,SP112965,1,,13499548
20,61662309,63025520,dup,SP112965,1,,1363211
13,94255973,94619540,del,SP112965,1,,363567
21,20815865,21463662,del,SP112965,1,,647797
5,84331079,85063758,dup,SP112965,1,,732679
7,132118485,139291394,dup,SP112965,1,,7172909
12,37902988,39359804,dup,SP112965,1,,1456816
11,125526050,127374816,dup,SP112965,1,,1848766
19,12715946,13278671,dup,SP112965,1,,562725
8,46896972,146364022,dup,SP112965,1,,99467050
15,31270808,31705190,dup,SP112965,1,,434382
2,219045615,221097050,dup,SP112965,1,,2051435
1,224908729,243491033,del,SP112965,1,,18582304
16,34297972,35271725,dup,SP112965,1,,973753
6,14199495,15883201,dup,SP112965,1,,1683706
5,164683323,176271676,dup,SP112965,1,,11588353
16,1,540021,dup,SP112949,1,,540020
19,45902737,46245161,dup,SP112949,1,,342424
19,40743817,40779422,dup,SP112949,1,,35605
19,19803638,21113464,del,SP112949,1,,1309826
10,44397394,45693605,del,SP112949,1,,1296211
18,19336551,78077248,del,SP112949,1,,58740697
7,31389981,31723065,del,SP112949,1,,333084
9,126269322,129147111,del,SP112949,1,,2877789
19,1225236,1320068,del,SP112949,1,,94832
11,69473447,69508928,dup,SP112949,1,,35481
X,1,2693433,dup,SP112949,1,,2693432
17,80065470,81195210,dup,SP112949,1,,1129740
14,22475859,22981839,dup,SP112949,1,,505980
2,141328855,141498405,del,SP112949,1,,169550
1,63478104,93635603,del,SP112949,1,,30157499
6,73868876,104691896,del,SP112949,1,,30823020
10,118921903,120300863,del,SP112949,1,,1378960
2,37000350,37306905,del,SP112949,1,,306555
3,109968851,110886715,del,SP112949,1,,917864
16,74948691,90354753,del,SP112949,1,,15406062
12,10441808,16054272,del,SP112949,1,,5612464
16,68566260,69201040,del,SP112949,1,,634780
1,26532178,28571405,del,SP112949,1,,2039227
11,46410945,47538063,del,SP112949,1,,1127118
7,23816194,24848498,del,SP112949,1,,1032304
14,37179485,38081879,dup,SP112949,1,,902394
8,22150259,24248587,del,SP112949,1,,2098328
19,55607748,56432029,dup,SP112949,1,,824281
2,32761721,33660383,del,SP112949,1,,898662
2,39554157,42719586,del,SP112949,1,,3165429
10,82381383,90233294,del,SP112949,1,,7851911
1,144966664,145288012,dup,SP112949,1,,321348
10,46966883,48002654,dup,SP112949,1,,1035771
2,33131138,50627196,del,SP112951,1,,17496058
5,1,12408979,dup,SP112951,1,,12408978
14,106393378,107349540,dup,SP112951,1,,956162
16,1,35271725,dup,SP112951,1,,35271724
8,8094763,37267133,del,SP112951,1,,29172370
14,89233760,106292885,del,SP112951,1,,17059125
16,78163321,90354753,del,SP112951,1,,12191432
22,42565285,51304566,del,SP112951,1,,8739281
12,1,30465591,del,SP112951,1,,30465590
9,70984372,77367696,del,SP112951,1,,6383324
17,1,22217883,dup,SP112951,1,,22217882
3,77231004,77335588,del,SP112953,1,,104584
4,1692887,1807677,del,SP112953,1,,114790
1,93600658,95706632,del,SP112953,1,,2105974
4,35645281,36760593,del,SP112953,1,,1115312
17,42114225,42925559,del,SP112953,1,,811334
15,64451443,64950516,del,SP112953,1,,499073
X,1,2663125,dup,SP112953,1,,2663124
22,24343908,24392203,dup,SP112953,1,,48295
10,74583706,92584814,del,SP112953,1,,18001108
1,175692433,176466173,del,SP112953,1,,773740
20,20633037,23631363,del,SP112953,1,,2998326
4,1807677,1878181,dup,SP112953,1,,70504
1,100236463,101203024,del,SP112953,1,,966561
8,22305109,22923323,del,SP112953,1,,618214
12,4048588,14088806,del,SP112953,1,,10040218
12,125068165,132660140,del,SP112953,1,,7591975
13,34295148,97461997,del,SP112953,1,,63166849
3,10176048,10226162,dup,SP112953,1,,50114
21,39872681,42873810,del,SP112953,1,,3001129
12,15989571,16292569,del,SP112953,1,,302998
17,1156435,1351026,del,SP112953,1,,194591
8,113194220,146364022,dup,SP112955,1,,33169802
7,40913768,58025423,del,SP112955,1,,17111655
20,1,26309255,dup,SP112955,1,,26309254
6,87658175,122611035,del,SP112955,1,,34952860
8,1,7004147,del,SP112955,1,,7004146
3,187758802,198022430,del,SP112955,1,,10263628
Y,2660163,10010068,del,SP112955,1,,7349905
18,66761534,78077248,del,SP112955,1,,11315714
5,1,12697296,dup,SP112955,1,,12697295
X,61732394,155270560,del,SP112955,1,,93538166
11,97301348,135006516,del,SP112955,1,,37705168
18,1991028,15377471,dup,SP112955,1,,13386443
Y,20810616,24510481,del,SP112955,1,,3699865
16,46461309,90354753,del,SP112955,1,,43893444
5,31360562,46401271,dup,SP112955,1,,15040709
4,52684891,69890345,del,SP112955,1,,17205454
2,188490106,195331583,del,SP112955,1,,6841477
12,1,35800000,del,SP112955,1,,35799999
8,56388266,88540383,dup,SP112955,1,,32152117
13,40821833,86976361,del,SP112955,1,,46154528
18,1,1991028,del,SP112955,1,,1991027
8,8094763,43767534,del,SP112955,1,,35672771
X,1,58470802,del,SP112955,1,,58470801
3,114564967,187758802,dup,SP112955,1,,73193835
Y,12500000,19516141,del,SP112955,1,,7016141
11,113728892,114780576,del,SP112957,1,,1051684
11,50012148,50979032,dup,SP112957,1,,966884
10,91025769,97445170,del,SP112957,1,,6419401
6,975075,2653712,del,SP112957,1,,1678637
6,4723688,5485909,del,SP112957,1,,762221
16,56561886,90354753,del,SP112957,1,,33792867
13,20763208,21470254,del,SP112957,1,,707046
8,31617073,43767534,del,SP112957,1,,12150461
22,24337410,24406725,dup,SP112957,1,,69315
17,4701176,7530255,del,SP112957,1,,2829079
12,71536050,72017200,del,SP112957,1,,481150
5,32107257,32181543,dup,SP112957,1,,74286
8,8094763,23012915,del,SP112957,1,,14918152
10,89629138,91025769,del,SP112957,1,,1396631
10,89604082,89629138,del,SP112957,1,,25056
X,1,2693433,dup,SP112957,1,,2693432
12,114980456,116380027,del,SP112957,1,,1399571
4,88535205,89439531,del,SP112957,1,,904326
7,151913643,152417978,del,SP112957,1,,504335
3,23066309,28964305,del,SP112957,1,,5897996
6,6622046,7176571,del,SP112957,1,,554525
17,17821962,19438681,del,SP112957,1,,1616719
17,7565410,15828576,del,SP112957,1,,8263166
2,235484574,235885789,del,SP112957,1,,401215
21,39914611,42873810,del,SP112957,1,,2959199
10,42515230,54766400,del,SP112957,1,,12251170
8,145633842,146364022,del,SP112957,1,,730180
17,34861761,36018189,del,SP112957,1,,1156428
8,25225982,30744144,del,SP112957,1,,5518162
1,175432664,175763656,dup,SP112957,1,,330992
12,62779489,67665087,del,SP112957,1,,4885598
1,21224829,25548834,del,SP112957,1,,4324005
10,55801726,89160668,del,SP112957,1,,33358942
8,1,7004147,del,SP112957,1,,7004146
12,132468602,133305068,del,SP112957,1,,836466
13,50803156,51272801,del,SP112957,1,,469645
2,39363374,46913804,del,SP112957,1,,7550430
2,7843961,8605388,del,SP112957,1,,761427
13,35376212,50803156,del,SP112957,1,,15426944
2,71713531,73912204,del,SP112957,1,,2198673
17,73295298,79148144,del,SP112957,1,,5852846
10,89160668,89604082,del,SP112957,1,,443414
11,69482669,69506393,dup,SP112957,1,,23724
2,25826903,26458676,del,SP112957,1,,631773
13,51272801,76194084,del,SP112957,1,,24921283
12,75158491,75789026,del,SP112957,1,,630535
13,19969889,20516954,del,SP112957,1,,547065
18,5188854,10575510,del,SP112957,1,,5386656
17,38961336,42909553,del,SP112957,1,,3948217
12,111973317,112562558,del,SP112957,1,,589241
4,85563251,86226112,del,SP112957,1,,662861
10,102471808,105200480,del,SP112957,1,,2728672
12,12996809,14574950,del,SP112957,1,,1578141
4,29592236,31092650,del,SP112957,1,,1500414
6,87596475,89527392,del,SP112957,1,,1930917
2,212826298,213427410,dup,SP112959,1,,601112
19,282513,2368871,dup,SP112959,1,,2086358
4,132876106,134212815,dup,SP112959,1,,1336709
10,46571122,47126844,dup,SP112959,1,,555722
3,95589433,96041677,del,SP112959,1,,452244
1,208591112,209367258,dup,SP112959,1,,776146
16,88354041,89374044,dup,SP112959,1,,1020003
9,31533079,32773117,del,SP112959,1,,1240038
2,42416617,42554607,del,SP112959,1,,137990
4,35895769,44553324,del,SP112959,1,,8657555
3,96674688,98019743,del,SP112959,1,,1345055
11,69409496,69450856,del,SP112959,1,,41360
9,29404197,30296106,del,SP112959,1,,891909
1,11858250,11944340,del,SP112959,1,,86090
6,66700180,69202286,del,SP112959,1,,2502106
12,132618393,133199945,dup,SP112959,1,,581552
5,102144410,102581680,del,SP112959,1,,437270
14,46814278,47280650,del,SP112959,1,,466372
14,106566869,106827209,dup,SP112959,1,,260340
7,9043000,9700934,dup,SP112959,1,,657934
10,107881161,111366255,del,SP112959,1,,3485094
1,3723476,3813295,del,SP112959,1,,89819
7,111142760,111898223,dup,SP112959,1,,755463
9,139388854,140396299,dup,SP112959,1,,1007445
5,100524911,101718901,del,SP112959,1,,1193990
13,90123239,102163104,del,SP112959,1,,12039865
13,57319634,57634751,del,SP112959,1,,315117
13,86988481,87269880,del,SP112959,1,,281399
9,11524192,12236582,del,SP112959,1,,712390
1,169260194,169879890,del,SP112959,1,,619696
1,168180442,168930328,del,SP112959,1,,749886
X,153297267,153558373,del,SP112959,1,,261106
3,75067843,84136492,del,SP112959,1,,9068649
4,53991380,54330425,del,SP112959,1,,339045
17,38465496,38530020,dup,SP112959,1,,64524
6,70144988,124627881,del,SP112959,1,,54482893
1,75614081,95615509,del,SP112959,1,,20001428
5,98442149,98843714,del,SP112959,1,,401565
17,78932129,80211192,dup,SP112959,1,,1279063
6,69202286,70144988,del,SP112959,1,,942702
19,33551180,33796483,dup,SP112959,1,,245303
5,108012268,108651415,del,SP112959,1,,639147
13,80346405,80906732,del,SP112959,1,,560327
9,24697375,26111030,del,SP112959,1,,1413655
12,58113365,58161990,dup,SP112959,1,,48625
1,147807940,149708418,dup,SP112959,1,,1900478
4,24527314,33061111,del,SP112959,1,,8533797
1,170642351,171420046,del,SP112959,1,,777695
11,1,917350,dup,SP112959,1,,917349
1,153976726,154212965,dup,SP112959,1,,236239
17,1400691,1789659,del,SP112959,1,,388968
5,54982563,57667424,del,SP112959,1,,2684861
19,3152039,4106515,dup,SP112959,1,,954476
5,106657754,107306663,del,SP112959,1,,648909
5,105103397,106572363,del,SP112959,1,,1468966
4,1765161,1833118,dup,SP112959,1,,67957
7,117769826,119597048,dup,SP112959,1,,1827222
20,60772783,62206014,dup,SP112959,1,,1433231
1,1,1300571,dup,SP112959,1,,1300570
7,13202885,14365703,dup,SP112959,1,,1162818
4,170013484,170372941,del,SP112959,1,,359457
4,182460900,183152619,del,SP112959,1,,691719
1,167507788,168180442,dup,SP112959,1,,672654
8,144285572,145774026,dup,SP112959,1,,1488454
16,89374044,89551509,del,SP112959,1,,177465
7,56327165,58025423,del,SP112959,1,,1698258
2,42554607,45021625,del,SP112959,1,,2467018
7,53092014,53554426,dup,SP112959,1,,462412
14,105237833,105294923,dup,SP112959,1,,57090
8,8094763,33724227,del,SP112959,1,,25629464
2,138577868,144359747,del,SP112959,1,,5781879
16,572747,2304205,dup,SP112959,1,,1731458
1,154587555,155038486,dup,SP112959,1,,450931
13,39436431,57319634,del,SP112959,1,,17883203
22,50068172,50575084,del,SP112959,1,,506912
11,2147780,2476163,dup,SP112959,1,,328383
17,1230508,1357392,del,SP112959,1,,126884
7,113323486,116442221,del,SP112959,1,,3118735
1,168930328,169260194,dup,SP112959,1,,329866
1,2097466,2497781,dup,SP112959,1,,400315
11,69450856,69474676,dup,SP112959,1,,23820
2,80017999,82141228,del,SP112959,1,,2123229
22,46540594,46745398,del,SP112959,1,,204804
5,97484972,98442149,del,SP112959,1,,957177
5,58086028,68828372,del,SP112959,1,,10742344
4,157746348,158088836,del,SP112959,1,,342488
1,144009053,147561985,dup,SP112959,1,,3552932
13,59275754,77582242,del,SP112959,1,,18306488
4,58759319,59061536,del,SP112959,1,,302217
2,13351771,13757926,del,SP112959,1,,406155
4,131074848,131842076,dup,SP112959,1,,767228
5,1027402,1295326,dup,SP112959,1,,267924
19,40716085,40749629,dup,SP112959,1,,33544
1,187996031,188688966,dup,SP112959,1,,692935
1,209728741,210298942,dup,SP112959,1,,570201
5,98843714,100524911,del,SP112959,1,,1681197
13,57634751,59024990,del,SP112959,1,,1390239
2,65921655,69874830,del,SP112959,1,,3953175
2,12011189,12765496,del,SP112959,1,,754307
2,115731878,117670650,del,SP112959,1,,1938772
13,88041985,88403616,del,SP112959,1,,361631
1,156034043,156088301,dup,SP112959,1,,54258
5,81767893,97484972,del,SP112959,1,,15717079
2,33632311,42416617,del,SP112959,1,,8784306
8,5086919,7004147,del,SP112959,1,,1917228
11,67290136,67375404,del,SP112959,1,,85268
7,83385902,85913225,dup,SP112959,1,,2527323
12,87256029,88047324,dup,SP112959,1,,791295
X,84161786,85038907,del,SP112959,1,,877121
4,59522829,60123159,del,SP112959,1,,600330
16,87999528,88354041,del,SP112959,1,,354513
4,1833118,1963169,del,SP112959,1,,130051
13,38120439,38237188,del,SP112959,1,,116749
X,1,2693433,dup,SP112959,1,,2693432
1,159314951,165793249,del,SP112959,1,,6478298
7,117042,1375244,dup,SP112959,1,,1258202
5,70306678,81059340,del,SP112959,1,,10752662
3,163695896,165044882,dup,SP112959,1,,1348986
10,122642890,123014995,dup,SP112959,1,,372105
12,10058683,13047228,del,SP112959,1,,2988545
4,171546572,171947412,del,SP112959,1,,400840
19,10229023,10331451,del,SP112959,1,,102428
8,63942450,65549515,del,SP112961,1,,1607065
12,12055156,13906394,del,SP112961,1,,1851238
1,149509215,155329740,dup,SP112961,1,,5820525
2,81671267,85433331,del,SP112961,1,,3762064
4,188247695,189715860,del,SP112961,1,,1468165
3,145135028,145641714,dup,SP112961,1,,506686
3,142799901,144215560,dup,SP112961,1,,1415659
4,161194638,163679895,del,SP112961,1,,2485257
2,43541168,50970539,del,SP112961,1,,7429371
8,13868740,31849918,del,SP112961,1,,17981178
11,1,930888,dup,SP112961,1,,930887
11,83695484,85848530,del,SP112961,1,,2153046
16,31946977,33727980,del,SP112961,1,,1781003
8,48631166,63801022,dup,SP112961,1,,15169856
12,73665047,75843273,dup,SP112961,1,,2178226
7,123263123,127165387,del,SP112961,1,,3902264
3,146049182,146874878,dup,SP112961,1,,825696
12,20330170,21703506,dup,SP112961,1,,1373336
15,36512476,41744607,del,SP112961,1,,5232131
7,116233678,119520642,del,SP112961,1,,3286964
X,26372774,31494357,del,SP112961,1,,5121583
11,67304191,67372567,del,SP112961,1,,68376
1,200791287,249250621,dup,SP112961,1,,48459334
8,114194230,146229729,dup,SP112961,1,,32035499
15,45734667,47831273,del,SP112961,1,,2096606
3,146874878,162408083,dup,SP112961,1,,15533205
5,10150193,12805019,del,SP112961,1,,2654826
21,26567183,27357634,del,SP112961,1,,790451
7,84469369,84817165,del,SP112961,1,,347796
2,88765815,89544091,del,SP112961,1,,778276
15,96524894,97112477,del,SP112961,1,,587583
3,141679930,142535383,dup,SP112961,1,,855453
12,99812261,100479239,dup,SP112961,1,,666978
14,65922948,70458188,del,SP112961,1,,4535240
12,44708360,46221674,del,SP112961,1,,1513314
11,69446756,69471278,dup,SP112961,1,,24522
8,46896972,48376526,dup,SP112961,1,,1479554
19,10235082,10304672,del,SP112961,1,,69590
8,32334526,43767534,del,SP112961,1,,11433008
2,198752978,199525364,del,SP112961,1,,772386
8,3366613,7004147,del,SP112961,1,,3637534
8,31849918,32334526,del,SP112961,1,,484608
5,1361347,2202301,del,SP112961,1,,840954
3,97468324,141679930,dup,SP112961,1,,44211606
7,54038877,56448744,del,SP112961,1,,2409867
8,8094763,13672683,del,SP112961,1,,5577920
17,78928921,81195210,dup,SP112961,1,,2266289
22,24343908,24392203,del,SP112961,1,,48295
7,121063513,121305221,del,SP112961,1,,241708
2,108777055,112813089,del,SP112961,1,,4036034
7,743564,1194841,dup,SP112961,1,,451277
7,71995605,72859025,dup,SP112961,1,,863420
8,3166125,3366613,dup,SP112961,1,,200488
19,33551180,33810062,dup,SP112961,1,,258882
5,26988712,27355338,del,SP112961,1,,366626
12,128779986,129091586,del,SP112961,1,,311600
1,178070757,198462222,dup,SP112961,1,,20391465
4,166495218,168755364,del,SP112961,1,,2260146
16,88368747,89364873,dup,SP112961,1,,996126
3,1,7151648,del,SP112961,1,,7151647
3,88060177,90201121,del,SP112961,1,,2140944
16,2007124,2592517,dup,SP112961,1,,585393
2,114441396,117461411,del,SP112961,1,,3020015
11,69423078,69446756,del,SP112961,1,,23678
14,106524357,106778612,dup,SP112961,1,,254255
16,388734,1285563,dup,SP112961,1,,896829
4,47051446,48782454,del,SP112961,1,,1731008
12,58113071,58161990,dup,SP112961,1,,48919
11,119627139,125454176,del,SP112961,1,,5827037
9,74536411,77193583,del,SP112961,1,,2657172
3,163051093,165077470,dup,SP112961,1,,2026377
4,133387409,134168942,del,SP112961,1,,781533
13,56448596,57045750,del,SP112961,1,,597154
9,8965625,9633040,del,SP112961,1,,667415
4,60466196,61071803,del,SP112961,1,,605607
13,48763784,52409009,del,SP112961,1,,3645225
12,122268118,122615985,del,SP112961,1,,347867
2,75689279,81353084,del,SP112961,1,,5663805
12,78183944,78606786,dup,SP112961,1,,422842
4,19581297,21461893,del,SP112961,1,,1880596
Y,17372886,19516141,del,SP112961,1,,2143255
10,94952799,96514848,del,SP112961,1,,1562049
9,70984372,72001541,del,SP112961,1,,1017169
12,4347319,10013944,del,SP112961,1,,5666625
15,99679618,100866621,del,SP112961,1,,1187003
4,164057822,165632499,del,SP112961,1,,1574677
15,97790015,98402585,del,SP112961,1,,612570
4,16701580,18660539,del,SP112961,1,,1958959
4,127385547,130597117,del,SP112961,1,,3211570
8,1953953,3166125,del,SP112961,1,,1212172
2,201081137,201817017,del,SP112961,1,,735880
3,145641714,146049182,dup,SP112961,1,,407468
14,20487677,24501915,del,SP112961,1,,4014238
19,40685121,40733533,dup,SP112961,1,,48412
3,76627963,81173514,del,SP112961,1,,4545551
X,1,2693433,dup,SP112961,1,,2693432
19,584625,1606463,dup,SP112961,1,,1021838
12,10297372,12048994,del,SP112961,1,,1751622
16,58587990,61828989,del,SP112961,1,,3240999
12,123794129,125705484,del,SP112961,1,,1911355
18,77144786,77672590,dup,SP112961,1,,527804
8,1,1953953,dup,SP112961,1,,1953952
3,83433309,88060177,del,SP112961,1,,4626868
10,89637066,91175506,del,SP112961,1,,1538440
11,37403276,39204528,del,SP112961,1,,1801252
16,73819294,74806993,del,SP112961,1,,987699
10,84555226,89592380,del,SP112961,1,,5037154
9,7766151,8108177,dup,SP112961,1,,342026
12,132618393,133199945,dup,SP112961,1,,581552
16,30880025,31252015,dup,SP112961,1,,371990
5,82272222,86235422,del,SP112961,1,,3963200
6,112709550,119242535,del,SP112961,1,,6532985
18,31594207,32134409,del,SP112961,1,,540202
19,19803638,20903313,del,SP112961,1,,1099675
3,93674551,97195647,dup,SP112961,1,,3521096
2,157708968,158252810,del,SP112961,1,,543842
15,51900121,52604872,del,SP112961,1,,704751
4,120523999,126753351,del,SP112961,1,,6229352
11,87828854,88193422,del,SP112961,1,,364568
3,165657391,169106564,dup,SP112961,1,,3449173
9,140114125,140355056,dup,SP112961,1,,240931
3,144215560,145135028,dup,SP112961,1,,919468
8,65623008,112924706,dup,SP112961,1,,47301698
1,144009053,148794708,dup,SP112961,1,,4785655
17,6784469,8296311,del,SP112963,1,,1511842
13,48894573,75713686,del,SP112963,1,,26819113
5,131425075,134110622,del,SP112963,1,,2685547
5,118263494,126977674,del,SP112963,1,,8714180
17,48720903,48768077,dup,SP112963,1,,47174
5,81660792,82089837,del,SP112963,1,,429045
4,184143955,185297026,del,SP112963,1,,1153071
19,40795859,42723039,del,SP112963,1,,1927180
15,74255334,74342619,dup,SP112963,1,,87285
6,162876320,163165401,dup,SP112963,1,,289081
5,135594631,136206060,del,SP112963,1,,611429
5,141960499,142367529,del,SP112963,1,,407030
5,164088836,165015856,del,SP112963,1,,927020
17,52859199,54209585,del,SP112963,1,,1350386
19,1343723,2458501,del,SP112963,1,,1114778
12,124606849,125430067,del,SP112963,1,,823218
12,62821335,64814653,del,SP112963,1,,1993318
19,36646413,40603388,del,SP112963,1,,3956975
5,64775208,68828372,del,SP112963,1,,4053164
14,74436611,81654778,del,SP112963,1,,7218167
2,213391168,213427410,dup,SP112963,1,,36242
22,45283932,48180400,del,SP112963,1,,2896468
5,145148335,145673279,del,SP112963,1,,524944
5,49958772,51297448,del,SP112963,1,,1338676
21,40038769,42879785,del,SP112963,1,,2841016
10,64163515,64844039,del,SP112963,1,,680524
3,159941333,161011659,dup,SP112963,1,,1070326
5,70306678,80470867,del,SP112963,1,,10164189
5,82697754,84687877,del,SP112963,1,,1990123
3,136499619,138207119,del,SP112963,1,,1707500
X,1,2693433,dup,SP112963,1,,2693432
10,87529864,90637947,del,SP112963,1,,3108083
3,49894871,49976249,dup,SP112963,1,,81378
5,162844436,163316986,del,SP112963,1,,472550
19,10274516,10353061,del,SP112963,1,,78545
5,108611842,113421406,del,SP112963,1,,4809564
19,18419107,19200807,del,SP112963,1,,781700
13,44564929,48871684,del,SP112963,1,,4306755
9,13307916,14619347,del,SP112963,1,,1311431
5,136833648,137485568,del,SP112963,1,,651920
5,107419981,108611842,del,SP112963,1,,1191861
19,45741338,50862273,del,SP112963,1,,5120935
14,59912278,62315840,del,SP112963,1,,2403562
5,52856479,55009590,del,SP112963,1,,2153111
5,146930596,148717281,del,SP112963,1,,1786685
4,89333024,91330362,del,SP112963,1,,1997338
5,167103229,168729146,del,SP112963,1,,1625917
3,12988357,13624597,dup,SP112963,1,,636240
4,6998577,7861294,del,SP112963,1,,862717
17,34873034,40046998,del,SP112963,1,,5173964
5,56669933,58419110,del,SP112963,1,,1749177
14,22609150,22734991,dup,SP112963,1,,125841
3,97929179,98774942,dup,SP112963,1,,845763
3,162288055,165136187,dup,SP112963,1,,2848132
1,110243644,110892025,del,SP112963,1,,648381
12,1,35800000,del,SP112963,1,,35799999
22,41751929,45199254,del,SP112963,1,,3447325
5,134807270,135159131,del,SP112963,1,,351861
5,114506422,115414206,del,SP112963,1,,907784
19,12903601,15465584,del,SP112963,1,,2561983
16,34468168,34777669,dup,SP112963,1,,309501
4,9606513,11722690,del,SP112963,1,,2116177
5,28260480,28586297,del,SP112963,1,,325817
17,69119645,70444881,del,SP112963,1,,1325236
1,109242067,110227064,del,SP112963,1,,984997
12,37902988,48291188,del,SP112963,1,,10388200
3,78934094,79088614,dup,SP112963,1,,154520
1,21748856,23366497,del,SP112963,1,,1617641
3,128266515,128631991,dup,SP112963,1,,365476
19,45373046,45565940,dup,SP112963,1,,192894
3,143522165,149489469,del,SP112963,1,,5967304
9,6542506,7025083,dup,SP112963,1,,482577
5,91760710,107419981,del,SP112963,1,,15659271
5,55009590,56400379,del,SP112963,1,,1390789
3,93517443,94014228,dup,SP112963,1,,496785
3,94823794,95415681,del,SP112963,1,,591887
19,50862273,51314022,dup,SP112963,1,,451749
14,32664828,39154164,del,SP112963,1,,6489336
17,41680066,42894252,del,SP112963,1,,1214186
19,4435929,5697437,dup,SP112963,1,,1261508
3,50259296,50701525,dup,SP112963,1,,442229
5,171409543,175221006,del,SP112963,1,,3811463
3,138493099,139316918,dup,SP112963,1,,823819
22,24343908,24403467,dup,SP112963,1,,59559
X,154923128,155270560,dup,SP112947,1,,347432
8,46896972,117138560,dup,SP112947,1,,70241588
6,77985580,93758433,del,SP112947,1,,15772853
X,1,2709287,dup,SP112947,1,,2709286
5,109155688,119690328,del,SP112947,1,,10534640
13,44166499,80663403,del,SP112947,1,,36496904
8,117138560,120573154,del,SP112947,1,,3434594
8,1,7004147,del,SP112947,1,,7004146
5,99939366,101546530,del,SP112947,1,,1607164
8,120573154,146364022,dup,SP112947,1,,25790868
5,49688562,62998493,del,SP112947,1,,13309931
2,134314613,163541417,del,SP112947,1,,29226804
10,87181984,107974536,del,SP112947,1,,20792552
8,8094763,43767534,del,SP112947,1,,35672771
19,1178158,1223486,dup,SP112943,1,,45328
1,11868205,11975221,del,SP112943,1,,107016
17,4680445,5048017,dup,SP112943,1,,367572
17,48724514,48888474,del,SP112943,1,,163960
4,1692887,1810068,del,SP112943,1,,117181
6,44273603,46431787,del,SP112943,1,,2158184
17,78569361,78642035,del,SP112943,1,,72674
3,49897651,49952392,dup,SP112943,1,,54741
X,1,2693433,dup,SP112943,1,,2693432
12,58112587,58148056,dup,SP112943,1,,35469
16,48996755,75239705,del,SP112943,1,,26242950
5,137834399,138811748,del,SP112943,1,,977349
22,43664768,46660147,del,SP112943,1,,2995379
22,47204787,50289819,del,SP112943,1,,3085032
12,12461365,14829102,del,SP112943,1,,2367737
21,42609435,42859011,del,SP112943,1,,249576
20,14056265,14196851,del,SP112943,1,,140586
22,32068474,32850006,del,SP112943,1,,781532
10,43494797,43621175,dup,SP112943,1,,126378
19,33663793,33787269,dup,SP112943,1,,123476
19,10274516,10462576,del,SP112943,1,,188060
3,113421241,122185543,del,SP112943,1,,8764302
11,69416756,69459431,del,SP112943,1,,42675
13,113330942,113821913,dup,SP112943,1,,490971
5,136944117,137761849,del,SP112943,1,,817732
17,37778725,37921844,dup,SP112943,1,,143119
17,47384152,48601144,del,SP112943,1,,1216992
17,43368943,46157787,del,SP112943,1,,2788844
5,132224709,132553668,del,SP112943,1,,328959
19,1223486,1254215,del,SP112943,1,,30729
11,119372594,121073336,del,SP112943,1,,1700742
5,68201072,68828372,del,SP112943,1,,627300
4,1810068,1878181,dup,SP112943,1,,68113
22,24746403,26375946,del,SP112943,1,,1629543
18,18554307,78077248,del,SP112943,1,,59522941
5,171849454,173235374,del,SP112943,1,,1385920
11,67237042,67372567,del,SP112943,1,,135525
22,27329404,28985091,del,SP112943,1,,1655687
5,70306678,76164644,del,SP112943,1,,5857966
18,14922827,15377471,del,SP112943,1,,454644
17,1230508,1354464,del,SP112943,1,,123956
16,75307996,90354753,del,SP112943,1,,15046757
11,113603837,115706375,del,SP112943,1,,2102538
8,17539669,39247104,del,SP112943,1,,21707435
21,36116827,37836834,del,SP112943,1,,1720007
17,75355817,75486838,dup,SP112943,1,,131021
9,130347296,130962415,del,SP112943,1,,615119
19,40695062,40793476,dup,SP112943,1,,98414
13,26070853,26812879,del,SP112945,1,,742026
17,36964466,37731338,del,SP112945,1,,766872
18,54334647,76994342,del,SP112945,1,,22659695
4,605598,1833118,dup,SP112945,1,,1227520
19,19101885,19573069,del,SP112945,1,,471184
11,67298739,67372567,del,SP112945,1,,73828
19,10231505,11436795,del,SP112945,1,,1205290
X,1,2693433,dup,SP112945,1,,2693432
13,29847666,115169878,del,SP112945,1,,85322212
17,7561411,7600907,del,SP112945,1,,39496
8,144285572,145779413,dup,SP112945,1,,1493841
1,1493066,1821395,del,SP112945,1,,328329
17,40464613,44796005,del,SP112945,1,,4331392
1,1,1493066,dup,SP112945,1,,1493065
11,33176202,34163537,del,SP112945,1,,987335
22,19938495,20745106,dup,SP112945,1,,806611
16,1953317,2338272,dup,SP112945,1,,384955
1,3723476,3817541,del,SP112945,1,,94065
11,2677952,2959113,dup,SP112945,1,,281161
10,134574118,135098104,dup,SP112945,1,,523986
11,69453655,69475291,dup,SP112945,1,,21636
21,46703017,46987215,dup,SP112945,1,,284198
9,120392246,121089895,del,SP112945,1,,697649
9,137407480,138369464,del,SP112945,1,,961984
3,72073411,72968537,del,SP112945,1,,895126
17,37921844,38465496,del,SP112945,1,,543652
2,242644313,243199373,dup,SP112945,1,,555060
9,140060207,140424060,dup,SP112945,1,,363853
7,151850,641590,dup,SP112945,1,,489740
16,388734,1587082,dup,SP112945,1,,1198348
14,104549166,106248982,dup,SP112945,1,,1699816
17,25326941,36857904,del,SP112945,1,,11530963
3,175197407,176882660,dup,SP112945,1,,1685253
13,19084823,21361368,del,SP112945,1,,2276545
20,60445263,62339514,dup,SP112945,1,,1894251
9,79758011,80558883,del,SP112945,1,,800872
19,279205,2471526,dup,SP112945,1,,2192321
10,46571122,47126844,dup,SP112945,1,,555722
1,11853432,12051788,del,SP112945,1,,198356
19,3032233,3663766,dup,SP112945,1,,631533
22,19702170,19823521,dup,SP112945,1,,121351
14,22640525,22798712,dup,SP112945,1,,158187
9,118444634,118880725,del,SP112945,1,,436091
8,101606809,103238359,del,SP112945,1,,1631550
22,19823521,19938495,del,SP112945,1,,114974
11,69418603,69444672,del,SP112945,1,,26069
1,1821395,3723476,dup,SP112945,1,,1902081
11,69475291,69492032,del,SP112945,1,,16741
21,45519918,45947948,dup,SP112945,1,,428030
9,140424060,141213431,del,SP112945,1,,789371
5,1027402,1293142,dup,SP112945,1,,265740
16,70099524,88413688,del,SP112945,1,,18314164
12,58112587,58148257,dup,SP112945,1,,35670
16,89161264,90354753,del,SP112945,1,,1193489
9,136293596,137407480,dup,SP112945,1,,1113884
8,143520734,143891609,dup,SP112945,1,,370875
17,78920856,80211192,dup,SP112945,1,,1290336
10,72844466,104987880,del,SP112945,1,,32143414
11,1,2489186,dup,SP112945,1,,2489185
7,896244,1133067,dup,SP112945,1,,236823
17,1357392,1670559,dup,SP112945,1,,313167
17,1230508,1357392,del,SP112945,1,,126884
16,1587082,1953317,del,SP112945,1,,366235
19,2471526,3032233,del,SP112945,1,,560707
10,43556629,43824297,dup,SP112945,1,,267668
12,132618393,133199945,dup,SP112945,1,,581552
1,234863052,235616059,del,SP112945,1,,753007
9,139386507,139588175,dup,SP112945,1,,201668
17,7600907,7622972,dup,SP112945,1,,22065
4,1833118,1973727,del,SP112945,1,,140609
17,38535585,40416776,del,SP112945,1,,1881191
22,44330604,46960034,del,SP112945,1,,2629430
11,2959113,3106977,del,SP112945,1,,147864
2,110186932,112472362,del,SP112945,1,,2285430
19,42746278,42924151,dup,SP112945,1,,177873
4,605598,1834550,dup,SP112927,1,,1228952
18,77144786,77735525,dup,SP112927,1,,590739
17,78578225,78759828,del,SP112927,1,,181603
10,94284175,95689590,del,SP112927,1,,1405415
X,153308196,153558373,del,SP112927,1,,250177
19,33535177,33799173,dup,SP112927,1,,263996
17,48413974,48716051,dup,SP112927,1,,302077
7,1,579006,dup,SP112927,1,,579005
16,88354041,89394507,dup,SP112927,1,,1040466
16,89877620,90120002,dup,SP112927,1,,242382
11,2959113,3106977,del,SP112927,1,,147864
8,25758990,27691712,del,SP112927,1,,1932722
1,71651580,76514229,del,SP112927,1,,4862649
1,46532295,48678918,del,SP112927,1,,2146623
19,50915287,51366236,dup,SP112927,1,,450949
8,143340501,143631476,dup,SP112927,1,,290975
16,1,2592517,dup,SP112927,1,,2592516
21,40582602,41187961,del,SP112927,1,,605359
12,132060038,132438692,dup,SP112927,1,,378654
1,3723476,6477568,del,SP112927,1,,2754092
8,145009955,145779413,dup,SP112927,1,,769458
19,10235082,10462576,del,SP112927,1,,227494
11,69418603,69449054,del,SP112927,1,,30451
11,67298739,67372567,del,SP112927,1,,73828
9,133588830,133694896,del,SP112927,1,,106066
3,173220124,178742528,del,SP112927,1,,5522404
15,41884673,43386953,del,SP112927,1,,1502280
10,46571122,48501806,dup,SP112927,1,,1930684
14,105243024,106248982,dup,SP112927,1,,1005958
17,1400691,1789659,del,SP112927,1,,388968
9,138811420,141213431,dup,SP112927,1,,2402011
10,64309875,64801869,del,SP112927,1,,491994
12,54150929,54329668,del,SP112927,1,,178739
1,11168194,11300505,del,SP112927,1,,132311
11,1,2489186,dup,SP112927,1,,2489185
1,77396450,79539707,del,SP112927,1,,2143257
2,206312308,210525722,dup,SP112927,1,,4213414
X,1,2693433,dup,SP112927,1,,2693432
22,28908663,31732801,del,SP112927,1,,2824138
14,76121216,77158477,del,SP112927,1,,1037261
1,105558150,107987248,del,SP112927,1,,2429098
19,3018843,4106515,dup,SP112927,1,,1087672
10,134517471,135171787,dup,SP112927,1,,654316
10,60486925,62567932,del,SP112927,1,,2081007
5,63205635,64551666,del,SP112927,1,,1346031
2,112953182,113284422,del,SP112927,1,,331240
11,2720642,2959113,dup,SP112927,1,,238471
2,229686613,231393055,del,SP112927,1,,1706442
11,67372567,67809655,dup,SP112927,1,,437088
5,1082270,1298756,dup,SP112927,1,,216486
1,1043498,3040296,dup,SP112927,1,,1996798
8,93270478,96735068,del,SP112927,1,,3464590
17,1244575,1354464,del,SP112927,1,,109889
8,18036538,24414387,del,SP112927,1,,6377849
20,60782718,62344800,dup,SP112927,1,,1562082
11,69449054,69474676,dup,SP112927,1,,25622
10,88524612,92129911,del,SP112927,1,,3605299
19,12732212,13278671,dup,SP112927,1,,546459
4,1834550,1967347,del,SP112927,1,,132797
1,17975237,18051374,dup,SP112927,1,,76137
8,144285572,144715661,dup,SP112927,1,,430089
21,46779962,46987215,dup,SP112927,1,,207253
12,58113071,58161990,dup,SP112927,1,,48919
19,40685121,40793476,dup,SP112927,1,,108355
16,89394507,89877620,del,SP112927,1,,483113
19,288713,2471526,dup,SP112927,1,,2182813
12,132618393,133185790,dup,SP112927,1,,567397
9,138022872,138811420,del,SP112927,1,,788548
19,42742450,42934627,dup,SP112927,1,,192177
17,78928921,81195210,dup,SP112927,1,,2266289
9,21974073,22003234,dup,SP112927,1,,29161
7,914355,2705983,dup,SP112927,1,,1791628
15,24512053,24931690,dup,SP112927,1,,419637
6,18333905,18880603,del,SP112929,1,,546698
19,18782519,19587972,del,SP112929,1,,805453
5,53201383,68277887,del,SP112929,1,,15076504
14,64985686,82004594,del,SP112929,1,,17018908
10,33052708,37125159,del,SP112929,1,,4072451
6,90269527,90739425,del,SP112929,1,,469898
6,151193596,152418360,del,SP112929,1,,1224764
10,88161677,90429153,del,SP112929,1,,2267476
6,44289026,46763452,del,SP112929,1,,2474426
13,76061480,85902688,del,SP112929,1,,9841208
4,97720427,98176546,del,SP112929,1,,456119
17,48533793,48719646,dup,SP112929,1,,185853
5,140670858,143248825,del,SP112929,1,,2577967
15,46811339,51613662,del,SP112929,1,,4802323
17,55281700,57110668,del,SP112929,1,,1828968
15,44020453,46009726,del,SP112929,1,,1989273
11,67298739,67375404,del,SP112929,1,,76665
12,10146971,18352586,del,SP112929,1,,8205615
17,46607538,46686798,dup,SP112929,1,,79260
19,40695062,40733533,dup,SP112929,1,,38471
13,32928640,75614299,del,SP112929,1,,42685659
22,24343908,24392203,del,SP112929,1,,48295
X,1,2693433,dup,SP112929,1,,2693432
5,82056330,138712982,del,SP112929,1,,56656652
3,11479594,11785718,del,SP112929,1,,306124
16,31952510,33850115,del,SP112929,1,,1897605
15,51687561,58146430,del,SP112929,1,,6458869
12,58113236,58156753,dup,SP112929,1,,43517
11,69414569,69442840,del,SP112929,1,,28271
6,89835847,90106129,del,SP112929,1,,270282
6,147837448,150215175,del,SP112929,1,,2377727
3,196199099,197612557,del,SP112929,1,,1413458
16,2237847,2338272,dup,SP112929,1,,100425
5,79152282,80931592,del,SP112929,1,,1779310
19,10274516,10412067,del,SP112929,1,,137551
8,17897770,38235704,del,SP112929,1,,20337934
21,39836031,42829594,del,SP112929,1,,2993563
3,93517443,176836388,dup,SP112931,1,,83318945
11,69383268,69446574,del,SP112931,1,,63306
7,103794316,104819569,dup,SP112931,1,,1025253
19,1,2471526,dup,SP112931,1,,2471525
11,1,895980,dup,SP112931,1,,895979
12,60940676,103869334,dup,SP112931,1,,42928658
15,36017575,38312039,dup,SP112931,1,,2294464
17,78848189,81195210,dup,SP112931,1,,2347021
8,46896972,47457515,dup,SP112931,1,,560543
12,51177959,53632996,dup,SP112931,1,,2455037
10,71209955,72540977,dup,SP112931,1,,1331022
19,51850679,59128983,dup,SP112931,1,,7278304
20,1,26309255,dup,SP112931,1,,26309254
8,128791469,135605710,dup,SP112931,1,,6814241
12,1359370,13685434,dup,SP112931,1,,12326064
7,61064518,62485340,dup,SP112931,1,,1420822
12,19366579,25059965,dup,SP112931,1,,5693386
22,24333003,24403467,dup,SP112931,1,,70464
X,153253325,153558373,del,SP112931,1,,305048
8,6260200,7004147,dup,SP112931,1,,743947
12,33240336,35800000,dup,SP112931,1,,2559664
12,55220507,58025531,dup,SP112931,1,,2805024
9,139392008,140424060,dup,SP112931,1,,1032052
4,142442234,143820236,dup,SP112931,1,,1378002
11,67277061,67372567,del,SP112931,1,,95506
16,1,2588221,dup,SP112931,1,,2588220
8,143290718,146364022,dup,SP112931,1,,3073304
12,27485529,31181350,dup,SP112931,1,,3695821
8,109469329,110924549,dup,SP112931,1,,1455220
2,203813432,204841371,del,SP112931,1,,1027939
9,21967789,39184065,dup,SP112931,1,,17216276
9,133603743,133679414,del,SP112931,1,,75671
19,27754573,28712005,dup,SP112931,1,,957432
12,105795536,108048371,dup,SP112931,1,,2252835
4,1,42521712,dup,SP112931,1,,42521711
5,45749867,46401271,dup,SP112931,1,,651404
19,18179319,24544320,dup,SP112931,1,,6365001
1,9611225,11273617,del,SP112931,1,,1662392
12,126144109,128558422,dup,SP112931,1,,2414313
3,72856165,91000000,dup,SP112931,1,,18143835
7,1,58025423,dup,SP112931,1,,58025422
8,113817363,121812575,dup,SP112931,1,,7995212
12,39648880,48588213,dup,SP112931,1,,8939333
16,89409914,90354753,del,SP112931,1,,944839
20,29519156,63025520,dup,SP112931,1,,33506364
17,40469766,44814741,del,SP112931,1,,4344975
12,37902988,38700940,dup,SP112931,1,,797952
8,113018081,113601212,dup,SP112931,1,,583131
X,1,2693433,dup,SP112931,1,,2693432
13,37815570,49489780,del,SP112931,1,,11674210
15,22752399,27532836,dup,SP112931,1,,4780437
11,119084892,119163596,del,SP112931,1,,78704
7,22509461,22884181,del,SP112933,1,,374720
4,2012223,3499037,dup,SP112933,1,,1486814
6,167862365,168360055,del,SP112933,1,,497690
4,1,1721321,dup,SP112933,1,,1721320
20,1,774521,del,SP112933,1,,774520
22,25193441,35849777,dup,SP112933,1,,10656336
6,131020146,132282699,dup,SP112933,1,,1262553
8,8094763,37366193,del,SP112933,1,,29271430
18,61059238,78077248,del,SP112933,1,,17018010
6,19014000,19797962,del,SP112933,1,,783962
6,169326607,171115067,del,SP112933,1,,1788460
3,121433939,123002770,del,SP112933,1,,1568831
3,73044963,74743832,del,SP112933,1,,1698869
9,8472739,8514745,del,SP112933,1,,42006
8,39390007,42080251,dup,SP112933,1,,2690244
6,146731503,147744766,del,SP112933,1,,1013263
22,43028890,44810195,dup,SP112933,1,,1781305
22,45857371,50185709,dup,SP112933,1,,4328338
16,46461309,90354753,del,SP112933,1,,43893444
6,163687883,166349616,del,SP112933,1,,2661733
6,159462930,160109501,del,SP112933,1,,646571
8,37366193,39231745,dup,SP112933,1,,1865552
12,68483813,69264587,dup,SP112933,1,,780774
9,37005275,37388566,del,SP112933,1,,383291
17,1,803718,del,SP112933,1,,803717
8,128796825,143244673,dup,SP112933,1,,14447848
6,806786,1487351,del,SP112933,1,,680565
8,42080251,42635275,del,SP112933,1,,555024
8,1,7004147,del,SP112933,1,,7004146
12,1,35800000,del,SP112933,1,,35799999
X,1,2623790,dup,SP112933,1,,2623789
22,24343908,24397683,dup,SP112933,1,,53775
18,57499124,60891240,del,SP112933,1,,3392116
6,81049269,123769868,del,SP112933,1,,42720599
16,31952510,35271725,del,SP112933,1,,3319215
6,128949839,129302633,del,SP112933,1,,352794
22,38094460,42201310,dup,SP112933,1,,4106850
8,94011986,128746731,dup,SP112933,1,,34734745
17,6710078,7875632,del,SP112933,1,,1165554
3,79106369,79619678,del,SP112933,1,,513309
12,90358150,93050950,del,SP112933,1,,2692800
19,3097665,4129017,dup,SP112935,1,,1031352
16,75307996,88712106,del,SP112935,1,,13404110
11,69447626,69472151,dup,SP112935,1,,24525
1,11868205,12051788,del,SP112935,1,,183583
16,1,2338272,dup,SP112935,1,,2338271
1,859884,1366060,dup,SP112935,1,,506176
9,139987666,140355056,dup,SP112935,1,,367390
9,99054599,101548656,del,SP112935,1,,2494057
8,8094763,42817386,del,SP112935,1,,34722623
11,107965230,108486174,del,SP112935,1,,520944
13,35820031,85230320,del,SP112935,1,,49410289
16,68036151,75228089,del,SP112935,1,,7191938
16,89877620,90018820,dup,SP112935,1,,141200
11,1,1466364,dup,SP112935,1,,1466363
19,40695062,40793476,dup,SP112935,1,,98414
17,46609386,46716396,dup,SP112935,1,,107010
11,67298739,67375404,del,SP112935,1,,76665
9,70984372,71283769,del,SP112935,1,,299397
17,1218621,1354464,del,SP112935,1,,135843
7,123776,1130572,dup,SP112935,1,,1006796
2,242477232,243199373,dup,SP112935,1,,722141
11,2751474,2930641,dup,SP112935,1,,179167
18,77144786,77648321,dup,SP112935,1,,503535
17,78682525,78765022,del,SP112935,1,,82497
19,10237724,10304672,del,SP112935,1,,66948
12,58113365,58156753,dup,SP112935,1,,43388
19,42741407,42924151,dup,SP112935,1,,182744
21,39887757,42879785,del,SP112935,1,,2992028
11,69414569,69447626,del,SP112935,1,,33057
X,1,2693433,dup,SP112935,1,,2693432
19,288713,2368871,dup,SP112935,1,,2080158
1,3723476,3810009,del,SP112935,1,,86533
11,66571116,67298739,dup,SP112935,1,,727623
2,202828228,203328963,del,SP112935,1,,500735
10,15218644,15519970,del,SP112935,1,,301326
8,430412,7004147,del,SP112935,1,,6573735
21,46779962,47129690,dup,SP112935,1,,349728
9,134006524,134123154,del,SP112935,1,,116630
3,70255451,72839348,del,SP112935,1,,2583897
22,24343908,24400522,dup,SP112935,1,,56614
16,88944362,89374044,dup,SP112935,1,,429682
9,21965970,22004999,dup,SP112937,1,,39029
19,12697399,13124815,dup,SP112937,1,,427416
11,2706138,2940788,dup,SP112937,1,,234650
2,134623414,136046020,del,SP112937,1,,1422606
2,141739918,141992164,del,SP112937,1,,252246
11,69446756,69473986,dup,SP112937,1,,27230
17,37852664,37937149,dup,SP112937,1,,84485
17,1244575,1354464,del,SP112937,1,,109889
13,66461086,77357627,del,SP112937,1,,10896541
13,37569236,66197233,del,SP112937,1,,28627997
16,89383834,89609118,del,SP112937,1,,225284
1,2097466,3168892,dup,SP112937,1,,1071426
13,80781190,81136327,del,SP112937,1,,355137
1,189279278,190777695,dup,SP112937,1,,1498417
17,48616977,48719917,dup,SP112937,1,,102940
17,78928921,81195210,dup,SP112937,1,,2266289
16,6064807,6229466,dup,SP112937,1,,164659
4,605598,1015762,dup,SP112937,1,,410164
19,3018843,4112985,dup,SP112937,1,,1094142
5,45946295,46401271,del,SP112937,1,,454976
10,134517471,135534747,dup,SP112937,1,,1017276
1,144009053,145267073,dup,SP112937,1,,1258020
8,143370123,143631476,dup,SP112937,1,,261353
X,1,2693433,dup,SP112937,1,,2693432
11,67298739,67372567,del,SP112937,1,,73828
6,66294203,100861456,del,SP112937,1,,34567253
7,151850,587561,dup,SP112937,1,,435711
16,1604045,1978692,del,SP112937,1,,374647
19,40685121,40733533,dup,SP112937,1,,48412
21,46779962,46963419,dup,SP112937,1,,183457
19,33682658,33799173,dup,SP112937,1,,116515
6,116049251,116881677,del,SP112937,1,,832426
8,145029764,145779413,dup,SP112937,1,,749649
4,34823600,35526632,dup,SP112937,1,,703032
9,139970639,140371343,dup,SP112937,1,,400704
12,34566769,35800000,del,SP112937,1,,1233231
4,136142433,137523276,dup,SP112937,1,,1380843
7,932668,1796621,dup,SP112937,1,,863953
6,104849740,114701303,del,SP112937,1,,9851563
19,288713,2390058,dup,SP112937,1,,2101345
1,3723476,3810009,del,SP112937,1,,86533
2,138104004,139020554,del,SP112937,1,,916550
17,36703262,36909618,dup,SP112937,1,,206356
17,46621181,46871488,dup,SP112937,1,,250307
19,42741407,42924151,dup,SP112937,1,,182744
17,6893130,7330808,dup,SP112937,1,,437678
14,22526247,22822028,dup,SP112937,1,,295781
1,188075031,188704685,dup,SP112937,1,,629654
16,88546161,89383834,dup,SP112937,1,,837673
4,64940046,65472318,dup,SP112937,1,,532272
10,116723619,117469157,dup,SP112937,1,,745538
16,1978692,2354489,dup,SP112937,1,,375797
2,133453959,133792208,del,SP112937,1,,338249
X,153320862,153555088,del,SP112937,1,,234226
19,39019263,39259060,del,SP112937,1,,239797
16,1,1604045,dup,SP112937,1,,1604044
1,1,1475929,dup,SP112937,1,,1475928
18,77144786,77709942,dup,SP112937,1,,565156
12,84278672,85572136,dup,SP112937,1,,1293464
19,10237724,10299904,del,SP112937,1,,62180
11,1,1561344,dup,SP112937,1,,1561343
12,132572234,133185790,dup,SP112937,1,,613556
12,58114544,58153435,dup,SP112937,1,,38891
2,143184205,143513740,del,SP112937,1,,329535
11,69414263,69446756,del,SP112937,1,,32493
22,24337410,24392203,del,SP112937,1,,54793
3,10174194,10227133,dup,SP112937,1,,52939
19,15263435,15368318,dup,SP112939,1,,104883
1,144912259,145398654,dup,SP112939,1,,486395
22,24343908,24392203,del,SP112939,1,,48295
3,49892957,49952392,dup,SP112939,1,,59435
12,58111654,58159517,dup,SP112939,1,,47863
14,106189463,106300146,del,SP112939,1,,110683
11,69399532,69446088,del,SP112939,1,,46556
X,1,2623790,dup,SP112939,1,,2623789
17,46626328,46716396,dup,SP112939,1,,90068
7,55036431,55095143,dup,SP112939,1,,58712
17,48682017,48720903,dup,SP112939,1,,38886
14,22418309,23005763,dup,SP112939,1,,587454
17,1218621,1357392,del,SP112939,1,,138771
19,40695062,40789514,dup,SP112939,1,,94452
19,12732212,13124815,dup,SP112939,1,,392603
10,43556629,43618053,dup,SP112939,1,,61424
1,3743466,3810009,del,SP112939,1,,66543
1,156040614,156079030,dup,SP112939,1,,38416
17,1330473,1400691,del,SP112941,1,,70218
19,38775195,39138242,dup,SP112941,1,,363047
19,1228731,1320068,del,SP112941,1,,91337
X,2263285,2693433,dup,SP112941,1,,430148
7,73697417,74015760,dup,SP112941,1,,318343
22,46660147,47014302,dup,SP112941,1,,354155
14,106559789,106816366,dup,SP112941,1,,256577
9,139392008,140138576,del,SP112941,1,,746568
16,1,1327862,del,SP112941,1,,1327861
19,10344463,11557440,dup,SP112941,1,,1212977
11,69450535,69472151,del,SP112941,1,,21616
1,3587071,3695429,del,SP112941,1,,108358
10,46571122,48315690,dup,SP112941,1,,1744568
3,10179486,10229183,dup,SP112941,1,,49697
1,1,1520375,del,SP112941,1,,1520374
1,3695429,3810009,dup,SP112941,1,,114580
19,17840207,18253662,dup,SP112941,1,,413455
3,49887832,49977567,dup,SP112941,1,,89735
14,105841795,106175158,del,SP112941,1,,333363
11,69472151,69519699,dup,SP112941,1,,47548
1,2199124,2531221,del,SP112941,1,,332097
9,21975767,22000206,dup,SP112941,1,,24439
7,157446876,158058461,dup,SP112941,1,,611585
22,38560752,38771050,dup,SP112941,1,,210298
22,19880600,19948477,dup,SP112941,1,,67877
17,78769048,78850131,dup,SP112941,1,,81083
16,88368747,89067085,del,SP112941,1,,698338
17,992042,1330473,dup,SP112941,1,,338431
X,1,2263285,dup,SP112941,1,,2263284
19,45336105,45823504,dup,SP112941,1,,487399
22,46136937,46660147,del,SP112941,1,,523210
9,132179054,132560718,dup,SP112941,1,,381664
19,2523645,3423186,dup,SP112941,1,,899541
19,40743817,40779422,dup,SP112941,1,,35605
3,167011058,168406833,del,SP112921,1,,1395775
5,99409947,128776804,del,SP112921,1,,29366857
3,147881042,148453991,del,SP112921,1,,572949
5,43086097,46401271,del,SP112921,1,,3315174
8,109110878,111854841,del,SP112921,1,,2743963
13,62686794,84644058,del,SP112921,1,,21957264
7,1,914355,dup,SP112921,1,,914354
4,124274135,129584061,del,SP112921,1,,5309926
19,40743817,40793476,dup,SP112921,1,,49659
4,13818526,14664772,del,SP112921,1,,846246
11,103409013,103812822,del,SP112921,1,,403809
3,95816151,98019743,del,SP112921,1,,2203592
1,194112048,194490700,del,SP112921,1,,378652
14,106461134,106816366,dup,SP112921,1,,355232
1,3394128,3649688,del,SP112921,1,,255560
5,98214845,99409947,del,SP112921,1,,1195102
X,1,2263285,dup,SP112921,1,,2263284
7,61064518,108031850,dup,SP112921,1,,46967332
4,133249308,134227289,dup,SP112921,1,,977981
6,64440668,126766185,del,SP112921,1,,62325517
Y,2660163,6309827,del,SP112921,1,,3649664
9,139392008,139635934,del,SP112921,1,,243926
5,50243439,52089358,del,SP112921,1,,1845919
2,35636783,43811449,del,SP112921,1,,8174666
16,122147,1314398,del,SP112921,1,,1192251
3,105506817,115160561,del,SP112921,1,,9653744
9,9150814,19104294,del,SP112921,1,,9953480
4,130292005,130846225,del,SP112921,1,,554220
18,27967548,28644295,del,SP112921,1,,676747
5,90079981,98214845,del,SP112921,1,,8134864
7,1119048,58025423,dup,SP112921,1,,56906375
7,111499385,159138663,dup,SP112921,1,,47639278
4,131762947,133249308,del,SP112921,1,,1486361
3,98230157,99314964,del,SP112921,1,,1084807
10,43467176,43597246,dup,SP112921,1,,130070
1,157540889,158669507,del,SP112921,1,,1128618
2,213027536,213494099,dup,SP112921,1,,466563
3,119123501,119593933,del,SP112921,1,,470432
10,110483077,111448981,del,SP112921,1,,965904
4,155396587,155839661,dup,SP112921,1,,443074
5,12952589,13565907,del,SP112921,1,,613318
1,238876341,240057641,del,SP112921,1,,1181300
5,19085743,23344209,del,SP112921,1,,4258466
19,1228731,1320068,del,SP112921,1,,91337
2,46191351,54045018,del,SP112921,1,,7853667
1,2227768,2560465,del,SP112921,1,,332697
2,99049975,99067419,dup,SP112923,1,,17444
12,58124514,58135453,dup,SP112923,1,,10939
5,3273061,3400675,dup,SP112923,1,,127614
1,40361831,40383493,dup,SP112923,1,,21662
22,26332947,26350018,dup,SP112923,1,,17071
5,52773817,52783382,dup,SP112923,1,,9565
5,37828574,37843825,dup,SP112923,1,,15251
17,28538623,28563898,dup,SP112923,1,,25275
16,79621593,79642808,dup,SP112923,1,,21215
1,166991545,167058113,dup,SP112923,1,,66568
3,54142129,54166847,dup,SP112923,1,,24718
7,151209582,151228959,dup,SP112923,1,,19377
2,30018601,30032077,dup,SP112923,1,,13476
2,5826603,5844039,dup,SP112923,1,,17436
10,101593318,101604950,dup,SP112923,1,,11632
1,58200189,58213312,dup,SP112923,1,,13123
2,88462940,88520116,dup,SP112923,1,,57176
20,23004592,23026954,dup,SP112923,1,,22362
2,21116795,21205873,dup,SP112923,1,,89078
18,67553956,67567418,dup,SP112923,1,,13462
12,54326593,54341653,dup,SP112923,1,,15060
7,45952401,45963270,dup,SP112923,1,,10869
17,7559985,7582177,del,SP112923,1,,22192
3,193987360,194073826,dup,SP112923,1,,86466
5,38849098,38873889,dup,SP112923,1,,24791
5,9538671,9553185,dup,SP112923,1,,14514
14,35866429,35880699,dup,SP112923,1,,14270
6,160111233,160119067,dup,SP112923,1,,7834
13,114261376,114916266,dup,SP112923,1,,654890
1,169060202,169081078,dup,SP112923,1,,20876
9,117826105,117837246,dup,SP112923,1,,11141
9,133439059,133689820,del,SP112925,1,,250761
X,153324163,153558373,del,SP112925,1,,234210
4,1849227,1967347,del,SP112925,1,,118120
19,10274516,10367827,del,SP112925,1,,93311
11,67298739,67372567,del,SP112925,1,,73828
10,45204942,45779526,dup,SP112925,1,,574584
16,61182060,82605871,del,SP112925,1,,21423811
12,12826191,13089074,del,SP112925,1,,262883
12,16031614,18310017,del,SP112925,1,,2278403
14,106601637,106827209,dup,SP112925,1,,225572
X,1,2693433,dup,SP112925,1,,2693432
11,69420774,69442840,del,SP112925,1,,22066
11,76128526,76255787,del,SP112907,1,,127261
9,97203503,98039396,dup,SP112907,1,,835893
15,27532836,28734991,del,SP112907,1,,1202155
12,1,35800000,dup,SP112907,1,,35799999
4,5749192,7776438,dup,SP112907,1,,2027246
11,69456922,69482917,dup,SP112907,1,,25995
6,80847304,101122870,del,SP112907,1,,20275566
8,32601442,33350144,del,SP112907,1,,748702
8,109182917,113620435,dup,SP112907,1,,4437518
6,28915387,29594080,del,SP112907,1,,678693
11,119074793,119168565,del,SP112907,1,,93772
12,56442968,57916783,dup,SP112907,1,,1473815
9,98068851,99025809,del,SP112907,1,,956958
19,27754573,29119214,dup,SP112907,1,,1364641
4,115369499,120849347,del,SP112907,1,,5479848
8,36121772,38219247,del,SP112907,1,,2097475
13,74825894,81176675,del,SP112907,1,,6350781
11,67277061,67372567,del,SP112907,1,,95506
8,20042461,21723292,del,SP112907,1,,1680831
2,140987915,141124667,del,SP112907,1,,136752
4,106126705,107202718,del,SP112907,1,,1076013
8,46896972,47408734,dup,SP112907,1,,511762
8,6428224,7004147,dup,SP112907,1,,575923
1,164876737,199867126,del,SP112907,1,,34990389
12,85029894,86716733,dup,SP112907,1,,1686839
6,26265923,28023248,del,SP112907,1,,1757325
18,29558743,31240888,del,SP112907,1,,1682145
10,116494213,117911958,dup,SP112907,1,,1417745
10,100232511,111556787,del,SP112907,1,,11324276
19,51974514,54473328,dup,SP112907,1,,2498814
3,72863832,79480452,dup,SP112907,1,,6616620
X,1,2693433,dup,SP112907,1,,2693432
17,7371004,8852320,del,SP112907,1,,1481316
8,13868740,15049152,del,SP112907,1,,1180412
3,104100929,139204940,dup,SP112907,1,,35104011
2,38244592,44556299,del,SP112907,1,,6311707
X,154923128,155270560,dup,SP112907,1,,347432
20,13549545,14551205,dup,SP112907,1,,1001660
3,142212461,162089560,dup,SP112907,1,,19877099
19,20057974,24544320,dup,SP112907,1,,4486346
3,93517443,100605294,dup,SP112907,1,,7087851
4,165672628,166442904,del,SP112907,1,,770276
3,163218347,198022430,dup,SP112907,1,,34804083
3,82964355,91000000,dup,SP112907,1,,8035645
11,69416756,69456922,del,SP112907,1,,40166
4,91235293,94707512,del,SP112907,1,,3472219
13,33224299,52321513,del,SP112907,1,,19097214
1,155053191,162396136,del,SP112907,1,,7342945
6,101338817,105564249,del,SP112907,1,,4225432
8,23540514,27727139,del,SP112907,1,,4186625
19,40787621,49370150,del,SP112907,1,,8582529
15,22752399,27532836,dup,SP112907,1,,4780437
4,109595700,110387381,del,SP112907,1,,791681
7,150147287,150598993,del,SP112907,1,,451706
14,71597238,84301768,del,SP112907,1,,12704530
X,153325623,153578396,del,SP112907,1,,252773
14,22489315,23053443,dup,SP112907,1,,564128
15,75667741,76327887,del,SP112907,1,,660146
8,12588373,13032145,del,SP112907,1,,443772
7,108283625,120358700,del,SP112907,1,,12075075
4,120849347,121688225,dup,SP112907,1,,838878
4,26726648,42521712,dup,SP112907,1,,15795064
22,24333003,24403467,dup,SP112907,1,,70464
11,69482917,69519699,del,SP112907,1,,36782
19,36931784,38356925,dup,SP112907,1,,1425141
1,94168209,96707924,del,SP112907,1,,2539715
9,70984372,75040075,dup,SP112907,1,,4055703
19,1,7437613,dup,SP112907,1,,7437612
19,39415899,40674539,del,SP112907,1,,1258640
8,113652863,146364022,dup,SP112907,1,,32711159
17,40473790,41271243,del,SP112909,1,,797453
8,18465318,22398603,del,SP112909,1,,3933285
16,2239522,2369105,dup,SP112909,1,,129583
8,8094763,17338210,del,SP112909,1,,9243447
8,3888887,4499388,del,SP112909,1,,610501
17,68791824,70937659,del,SP112909,1,,2145835
5,68504392,68828372,del,SP112909,1,,323980
19,42746278,42838132,dup,SP112909,1,,91854
19,1243566,1606463,dup,SP112909,1,,362897
10,89637066,90679220,del,SP112909,1,,1042154
16,89394507,89872736,del,SP112909,1,,478229
10,106411905,107688459,dup,SP112909,1,,1276554
8,3202894,3434568,del,SP112909,1,,231674
17,71647955,73789345,del,SP112909,1,,2141390
10,116325598,118894742,del,SP112909,1,,2569144
X,1,2693433,dup,SP112909,1,,2693432
11,69418603,69446574,del,SP112909,1,,27971
19,10254176,10462576,del,SP112909,1,,208400
8,2790377,2958392,del,SP112909,1,,168015
8,5100942,6597670,del,SP112909,1,,1496728
8,23344614,30610640,del,SP112909,1,,7266026
11,1,930888,dup,SP112909,1,,930887
19,703981,1218439,dup,SP112909,1,,514458
16,81279464,83431439,del,SP112909,1,,2151975
17,79968846,81195210,dup,SP112909,1,,1226364
17,41282644,44815508,del,SP112909,1,,3532864
7,50574449,53359369,del,SP112911,1,,2784920
22,32666384,33462601,del,SP112911,1,,796217
12,10116293,21679846,del,SP112911,1,,11563553
10,1837953,21785691,del,SP112911,1,,19947738
3,168387405,168692545,del,SP112911,1,,305140
10,22160243,39146676,del,SP112911,1,,16986433
10,116355889,117707001,dup,SP112911,1,,1351112
5,49441966,50214870,dup,SP112911,1,,772904
18,1,15377471,dup,SP112911,1,,15377470
8,42542778,43767534,dup,SP112911,1,,1224756
4,157892455,162636467,del,SP112911,1,,4744012
6,62768371,64068456,del,SP112911,1,,1300085
2,139223140,140216373,del,SP112911,1,,993233
X,1,2693433,dup,SP112911,1,,2693432
1,216065878,241435351,del,SP112911,1,,25369473
8,48786273,49360863,dup,SP112911,1,,574590
2,34610322,35015612,del,SP112911,1,,405290
5,85376419,88488642,del,SP112911,1,,3112223
5,50214870,51204393,del,SP112911,1,,989523
16,33584337,34868574,del,SP112911,1,,1284237
12,38251242,38634152,del,SP112911,1,,382910
22,24397683,32576559,del,SP112911,1,,8178876
20,32321145,35955672,del,SP112911,1,,3634527
6,64933111,114776697,del,SP112911,1,,49843586
20,36099372,51060479,del,SP112911,1,,14961107
5,89528329,107184003,del,SP112911,1,,17655674
3,98006773,167232268,dup,SP112911,1,,69225495
11,87236661,122598821,del,SP112911,1,,35362160
3,167464145,167884209,del,SP112911,1,,420064
8,14545554,16408696,dup,SP112911,1,,1863142
5,154413544,162857041,del,SP112911,1,,8443497
5,151352740,153968030,del,SP112911,1,,2615290
2,42384952,50383651,del,SP112911,1,,7998699
7,1,50574449,dup,SP112911,1,,50574448
8,12724275,13525730,dup,SP112911,1,,801455
1,154518237,155135162,dup,SP112911,1,,616925
2,157708968,158346702,del,SP112911,1,,637734
22,39270489,46647364,del,SP112911,1,,7376875
14,106566869,106816366,dup,SP112911,1,,249497
18,27847913,28240853,del,SP112911,1,,392940
8,116514354,119701776,dup,SP112911,1,,3187422
2,138595712,138917564,del,SP112911,1,,321852
20,1,26309255,dup,SP112911,1,,26309254
10,47005935,47577294,del,SP112911,1,,571359
12,38775967,39885852,del,SP112911,1,,1109885
14,64758751,73359436,del,SP112911,1,,8600685
18,18554307,27847913,dup,SP112911,1,,9293606
22,24343908,24397683,dup,SP112911,1,,53775
6,163016936,165528710,del,SP112911,1,,2511774
11,69273524,70062885,dup,SP112911,1,,789361
2,164003610,164360028,del,SP112911,1,,356418
8,60088638,60526300,dup,SP112911,1,,437662
12,25361029,25494992,del,SP112911,1,,133963
6,135229931,159479844,del,SP112911,1,,24249913
4,17655989,19213846,del,SP112911,1,,1557857
12,104347247,104769461,dup,SP112911,1,,422214
8,11213888,11560275,dup,SP112911,1,,346387
8,47588941,48421341,dup,SP112911,1,,832400
4,168586620,173686762,del,SP112911,1,,5100142
2,137501963,138173223,del,SP112911,1,,671260
13,32332924,82196809,del,SP112911,1,,49863885
1,211341420,215531437,del,SP112911,1,,4190017
22,23744748,24343908,del,SP112911,1,,599160
5,148133966,148608462,dup,SP112911,1,,474496
5,143589509,144597556,del,SP112911,1,,1008047
8,112731520,113254911,dup,SP112911,1,,523391
12,98562016,98960248,dup,SP112911,1,,398232
2,162557870,163043139,del,SP112911,1,,485269
2,158926116,160887655,del,SP112911,1,,1961539
8,127365192,146364022,dup,SP112911,1,,18998830
20,29519156,32239272,del,SP112911,1,,2720116
7,53359369,58025423,dup,SP112911,1,,4666054
19,40795859,41304082,dup,SP112911,1,,508223
3,168692545,198022430,dup,SP112911,1,,29329885
16,34868574,35271725,dup,SP112911,1,,403151
10,42413322,42895685,del,SP112911,1,,482363
15,40232688,40667941,dup,SP112911,1,,435253
8,66558376,110612164,dup,SP112911,1,,44053788
16,50103207,53149800,del,SP112911,1,,3046593
2,50849472,51430313,del,SP112911,1,,580841
7,113475112,113728732,del,SP112911,1,,253620
2,140821619,155499229,del,SP112911,1,,14677610
18,29063742,78077248,dup,SP112911,1,,49013506
2,35908988,41606606,del,SP112911,1,,5697618
20,51060479,63025520,dup,SP112911,1,,11965041
5,1,46401271,dup,SP112911,1,,46401270
12,40015062,40709117,del,SP112911,1,,694055
15,57875377,58930233,dup,SP112911,1,,1054856
7,128590944,159138663,dup,SP112911,1,,30547719
5,83158405,84055532,del,SP112911,1,,897127
7,61064518,113475112,dup,SP112911,1,,52410594
7,113836803,128424824,dup,SP112911,1,,14588021
1,47717950,48327671,dup,SP112911,1,,609721
16,72453414,88354041,del,SP112911,1,,15900627
19,16862114,17143120,dup,SP112911,1,,281006
8,83416508,84226547,dup,SP112913,1,,810039
8,1,7004147,del,SP112913,1,,7004146
8,130255603,131018683,dup,SP112913,1,,763080
18,63425389,78077248,del,SP112913,1,,14651859
17,37647093,45719992,del,SP112913,1,,8072899
8,134346630,140886474,dup,SP112913,1,,6539844
2,147750358,152887988,del,SP112913,1,,5137630
X,1,2693433,dup,SP112913,1,,2693432
X,36674201,38329788,dup,SP112913,1,,1655587
8,89428497,89867317,dup,SP112913,1,,438820
8,127929212,128339113,dup,SP112913,1,,409901
8,118499319,118899247,dup,SP112913,1,,399928
19,32603061,33229707,del,SP112913,1,,626646
8,92102212,93254383,dup,SP112913,1,,1152171
4,10887464,14077137,dup,SP112913,1,,3189673
4,140474904,141079769,dup,SP112913,1,,604865
8,113644038,113840085,dup,SP112913,1,,196047
8,129323141,130255603,dup,SP112913,1,,932462
22,45659575,51304566,del,SP112913,1,,5644991
22,27052072,29700406,del,SP112913,1,,2648334
17,75058049,75550132,del,SP112913,1,,492083
2,191833200,197141483,del,SP112913,1,,5308283
2,235002697,239846164,del,SP112913,1,,4843467
5,128728207,180915260,dup,SP112913,1,,52187053
8,131315805,132826259,dup,SP112913,1,,1510454
8,119109791,120179275,dup,SP112913,1,,1069484
8,113194220,113249187,dup,SP112913,1,,54967
13,33556804,83025754,del,SP112913,1,,49468950
16,70683561,90354753,del,SP112913,1,,19671192
11,113755744,118290246,del,SP112913,1,,4534502
6,1,396938,dup,SP112913,1,,396937
6,85591120,121742887,del,SP112913,1,,36151767
12,7284028,19470863,del,SP112913,1,,12186835
6,137429723,150074413,del,SP112913,1,,12644690
13,30957491,31524403,del,SP112913,1,,566912
6,161763898,161979728,dup,SP112913,1,,215830
5,114986925,128592562,dup,SP112913,1,,13605637
1,220228300,246971488,del,SP112913,1,,26743188
10,1,8356702,del,SP112913,1,,8356701
3,22761770,27836824,del,SP112913,1,,5075054
3,156698488,179046905,dup,SP112913,1,,22348417
3,187466472,196471620,del,SP112913,1,,9005148
11,76099819,76362929,del,SP112913,1,,263110
8,131018683,131315805,dup,SP112913,1,,297122
8,114769974,115299479,dup,SP112913,1,,529505
8,141577810,146364022,dup,SP112913,1,,4786212
2,221484843,224571984,del,SP112913,1,,3087141
8,93254383,99322750,dup,SP112913,1,,6068367
8,128339113,129323141,dup,SP112913,1,,984028
21,39876718,42867981,del,SP112913,1,,2991263
8,8094763,26590685,del,SP112913,1,,18495922
8,77744592,83416508,dup,SP112913,1,,5671916
6,162399459,163205437,dup,SP112913,1,,805978
8,115299479,118499319,dup,SP112913,1,,3199840
20,49964321,63025520,dup,SP112913,1,,13061199
8,118899247,119109791,dup,SP112913,1,,210544
9,100517739,106751434,dup,SP112913,1,,6233695
8,89867317,92102212,dup,SP112913,1,,2234895
8,132826259,134346630,dup,SP112913,1,,1520371
17,75550132,76054589,del,SP112913,1,,504457
5,25603666,37480624,del,SP112913,1,,11876958
8,102189527,113194220,dup,SP112913,1,,11004693
16,1,23337973,dup,SP112913,1,,23337972
X,19968306,20545359,dup,SP112913,1,,577053
8,84226547,89428497,dup,SP112913,1,,5201950
8,140886474,141315209,dup,SP112913,1,,428735
21,44575335,48129895,del,SP112913,1,,3554560
2,240059277,240460013,dup,SP112913,1,,400736
2,171091023,180052387,del,SP112913,1,,8961364
11,119093723,119177168,del,SP112913,1,,83445
2,217527933,219275319,del,SP112913,1,,1747386
8,113840085,114769974,dup,SP112913,1,,929889
13,31524403,33107920,del,SP112913,1,,1583517
8,120179275,127929212,dup,SP112913,1,,7749937
8,113249187,113644038,dup,SP112913,1,,394851
16,34468168,34777669,dup,SP112915,1,,309501
10,112960685,114134689,del,SP112915,1,,1174004
13,67167101,70418506,del,SP112915,1,,3251405
14,106524357,106632517,dup,SP112915,1,,108160
13,51015576,51701992,del,SP112915,1,,686416
10,88528628,90620135,del,SP112915,1,,2091507
12,15111779,17313083,del,SP112915,1,,2201304
2,232817929,233728263,del,SP112915,1,,910334
10,46571122,48315690,dup,SP112915,1,,1744568
12,11874938,12842147,del,SP112915,1,,967209
12,1374231,1594490,del,SP112915,1,,220259
12,347692,466909,del,SP112915,1,,119217
9,21975053,22003234,dup,SP112915,1,,28181
10,84567157,87434870,del,SP112915,1,,2867713
12,31675745,32154443,del,SP112915,1,,478698
12,21948191,25388485,del,SP112915,1,,3440294
X,1,2554556,dup,SP112915,1,,2554555
3,77235422,78076683,del,SP112915,1,,841261
3,76137245,76658630,del,SP112915,1,,521385
17,42460798,43271633,del,SP112915,1,,810835
12,9245544,11794472,del,SP112915,1,,2548928
16,89418913,89551509,del,SP112915,1,,132596
16,85012933,85947028,del,SP112915,1,,934095
12,13180130,14405084,del,SP112915,1,,1224954
16,1,388734,del,SP112917,1,,388733
3,71486858,83189480,del,SP112917,1,,11702622
8,4860707,7004147,del,SP112917,1,,2143440
7,151850,1122793,dup,SP112917,1,,970943
8,8094763,38269179,del,SP112917,1,,30174416
1,1,3040296,dup,SP112917,1,,3040295
11,69475291,69511002,del,SP112917,1,,35711
8,1,2866949,del,SP112917,1,,2866948
X,153324163,153562526,del,SP112917,1,,238363
17,1230508,1354464,del,SP112917,1,,123956
16,2038317,2588221,dup,SP112917,1,,549904
16,89380549,89515314,del,SP112917,1,,134765
19,10231505,10387007,del,SP112917,1,,155502
20,60782718,62344800,dup,SP112917,1,,1562082
3,193467656,196670052,del,SP112917,1,,3202396
4,1765161,1834550,dup,SP112917,1,,69389
19,50352131,50401343,dup,SP112917,1,,49212
8,38437319,39370572,del,SP112917,1,,933253
11,69399532,69453655,del,SP112917,1,,54123
17,37731338,37921844,dup,SP112917,1,,190506
12,132635028,133199945,dup,SP112917,1,,564917
8,3213190,4498266,del,SP112917,1,,1285076
19,3018843,4066666,dup,SP112917,1,,1047823
11,2720642,2959113,dup,SP112917,1,,238471
11,2959113,3106977,del,SP112917,1,,147864
1,3723476,3817541,del,SP112917,1,,94065
9,138839166,140424060,dup,SP112917,1,,1584894
21,46703017,46963419,dup,SP112917,1,,260402
11,1,2489186,dup,SP112917,1,,2489185
16,70165330,82381459,del,SP112917,1,,12216129
11,46432980,47849594,del,SP112917,1,,1416614
1,184672536,228406448,dup,SP112917,1,,43733912
X,1,2693433,dup,SP112917,1,,2693432
1,11858250,12051788,del,SP112917,1,,193538
4,1834550,1963169,del,SP112917,1,,128619
16,388734,1587082,dup,SP112917,1,,1198348
13,48894573,61142759,del,SP112917,1,,12248186
6,84721209,86322453,del,SP112917,1,,1601244
5,32095779,32179180,dup,SP112917,1,,83401
13,35690237,48873033,del,SP112917,1,,13182796
16,68159839,69936969,del,SP112917,1,,1777130
3,83189480,91000000,dup,SP112917,1,,7810520
10,43550872,43768688,dup,SP112917,1,,217816
11,67298739,67376865,del,SP112917,1,,78126
19,4435929,5164520,dup,SP112917,1,,728591
17,78915889,80211192,dup,SP112917,1,,1295303
3,196766492,198022430,del,SP112917,1,,1255938
8,48631166,146364022,dup,SP112917,1,,97732856
11,69453655,69475291,dup,SP112917,1,,21636
17,48601144,48716608,dup,SP112917,1,,115464
12,58112587,58161990,dup,SP112917,1,,49403
19,854713,2368871,dup,SP112917,1,,1514158
1,228453339,237450052,dup,SP112917,1,,8996713
21,39876718,42625361,del,SP112917,1,,2748643
14,104549166,106248982,dup,SP112917,1,,1699816
16,88354041,89380549,dup,SP112917,1,,1026508
1,3262989,3723476,dup,SP112917,1,,460487
3,93517443,172440418,dup,SP112917,1,,78922975
3,172440418,190810590,del,SP112917,1,,18370172
8,41011194,43767534,del,SP112917,1,,2756340
7,143321680,143974409,dup,SP112917,1,,652729
8,46896972,48348190,dup,SP112917,1,,1451218
1,238486112,249250621,dup,SP112917,1,,10764509
5,1012204,1289704,dup,SP112917,1,,277500
22,19812350,19916591,del,SP112917,1,,104241
10,95581880,97974922,del,SP112919,1,,2393042
6,66294203,66882706,del,SP112919,1,,588503
14,106534342,106784498,del,SP112919,1,,250156
21,18431189,25385284,del,SP112919,1,,6954095
18,54882517,55544592,del,SP112919,1,,662075
19,58143915,59128983,del,SP112919,1,,985068
7,128869074,134899638,del,SP112919,1,,6030564
18,23685947,28210728,del,SP112919,1,,4524781
1,144937900,145398654,dup,SP112919,1,,460754
6,87234658,89195593,del,SP112919,1,,1960935
6,82145014,83304797,del,SP112919,1,,1159783
19,6766444,7285759,del,SP112919,1,,519315
10,88524612,89450417,del,SP112919,1,,925805
7,87870419,100730842,del,SP112919,1,,12860423
10,85659056,87450359,del,SP112919,1,,1791303
3,125173744,125763574,del,SP112919,1,,589830
20,14781326,14832941,del,SP112919,1,,51615
6,99868549,100500752,del,SP112919,1,,632203
12,125033464,125418285,dup,SP112919,1,,384821
1,56904731,59231380,del,SP112919,1,,2326649
18,50558496,50687635,del,SP112919,1,,129139
17,7563665,7605717,del,SP112919,1,,42052
2,16071164,16089760,dup,SP112919,1,,18596
8,28763435,29181444,del,SP112919,1,,418009
6,95885338,98846938,del,SP112919,1,,2961600
X,1,2693433,dup,SP112919,1,,2693432
18,60397622,60592319,del,SP112919,1,,194697
6,91073891,91339360,del,SP112919,1,,265469
6,69410914,69811502,del,SP112919,1,,400588
19,47594770,48170561,del,SP112919,1,,575791
14,84076499,86426489,del,SP112919,1,,2349990
1,59260985,60055253,del,SP112919,1,,794268
21,39903822,45115921,del,SP112919,1,,5212099
7,101520238,128700320,del,SP112919,1,,27180082
18,33181197,33919558,del,SP112919,1,,738361
9,21985897,22004411,dup,SP112919,1,,18514
6,70485517,77930690,del,SP112919,1,,7445173
10,89637066,90550313,del,SP112919,1,,913247
10,82975995,83403155,del,SP112919,1,,427160
1,144009053,145085874,del,SP112899,1,,1076821
20,14818433,14947995,del,SP112899,1,,129562
X,1,2693433,dup,SP112899,1,,2693432
5,32101274,32169053,dup,SP112899,1,,67779
14,105976659,106199622,dup,SP112899,1,,222963
11,2099313,2869991,del,SP112901,1,,770678
16,88727229,89067085,del,SP112901,1,,339856
19,45336105,45579302,dup,SP112901,1,,243197
22,19833507,19924804,dup,SP112901,1,,91297
1,227217071,249250621,del,SP112901,1,,22033550
10,46571122,47124743,dup,SP112901,1,,553621
9,119843083,124025859,del,SP112901,1,,4182776
6,65945346,74692065,del,SP112901,1,,8746719
5,70306678,72562077,del,SP112901,1,,2255399
6,20414387,25155391,del,SP112901,1,,4741004
17,1319429,1400691,del,SP112901,1,,81262
10,107098512,121896869,del,SP112901,1,,14798357
19,38815193,39138242,dup,SP112901,1,,323049
5,89542418,105126502,del,SP112901,1,,15584084
5,57734659,68828372,del,SP112901,1,,11093713
11,54795357,57675972,del,SP112901,1,,2880615
14,106384228,106757937,dup,SP112901,1,,373709
16,572747,1314398,del,SP112901,1,,741651
6,163394274,171115067,del,SP112901,1,,7720793
10,624911,792719,dup,SP112901,1,,167808
6,43086192,57317854,del,SP112901,1,,14231662
11,69473447,69543728,dup,SP112901,1,,70281
1,2100168,2497781,del,SP112901,1,,397613
21,39894980,42839761,del,SP112901,1,,2944781
9,21975053,22000206,dup,SP112901,1,,25153
6,32159878,33225001,del,SP112901,1,,1065123
10,75513093,105764322,del,SP112901,1,,30251229
10,132813652,133906134,dup,SP112901,1,,1092482
19,1228731,1296842,del,SP112901,1,,68111
22,46065854,46660147,del,SP112901,1,,594293
7,73727084,73993780,dup,SP112901,1,,266696
X,1,2693433,dup,SP112901,1,,2693432
6,57967353,58770502,del,SP112901,1,,803149
19,40743817,40780533,dup,SP112901,1,,36716
22,38554024,38771050,dup,SP112901,1,,217026
7,55162795,56708876,del,SP112901,1,,1546081
17,78773982,78827364,dup,SP112901,1,,53382
9,133564498,136081805,del,SP112901,1,,2517307
17,992042,1319429,dup,SP112901,1,,327387
8,1700138,2028078,dup,SP112901,1,,327940
17,42085642,42570135,del,SP112901,1,,484493
4,79870226,83681606,del,SP112901,1,,3811380
14,106384228,107349540,dup,SP112903,1,,965312
X,1,2467271,dup,SP112903,1,,2467270
X,154923128,155270560,dup,SP112903,1,,347432
17,19877003,22217883,dup,SP112903,1,,2340880
19,4129017,4435929,del,SP112905,1,,306912
8,145783379,146364022,del,SP112905,1,,580643
16,388734,1557047,dup,SP112905,1,,1168313
19,3018843,4129017,dup,SP112905,1,,1110174
2,37801929,47378513,del,SP112905,1,,9576584
4,605598,1833118,dup,SP112905,1,,1227520
1,2100168,3723476,dup,SP112905,1,,1623308
11,62483112,63145849,del,SP112905,1,,662737
7,2060394,2446332,del,SP112905,1,,385938
21,39818904,42835086,del,SP112905,1,,3016182
12,16367492,17313083,del,SP112905,1,,945591
11,69446756,69475291,dup,SP112905,1,,28535
20,62527712,63025520,del,SP112905,1,,497808
10,43556629,43758411,dup,SP112905,1,,201782
12,12701141,14844229,del,SP112905,1,,2143088
22,38525371,38671103,del,SP112905,1,,145732
12,11508568,11835130,del,SP112905,1,,326562
20,35979213,36099372,dup,SP112905,1,,120159
X,153324163,153558373,del,SP112905,1,,234210
17,37748494,37833273,dup,SP112905,1,,84779
19,42746278,42924151,dup,SP112905,1,,177873
2,15853565,16047667,del,SP112905,1,,194102
18,48589062,77126895,del,SP112905,1,,28537833
19,19060600,19587972,del,SP112905,1,,527372
19,33544624,33801712,dup,SP112905,1,,257088
5,998945,1296987,dup,SP112905,1,,298042
8,143891609,144285572,del,SP112905,1,,393963
2,16849551,17682873,del,SP112905,1,,833322
16,87907297,88354041,del,SP112905,1,,446744
3,37355892,38647009,del,SP112905,1,,1291117
17,38474799,38530020,dup,SP112905,1,,55221
17,76965970,77195987,dup,SP112905,1,,230017
1,11742350,12051788,del,SP112905,1,,309438
8,97182838,98371195,del,SP112905,1,,1188357
X,1,2693433,dup,SP112905,1,,2693432
3,71863604,73786919,del,SP112905,1,,1923315
10,129171704,134829614,del,SP112905,1,,5657910
5,173384313,174385473,del,SP112905,1,,1001160
7,151850,652660,dup,SP112905,1,,500810
22,50289819,51054139,dup,SP112905,1,,764320
17,48616977,48716608,dup,SP112905,1,,99631
1,156016069,156059721,dup,SP112905,1,,43652
19,50352131,50403766,dup,SP112905,1,,51635
14,105030134,106248982,dup,SP112905,1,,1218848
19,7753427,8269150,del,SP112905,1,,515723
11,2959113,3106977,del,SP112905,1,,147864
22,19938495,20800922,dup,SP112905,1,,862427
16,1953317,2338272,dup,SP112905,1,,384955
10,89481483,90550313,del,SP112905,1,,1068830
8,39390007,43767534,del,SP112905,1,,4377527
10,135171787,135534747,del,SP112905,1,,362960
8,48705780,49229389,del,SP112905,1,,523609
19,288713,2492172,dup,SP112905,1,,2203459
9,138867174,139306633,dup,SP112905,1,,439459
16,89380549,89642993,del,SP112905,1,,262444
4,7084911,7637169,del,SP112905,1,,552258
3,13041110,13515724,del,SP112905,1,,474614
12,132618393,133469370,dup,SP112905,1,,850977
19,10771425,11436795,del,SP112905,1,,665370
17,7602787,7622972,dup,SP112905,1,,20185
8,142788351,143228324,del,SP112905,1,,439973
17,78608600,78751979,del,SP112905,1,,143379
21,46676236,46963419,dup,SP112905,1,,287183
9,136293596,137407480,dup,SP112905,1,,1113884
2,99044173,99075043,dup,SP112905,1,,30870
8,1,7004147,del,SP112905,1,,7004146
20,60494742,60743416,dup,SP112905,1,,248674
19,2492172,3018843,del,SP112905,1,,526671
21,45519918,45887581,dup,SP112905,1,,367663
2,242644313,243199373,dup,SP112905,1,,555060
1,3723476,3813295,del,SP112905,1,,89819
19,7285759,7753427,dup,SP112905,1,,467668
5,38184175,46401271,del,SP112905,1,,8217096
18,1,9277184,del,SP112905,1,,9277183
17,78845651,81195210,dup,SP112905,1,,2349559
11,1,2476163,dup,SP112905,1,,2476162
17,42366080,44794346,del,SP112905,1,,2428266
11,69475291,69497951,del,SP112905,1,,22660
8,49427440,49854413,del,SP112905,1,,426973
22,19807774,19938495,del,SP112905,1,,130721
6,31774117,31936000,del,SP112905,1,,161883
16,88354041,89380549,dup,SP112905,1,,1026508
11,67298739,67376865,del,SP112905,1,,78126
18,77274051,78077248,del,SP112905,1,,803197
12,124814115,125068165,dup,SP112905,1,,254050
16,2588221,2716246,del,SP112905,1,,128025
17,1357392,1670559,dup,SP112905,1,,313167
12,58113236,58148257,dup,SP112905,1,,35021
19,49013839,49509801,del,SP112905,1,,495962
9,131497153,132140506,del,SP112905,1,,643353
22,24343908,24397683,dup,SP112905,1,,53775
7,896244,2060394,dup,SP112905,1,,1164150
14,23322258,23655182,del,SP112905,1,,332924
9,137407480,138867174,del,SP112905,1,,1459694
11,68625746,69446756,del,SP112905,1,,821010
2,18109562,20533779,del,SP112905,1,,2424217
10,47005935,47604779,del,SP112905,1,,598844
8,8094763,39264684,del,SP112905,1,,31169921
16,1,388734,del,SP112905,1,,388733
8,143228324,143891609,dup,SP112905,1,,663285
4,1833118,1967347,del,SP112905,1,,134229
16,1557047,1953317,del,SP112905,1,,396270
17,37880170,37921844,dup,SP112905,1,,41674
17,1218621,1357392,del,SP112905,1,,138771
1,1,1475929,dup,SP112905,1,,1475928
5,179962036,180096101,dup,SP112905,1,,134065
19,31456870,31828387,del,SP112905,1,,371517
8,144285572,145783379,dup,SP112905,1,,1497807
X,41995680,42374356,del,SP112905,1,,378676
19,40685121,40744843,dup,SP112905,1,,59722
19,18850712,19060600,dup,SP112905,1,,209888
13,43199687,52021254,del,SP112905,1,,8821567
4,185952011,186817532,del,SP112905,1,,865521
20,60881066,62339514,dup,SP112905,1,,1458448
17,77195987,78329627,del,SP112905,1,,1133640
16,89872736,90354753,dup,SP112905,1,,482017
13,95303925,98054454,del,SP112905,1,,2750529
11,2720642,2959113,dup,SP112905,1,,238471
9,139388854,140424060,dup,SP112905,1,,1035206
19,10231505,10387007,del,SP112905,1,,155502
22,46540594,46745398,del,SP112905,1,,204804
14,66741381,69395281,del,SP112905,1,,2653900
20,60101844,60494742,del,SP112905,1,,392898
X,58127450,58470802,del,SP112887,1,,343352
13,45287127,48416753,del,SP112887,1,,3129626
17,19877003,22217883,dup,SP112887,1,,2340880
X,154923128,155270560,dup,SP112887,1,,347432
X,1,2678150,dup,SP112887,1,,2678149
6,138735956,168898376,del,SP112889,1,,30162420
18,77432624,78077248,dup,SP112889,1,,644624
14,22981839,23690983,del,SP112889,1,,709144
4,187631679,187907668,dup,SP112889,1,,275989
21,29783874,32025276,del,SP112889,1,,2241402
10,1,624911,del,SP112889,1,,624910
12,26525151,27794460,del,SP112889,1,,1269309
10,741610,23701828,del,SP112889,1,,22960218
15,23740906,25064302,del,SP112889,1,,1323396
18,60294490,60657659,del,SP112889,1,,363169
7,96732938,97465721,del,SP112889,1,,732783
1,77480192,78794372,del,SP112889,1,,1314180
12,7974629,14973702,del,SP112889,1,,6999073
1,33368742,34059085,del,SP112889,1,,690343
6,8030475,10810230,del,SP112889,1,,2779755
17,54508737,64075076,del,SP112889,1,,9566339
3,30738828,31780255,del,SP112889,1,,1041427
21,14344537,16428913,del,SP112889,1,,2084376
1,3652763,3817541,dup,SP112889,1,,164778
5,45850623,46401271,del,SP112889,1,,550648
8,55520009,56715275,del,SP112889,1,,1195266
21,21101280,23349277,del,SP112889,1,,2247997
16,68036151,90354753,del,SP112889,1,,22318602
1,67684859,68255054,del,SP112889,1,,570195
21,46939477,47759084,dup,SP112889,1,,819607
22,24337410,24397683,dup,SP112889,1,,60273
7,26234643,27567555,dup,SP112889,1,,1332912
7,150162566,150443224,del,SP112889,1,,280658
1,76203415,76663828,del,SP112889,1,,460413
17,6801922,7593310,del,SP112889,1,,791388
14,92579870,94506783,del,SP112889,1,,1926913
6,709222,2387123,del,SP112889,1,,1677901
3,70599800,71578156,del,SP112889,1,,978356
21,39939192,42859011,del,SP112889,1,,2919819
12,25349875,26433576,del,SP112889,1,,1083701
8,8094763,37670280,del,SP112889,1,,29575517
8,4861433,7004147,del,SP112889,1,,2142714
12,21057450,25059965,del,SP112889,1,,4002515
3,29847332,30623172,del,SP112889,1,,775840
1,117226462,118320834,del,SP112889,1,,1094372
1,35513033,36996085,del,SP112889,1,,1483052
21,36072598,37657555,del,SP112889,1,,1584957
14,20219083,20735041,del,SP112889,1,,515958
18,60914771,61033069,del,SP112889,1,,118298
18,54345395,55197718,del,SP112889,1,,852323
5,173313881,176083857,del,SP112889,1,,2769976
2,16071164,16087942,dup,SP112889,1,,16778
22,18539842,19906497,del,SP112889,1,,1366655
6,43718088,58770502,del,SP112889,1,,15052414
1,60366930,62600528,del,SP112889,1,,2233598
12,37902988,38426187,del,SP112889,1,,523199
10,85440655,90322993,del,SP112889,1,,4882338
5,54671607,55433905,del,SP112889,1,,762298
10,46152582,47340886,dup,SP112889,1,,1188304
8,1,4813348,del,SP112889,1,,4813347
14,95805136,107349540,del,SP112889,1,,11544404
21,24819711,27148070,del,SP112889,1,,2328359
6,61000000,112663323,del,SP112889,1,,51663323
7,55216235,55249907,dup,SP112889,1,,33672
22,25805042,29402967,del,SP112889,1,,3597925
14,24059019,29966176,del,SP112889,1,,5907157
7,115807379,116321420,dup,SP112889,1,,514041
1,106592450,109565513,del,SP112889,1,,2973063
14,31435850,34787239,del,SP112889,1,,3351389
1,120248833,120783240,del,SP112889,1,,534407
2,179929911,180973133,del,SP112889,1,,1043222
11,113645085,118218450,del,SP112889,1,,4573365
14,60912266,66765059,del,SP112889,1,,5852793
10,29395769,29714389,dup,SP112889,1,,318620
12,19337910,20531628,del,SP112889,1,,1193718
X,1,2693433,dup,SP112889,1,,2693432
11,50353819,51223497,del,SP112889,1,,869678
11,69480851,69508928,dup,SP112889,1,,28077
21,45897964,46419947,dup,SP112889,1,,521983
1,69580625,70089909,del,SP112889,1,,509284
5,115414206,119095864,del,SP112889,1,,3681658
7,158233672,159040558,dup,SP112889,1,,806886
21,19830796,20619466,del,SP112889,1,,788670
15,30667575,47692103,del,SP112889,1,,17024528
7,157278662,157820642,dup,SP112889,1,,541980
1,110063400,111096547,del,SP112889,1,,1033147
18,60657659,60914771,dup,SP112889,1,,257112
14,74262357,77648309,del,SP112889,1,,3385952
10,97925557,100428230,del,SP112889,1,,2502673
8,92888684,93305493,dup,SP112889,1,,416809
5,3633354,4895480,del,SP112891,1,,1262126
4,175864413,179210934,del,SP112891,1,,3346521
22,38549636,38733494,dup,SP112891,1,,183858
5,98013575,99246817,del,SP112891,1,,1233242
1,190238186,191787808,del,SP112891,1,,1549622
11,1,508711,del,SP112891,1,,508710
19,1213034,1320068,del,SP112891,1,,107034
4,126739707,132601574,del,SP112891,1,,5861867
9,70984372,78613744,del,SP112891,1,,7629372
X,81007829,82350014,del,SP112891,1,,1342185
2,145403398,146540315,del,SP112891,1,,1136917
1,2213032,2497781,del,SP112891,1,,284749
11,69449631,69475682,del,SP112891,1,,26051
9,105795221,107757592,del,SP112891,1,,1962371
5,82786777,83313116,del,SP112891,1,,526339
5,83791770,91162301,del,SP112891,1,,7370531
6,101322905,121461055,del,SP112891,1,,20138150
4,121356387,121915420,del,SP112891,1,,559033
5,99246817,100615725,del,SP112891,1,,1368908
1,3652763,3804219,dup,SP112891,1,,151456
8,5962416,7004147,del,SP112891,1,,1041731
1,165111121,165686166,del,SP112891,1,,575045
8,32955102,34875841,del,SP112891,1,,1920739
4,116416576,116917038,del,SP112891,1,,500462
3,13114972,13655983,dup,SP112891,1,,541011
5,97196689,97591978,del,SP112891,1,,395289
4,179529807,181321260,del,SP112891,1,,1791453
21,46513748,47129690,del,SP112891,1,,615942
5,50440689,68828372,del,SP112891,1,,18387683
X,1,2693433,dup,SP112891,1,,2693432
12,4778848,25237252,del,SP112891,1,,20458404
4,179210934,179529807,del,SP112891,1,,318873
11,69475682,69554245,dup,SP112891,1,,78563
6,81925593,92485509,del,SP112891,1,,10559916
4,96274459,97832267,del,SP112891,1,,1557808
11,101016427,101574906,del,SP112891,1,,558479
4,30018024,30737889,del,SP112891,1,,719865
4,187576603,188394839,del,SP112891,1,,818236
8,8094763,32030975,del,SP112891,1,,23936212
16,88342973,89263247,del,SP112891,1,,920274
14,105988088,106171659,del,SP112891,1,,183571
19,10429884,11047864,dup,SP112891,1,,617980
1,214930372,241086047,del,SP112891,1,,26155675
5,70306678,81250763,del,SP112891,1,,10944085
8,138299649,139508630,del,SP112891,1,,1208981
1,3160098,3652763,del,SP112891,1,,492665
5,100615725,109785444,del,SP112891,1,,9169719
5,176526922,176579279,dup,SP112891,1,,52357
12,129564043,133148698,del,SP112891,1,,3584655
3,183589374,185144279,del,SP112893,1,,1554905
3,174428328,177613690,del,SP112893,1,,3185362
X,61732394,62136917,del,SP112893,1,,404523
X,1,1121912,dup,SP112893,1,,1121911
17,19877003,22217883,dup,SP112893,1,,2340880
19,17223703,18768473,del,SP112893,1,,1544770
17,3909458,12676876,del,SP112893,1,,8767418
3,179122017,181034636,del,SP112893,1,,1912619
13,35851150,48875863,del,SP112893,1,,13024713
X,154923128,155270560,dup,SP112893,1,,347432
10,73077907,81234081,del,SP112893,1,,8156174
21,39965803,42859011,del,SP112893,1,,2893208
6,31357730,31922363,del,SP112893,1,,564633
X,1483574,2483116,dup,SP112893,1,,999542
14,106287213,107349540,dup,SP112893,1,,1062327
7,137076793,139095935,del,SP112893,1,,2019142
6,43603981,44017011,del,SP112893,1,,413030
17,1994922,7356667,del,SP112895,1,,5361745
17,8930246,12096593,del,SP112895,1,,3166347
10,132723635,133906134,dup,SP112895,1,,1182499
1,3587071,3652763,del,SP112895,1,,65692
17,1367542,1887345,del,SP112895,1,,519803
22,19757115,19948477,dup,SP112895,1,,191362
19,40745531,40778521,dup,SP112895,1,,32990
19,17452949,17950169,dup,SP112895,1,,497220
20,44440242,44979106,dup,SP112895,1,,538864
19,45190798,45823504,dup,SP112895,1,,632706
22,38544697,38743108,dup,SP112895,1,,198411
16,88267811,89344816,del,SP112895,1,,1077005
19,50331736,50393650,del,SP112895,1,,61914
8,46896972,47186637,dup,SP112895,1,,289665
1,2093618,3211040,del,SP112895,1,,1117422
16,76204858,78637762,del,SP112895,1,,2432904
19,1228731,1265665,del,SP112895,1,,36934
17,77184322,77645917,dup,SP112895,1,,461595
11,69449631,69472923,del,SP112895,1,,23292
19,10806361,11557440,dup,SP112895,1,,751079
21,40582602,42835086,del,SP112895,1,,2252484
1,17681350,17761705,dup,SP112895,1,,80355
6,168590641,169132188,dup,SP112895,1,,541547
17,76192027,76630809,dup,SP112895,1,,438782
X,1,2693433,dup,SP112895,1,,2693432
19,12917418,13278671,dup,SP112895,1,,361253
14,106534342,106784498,dup,SP112895,1,,250156
19,50393650,50808286,dup,SP112895,1,,414636
19,42668900,42720039,dup,SP112895,1,,51139
19,49051645,49515878,dup,SP112895,1,,464233
22,44922923,45256646,dup,SP112895,1,,333723
19,2368871,3018843,dup,SP112895,1,,649972
11,69472923,69557249,dup,SP112895,1,,84326
17,7565410,7619843,del,SP112895,1,,54433
9,131921962,132549626,dup,SP112895,1,,627664
22,24333003,24400522,dup,SP112895,1,,67519
16,34468168,34823427,dup,SP112895,1,,355259
1,3652763,3806035,dup,SP112895,1,,153272
17,80065470,81195210,dup,SP112895,1,,1129740
16,572747,1314398,del,SP112895,1,,741651
16,80138777,87896565,del,SP112895,1,,7757788
17,41266138,41471672,dup,SP112895,1,,205534
17,5536278,7722782,del,SP112897,1,,2186504
10,49026824,50502443,del,SP112897,1,,1475619
15,74168911,74342619,dup,SP112897,1,,173708
1,93477178,94362147,del,SP112897,1,,884969
6,134081839,137095166,del,SP112897,1,,3013327
17,41620341,42581319,del,SP112897,1,,960978
8,1,2932929,del,SP112897,1,,2932928
9,139392008,139569733,del,SP112897,1,,177725
18,19820223,21726853,del,SP112897,1,,1906630
6,125443206,129007258,del,SP112897,1,,3564052
16,71469665,90354753,del,SP112897,1,,18885088
2,212649970,216012628,del,SP112897,1,,3362658
8,125003449,126434421,del,SP112897,1,,1430972
9,1,14184654,del,SP112897,1,,14184653
14,106524357,106816366,dup,SP112897,1,,292009
7,157220902,157686168,dup,SP112897,1,,465266
12,1,19337910,del,SP112897,1,,19337909
19,1225236,1296842,del,SP112897,1,,71606
X,1262729,1603426,dup,SP112897,1,,340697
1,2173019,2497781,del,SP112897,1,,324762
8,41921154,42499719,del,SP112897,1,,578565
19,11843313,13815538,del,SP112897,1,,1972225
2,228144415,230831506,del,SP112897,1,,2687091
X,1,1262729,dup,SP112897,1,,1262728
14,22599824,22994316,dup,SP112897,1,,394492
8,2955660,7004147,del,SP112897,1,,4048487
6,87754822,117358241,del,SP112897,1,,29603419
21,39872681,42867981,del,SP112897,1,,2995300
10,46980006,47557198,del,SP112897,1,,577192
2,226039135,227611078,del,SP112897,1,,1571943
10,101541156,105466412,del,SP112897,1,,3925256
X,1603426,2693433,dup,SP112897,1,,1090007
1,166845937,169801105,del,SP112897,1,,2955168
8,8094763,38929106,del,SP112897,1,,30834343
15,22752399,49044810,del,SP112897,1,,26292411
8,145029764,145513477,dup,SP112897,1,,483713
1,3587071,3649688,del,SP112897,1,,62617
19,1173202,1203765,dup,SP112897,1,,30563
1,219923308,219923626,del,NA12043,0,,318
1,183118733,183119274,del,NA20341,0,,541
1,25900344,25908041,del,NA18597,0,,7697
1,9822405,9825678,del,HG00419,0,,3273
1,41746258,41749818,del,HG00276,0,,3560
1,231743586,231743987,del,NA18909,0,,401
1,31169519,31171884,del,NA18557,0,,2365
1,234142437,234143182,del,NA19390,0,,745
1,215004580,215010436,del,NA18546,0,,5856
1,248858089,248906850,del,HG00619,0,,48761
1,151937156,151942853,del,NA18908,0,,5697
1,5302112,5304560,del,NA19452,0,,2448
1,738655,742056,del,NA19000,0,,3401
1,38602524,38604796,del,HG00313,0,,2272
1,63611025,63616493,del,NA19317,0,,5468
1,225721129,225724502,del,NA19652,0,,3373
1,15288345,15288527,del,NA19779,0,,182
1,106978446,106981604,del,NA19701,0,,3158
1,168572259,168574235,del,HG01204,0,,1976
1,109602596,109603290,del,NA19377,0,,694
1,46705863,46708626,del,NA19908,0,,2763
1,25592116,25610022,del,HG00329,0,,17906
1,77969980,78000342,del,NA19901,0,,30362
1,163771334,163771977,del,HG01188,0,,643
1,236054575,236054913,del,HG01067,0,,338
1,38642190,38645074,del,NA18523,0,,2884
1,238556181,238562103,del,NA18636,0,,5922
1,40962346,40962777,del,HG00525,0,,431
1,93184643,93186046,del,NA18853,0,,1403
1,197720899,197723055,del,NA18508,0,,2156
1,73011114,73093104,del,HG00244,0,,81990
1,248849861,248850138,del,HG01354,0,,277
1,45160177,45169351,del,HG00614,0,,9174
1,153098578,153100384,del,NA19704,0,,1806
1,25614416,25661522,del,HG00150,0,,47106
1,158455170,158513839,del,HG00338,0,,58669
1,16366439,16388944,del,NA18561,0,,22505
1,118989797,118990341,del,NA18917,0,,544
1,201391609,201392338,del,HG00478,0,,729
1,63705356,63708146,del,NA12340,0,,2790
1,55287551,55287869,del,HG00662,0,,318
1,248867416,248876522,del,NA18516,0,,9106
1,86851525,86851681,del,NA18571,0,,156
1,3098399,3098480,del,HG01383,0,,81
1,202293099,202294319,del,HG00313,0,,1220
1,210284716,210289468,del,NA19431,0,,4752
1,240641206,240641608,del,HG01183,0,,402
1,11054670,11056071,del,NA19350,0,,1401
1,240726203,240726358,del,NA18510,0,,155
1,231966832,232366812,del,NA19818,0,,399980
1,160953965,160960682,del,NA18511,0,,6717
1,111359610,111360445,del,NA19382,0,,835
1,104443199,104443725,del,NA19443,0,,526
1,217404369,217404691,del,NA19087,0,,322
1,43415694,43416255,del,NA19700,0,,561
1,205471169,205481148,del,NA19395,0,,9979
1,70768111,70768434,del,HG00236,0,,323
1,208724724,208738724,del,NA18534,0,,14000
1,38132311,38132981,del,HG00619,0,,670
1,161121016,161123522,del,HG00448,0,,2506
1,10369469,10378666,del,NA19664,0,,9197
1,7570071,7571526,del,NA18545,0,,1455
1,230839627,230842464,del,HG00557,0,,2837
1,77830626,77832647,del,NA18963,0,,2021
1,191916444,191918553,del,NA18517,0,,2109
1,94212842,94213562,del,NA19438,0,,720
1,108222811,108225231,del,HG01462,0,,2420
1,243069896,243082146,del,HG01060,0,,12250
1,196728996,196813659,del,NA19398,0,,84663
1,2585601,2587388,del,NA19223,0,,1787
1,213667192,213668343,del,HG00331,0,,1151
1,42071715,42072603,del,NA19346,0,,888
1,145400610,145400720,del,HG00328,0,,110
1,11541441,11543200,del,NA20586,0,,1759
1,4284588,4285905,del,NA19713,0,,1317
1,28833990,28835181,del,HG00179,0,,1191
1,30167185,30979631,del,NA11931,0,,812446
1,33216504,33216674,del,HG00701,0,,170
1,185766810,185767133,del,NA19129,0,,323
1,62115366,62119772,del,HG00185,0,,4406
1,193557264,193557379,del,HG00324,0,,115
1,111376659,111388634,del,HG01067,0,,11975
1,204381516,204386072,del,NA19703,0,,4556
1,229812533,229820836,del,NA18593,0,,8303
1,45766916,45768526,del,NA19077,0,,1610
1,23475241,23480097,del,HG00171,0,,4856
1,152495214,152497812,del,NA19921,0,,2598
1,60043130,60047778,del,NA19238,0,,4648
1,5172491,5173418,del,HG00611,0,,927
1,11230422,11232180,del,HG01384,0,,1758
1,41068507,41084514,del,HG00237,0,,16007
1,17031841,17032423,del,NA19332,0,,582
1,152142911,152143350,del,HG01136,0,,439
1,65682230,65682594,del,NA18511,0,,364
1,13854190,13854379,del,NA19381,0,,189
1,200386799,200388468,del,HG00418,0,,1669
1,164184236,164184359,del,HG00281,0,,123
1,37521888,37522707,del,NA18908,0,,819
1,6791743,6793120,del,NA19373,0,,1377
1,96719961,96726436,del,HG01079,0,,6475
1,107125383,107125764,del,NA20346,0,,381
1,106307516,106319022,del,NA19374,0,,11506
1,89380139,89385119,del,NA12842,0,,4980
1,4676497,4676644,del,NA19055,0,,147
1,205106093,205108063,del,NA19457,0,,1970
1,187295944,187301291,del,NA19377,0,,5347
1,222723150,222724464,del,NA18595,0,,1314
1,196602684,196604037,del,NA18614,0,,1353
1,110462287,110463014,del,HG00282,0,,727
1,25535878,25539752,del,NA19900,0,,3874
1,150417780,150418335,del,NA18530,0,,555
1,242598585,242598797,del,HG00159,0,,212
1,105269149,105269596,del,NA19440,0,,447
1,169575762,169581806,del,NA19236,0,,6044
1,246125965,246126155,del,NA19009,0,,190
1,154854902,154856417,del,NA20812,0,,1515
1,161498519,161574194,del,HG00359,0,,75675
1,189200850,189201831,del,NA20813,0,,981
1,203786486,203787453,del,NA20799,0,,967
1,182173085,182188086,del,NA19009,0,,15001
1,189084961,189085232,del,NA19207,0,,271
1,14436350,14436655,del,NA20282,0,,305
1,158961355,158966211,del,HG00275,0,,4856
1,9604142,9608500,del,NA19725,0,,4358
1,8550246,8551326,del,NA19235,0,,1080
1,3325300,3325742,del,NA20761,0,,442
1,222550245,222551116,del,NA18572,0,,871
1,4882350,4883038,del,NA19003,0,,688
1,145719889,145722929,del,NA19010,0,,3040
1,149294692,149680218,del,HG00419,0,,385526
1,1465911,1466230,del,NA18951,0,,319
1,154565067,154569158,del,HG01073,0,,4091
1,1772235,1773644,del,HG00146,0,,1409
1,105625015,105630910,del,HG01051,0,,5895
1,24091454,24099936,del,NA19446,0,,8482
1,150860263,150862810,del,NA20809,0,,2547
1,179064393,179066699,del,HG00553,0,,2306
1,222373666,222381322,del,NA20828,0,,7656
1,105091161,105092565,del,NA19437,0,,1404
1,16151935,16155439,del,NA07048,0,,3504
1,152760866,152773222,del,NA18916,0,,12356
1,68007964,68008816,del,HG00542,0,,852
1,98903493,98904126,del,NA19675,0,,633
1,109580065,109581417,del,NA11994,0,,1352
1,1086817,1087023,del,NA19900,0,,206
1,195043196,195043557,del,HG01073,0,,361
1,8338218,8338897,del,NA19371,0,,679
1,26661234,26661788,del,NA18632,0,,554
1,56766715,56770303,del,HG00704,0,,3588
1,101637603,101639928,del,NA19681,0,,2325
1,81119424,81119734,del,HG00443,0,,310
1,81405116,81416922,del,HG00321,0,,11806
1,93291980,93292794,del,NA18550,0,,814
1,242556540,242556760,del,NA19439,0,,220
1,105386435,105392485,del,NA19373,0,,6050
1,33806758,33809167,del,HG00472,0,,2409
1,17815773,17819713,del,NA19078,0,,3940
1,213081566,213087722,del,HG00257,0,,6156
1,40733003,40733312,del,HG00731,0,,309
1,99003440,99007852,del,HG00428,0,,4412
1,111472691,111477713,del,NA18635,0,,5022
1,113036671,113037938,del,NA19469,0,,1267
1,72755412,72763913,del,HG00313,0,,8501
1,92427722,92427879,del,HG00345,0,,157
1,23867498,23874823,del,HG00536,0,,7325
1,19599560,19614159,del,NA20340,0,,14599
1,111383250,111384520,del,NA19456,0,,1270
1,204315474,204315777,del,NA19085,0,,303
1,160555066,160555446,del,NA18907,0,,380
1,166373739,166384108,del,NA18560,0,,10369
1,1443563,1445764,del,NA19376,0,,2201
1,110484142,110485785,del,HG00736,0,,1643
1,245695398,245698320,del,HG00133,0,,2922
1,230105160,230105304,del,HG00345,0,,144
1,7608746,7608938,del,NA19773,0,,192
1,234083148,234083565,del,NA10851,0,,417
1,5869379,5869501,del,NA20535,0,,122
1,243127516,243128922,del,HG00183,0,,1406
1,27464868,27466108,del,NA19375,0,,1240
1,189243967,189246893,del,NA18933,0,,2926
1,10913511,10913622,del,NA19360,0,,111
1,13120416,13141422,del,NA19010,0,,21006
1,79957296,80107459,del,HG01048,0,,150163
1,1587100,1653294,del,NA18982,0,,66194
1,17069933,17225389,del,HG01073,0,,155456
1,1565016,1568022,del,HG00158,0,,3006
1,76900599,76903386,del,NA18595,0,,2787
1,82382333,82386361,del,NA19347,0,,4028
1,2589248,2616268,del,NA18943,0,,27020
1,34028739,34029733,del,NA20346,0,,994
1,152128085,152128697,del,NA20542,0,,612
1,117002162,117002292,del,NA19376,0,,130
1,5028128,5056368,del,NA19473,0,,28240
1,247745705,247748273,del,NA19239,0,,2568
1,244679967,244681253,del,NA19359,0,,1286
1,209670685,209684571,del,NA20804,0,,13886
1,69020025,69021224,del,NA19440,0,,1199
1,228481252,228482681,del,HG00581,0,,1429
1,205251509,205252468,del,NA19921,0,,959
1,161355536,161356012,del,NA18949,0,,476
1,228479552,228480972,del,HG00476,0,,1420
1,177502961,177506193,del,HG00565,0,,3232
1,249089584,249093213,del,NA19189,0,,3629
1,248546381,248547945,del,HG00736,0,,1564
1,81436464,81444017,del,NA18861,0,,7553
1,3670537,3671607,del,NA19373,0,,1070
1,102096710,102098774,del,NA18501,0,,2064
1,189026186,189031206,del,HG01060,0,,5020
1,33785376,33787934,del,NA19682,0,,2558
1,44066084,44066421,del,NA19385,0,,337
1,165535068,165547924,del,NA12341,0,,12856
1,34568180,34568256,del,HG00249,0,,76
1,174803009,174819211,del,HG00589,0,,16202
1,203894318,203895936,del,NA18873,0,,1618
1,77910012,77910306,del,NA18924,0,,294
1,39084221,39085825,del,NA19466,0,,1604
1,98619518,98620240,del,NA19346,0,,722
1,247103858,247104523,del,NA19385,0,,665
1,71237363,71240327,del,HG00131,0,,2964
1,43385310,43386575,del,NA19375,0,,1265
1,17997723,18003855,del,HG01055,0,,6132
1,49068875,49069509,del,HG00608,0,,634
1,51915151,51917455,del,NA19467,0,,2304
1,4155146,4155460,del,NA19347,0,,314
1,53594097,53594948,del,NA19676,0,,851
1,213027330,213028992,del,NA19455,0,,1662
1,212384360,212386634,del,NA18990,0,,2274
1,215435462,215436105,del,NA18548,0,,643
1,195040091,195040542,del,HG01083,0,,451
1,62479159,62480586,del,HG00442,0,,1427
1,222374165,222380539,del,HG00328,0,,6374
1,72766323,72811839,del,NA19209,0,,45516
1,236583972,236584880,del,NA19719,0,,908
1,246846349,246848019,del,HG01051,0,,1670
1,195904521,195906949,del,NA18956,0,,2428
1,246905202,246909210,del,HG00428,0,,4008
1,154080902,154084661,del,NA18912,0,,3759
1,248595034,248597358,del,HG01171,0,,2324
1,20286486,20288553,del,NA18984,0,,2067
1,71886688,71886909,del,NA18956,0,,221
1,188984235,189038071,del,NA18907,0,,53836
1,39084065,39085669,del,NA19835,0,,1604
1,165890033,165890726,del,NA19382,0,,693
1,112983559,112987557,del,HG00689,0,,3998
1,28957511,28960862,del,NA20334,0,,3351
1,209008738,209012053,del,HG00557,0,,3315
1,94251458,94251771,del,NA18980,0,,313
1,63388482,63388731,del,NA19360,0,,249
1,64843725,64846465,del,NA19703,0,,2740
1,81422530,81424434,del,NA20334,0,,1904
1,22117422,22121963,del,NA19439,0,,4541
1,32186521,32187695,del,HG00174,0,,1174
1,26460116,26464272,del,HG00178,0,,4156
1,13693216,13773222,del,NA19648,0,,80006
1,8185330,8186291,del,NA18534,0,,961
1,147865516,147913222,del,HG00671,0,,47706
1,22216021,22216245,del,NA19382,0,,224
1,62765368,62770755,del,NA07000,0,,5387
1,246585970,246594478,del,NA18544,0,,8508
1,64846908,64848425,del,NA19703,0,,1517
1,236476469,236478376,del,NA19437,0,,1907
1,103601637,103752227,del,NA19130,0,,150590
1,78960360,78964798,del,HG00149,0,,4438
1,44823391,44823690,del,NA20797,0,,299
1,32969091,32973956,del,NA18606,0,,4865
1,248739716,248798022,del,NA19213,0,,58306
1,6762362,6763679,del,NA19916,0,,1317
1,249089599,249090753,del,HG01124,0,,1154
1,46090642,46092126,del,HG00325,0,,1484
1,40575437,40587366,del,NA19446,0,,11929
1,208605224,208607228,del,HG00671,0,,2004
1,207700012,207737123,del,HG01456,0,,37111
1,30947122,30950772,del,NA20519,0,,3650
1,32871677,32871969,del,NA19374,0,,292
1,19647189,19648341,del,NA19373,0,,1152
1,22499758,22509304,del,NA18868,0,,9546
1,171408990,171411924,del,NA19384,0,,2934
1,15920718,15937083,del,NA19834,0,,16365
1,74829729,74830505,del,HG01052,0,,776
1,35101421,35111976,del,HG00281,0,,10555
1,157674623,157677819,del,NA12413,0,,3196
1,183308660,183309115,del,NA18636,0,,455
1,180224428,180233245,del,NA19056,0,,8817
1,161345038,161346797,del,NA18570,0,,1759
1,235537065,235538337,del,NA19317,0,,1272
1,7908786,7909459,del,HG00310,0,,673
1,30154856,30167410,del,HG00704,0,,12554
1,18722396,18722729,del,NA19625,0,,333
1,14163093,14167002,del,NA19107,0,,3909
1,64847081,65092556,del,HG00704,0,,245475
1,19369909,19373169,del,HG00418,0,,3260
1,198017127,198019104,del,HG01149,0,,1977
1,38175614,38182839,del,NA19404,0,,7225
1,196631026,196633119,del,NA19704,0,,2093
1,247984836,247985241,del,NA18486,0,,405
1,247925430,247926065,del,NA18606,0,,635
1,9620053,9622149,del,HG01351,0,,2096
1,89094518,89095340,del,NA18557,0,,822
1,11097649,11106265,del,NA19257,0,,8616
1,197894018,197894314,del,NA18558,0,,296
1,225748695,225750166,del,HG00449,0,,1471
1,207040602,207045231,del,NA19707,0,,4629
1,169225316,169245822,del,HG00334,0,,20506
1,4531112,4531246,del,NA19403,0,,134
1,189503394,189518602,del,NA18545,0,,15208
1,246946513,246946840,del,HG00246,0,,327
1,189771448,189777761,del,NA19247,0,,6313
1,212681774,212682924,del,HG00656,0,,1150
1,35504958,35507112,del,HG00560,0,,2154
1,54611366,54614972,del,NA19904,0,,3606
1,95542288,95542614,del,NA18990,0,,326
1,9453900,9456501,del,NA18530,0,,2601
1,22904414,22905459,del,NA19446,0,,1045
1,18009607,18009864,del,HG00124,0,,257
1,15935091,15938226,del,NA19235,0,,3135
1,177946240,177951933,del,NA19716,0,,5693
1,1082524,1082740,del,NA19439,0,,216
1,231535376,231546037,del,HG00656,0,,10661
1,203684276,203686199,del,NA20356,0,,1923
1,74351391,74364332,del,HG00422,0,,12941
1,73646466,73650684,del,NA18959,0,,4218
1,2693029,2697101,del,HG00404,0,,4072
1,37846251,37847483,del,NA19462,0,,1232
1,104706645,104708051,del,NA19904,0,,1406
1,158726925,158728009,del,NA18544,0,,1084
1,241853759,241854272,del,HG00443,0,,513
1,23736151,23737760,del,NA18631,0,,1609
1,183118603,183118698,del,NA18638,0,,95
1,240896096,240897662,del,HG01069,0,,1566
1,1561116,1571022,del,HG00671,0,,9906
1,173083704,173084934,del,NA19904,0,,1230
1,67824265,67831968,del,HG00448,0,,7703
1,168546495,168547937,del,NA19078,0,,1442
1,8147356,8147708,del,HG00524,0,,352
1,106419738,106421578,del,NA19079,0,,1840
1,178948111,178975612,del,NA19079,0,,27501
1,92383235,92384150,del,NA19448,0,,915
1,161484104,161565762,del,HG00351,0,,81658
1,21793599,21798063,del,HG00427,0,,4464
1,157556835,157558637,del,NA19472,0,,1802
1,215492421,215500994,del,HG01377,0,,8573
1,200189970,200190556,del,HG01047,0,,586
1,182674679,182674860,del,HG00254,0,,181
1,118058747,118061240,del,NA19334,0,,2493
1,101637610,101639920,del,NA19681,0,,2310
1,91040198,91040386,del,NA18949,0,,188
1,188710591,188715821,del,HG01108,0,,5230
1,33156761,33156938,del,NA18620,0,,177
1,79094618,79097447,del,HG01357,0,,2829
1,106404277,106407804,del,HG00108,0,,3527
1,228741048,228742129,del,NA19675,0,,1081
1,106983099,106987671,del,NA18532,0,,4572
1,192539198,192540188,del,NA19189,0,,990
1,188958983,188966270,del,NA19448,0,,7287
1,1414616,1416422,del,NA19732,0,,1806
1,27768246,27769036,del,NA18638,0,,790
1,145142706,145143425,del,HG00614,0,,719
1,91132697,91132833,del,HG00284,0,,136
1,107655281,107663738,del,NA12777,0,,8457
1,236536630,236539218,del,NA19437,0,,2588
1,226197945,226200880,del,NA18559,0,,2935
1,160564299,160565865,del,HG00543,0,,1566
1,170617667,170618524,del,HG00123,0,,857
1,79393608,79399526,del,NA18907,0,,5918
1,180228457,180230452,del,NA18867,0,,1995
1,232048468,232049194,del,NA18502,0,,726
1,69996390,70002702,del,NA19377,0,,6312
1,83302348,83304293,del,HG00534,0,,1945
1,243094685,243095755,del,NA19383,0,,1070
1,92232061,92233333,del,HG00740,0,,1272
1,174796556,174801844,del,NA18618,0,,5288
1,53594816,53596522,del,HG00321,0,,1706
1,119289189,119292020,del,NA20537,0,,2831
1,50861089,50877152,del,HG00736,0,,16063
1,54894099,54897519,del,HG01102,0,,3420
1,196760476,196877793,del,NA19384,0,,117317
1,245055091,245056388,del,NA18874,0,,1297
1,172759292,172761991,del,NA19396,0,,2699
1,235872727,235873263,del,NA18868,0,,536
1,203064346,203065190,del,NA12830,0,,844
1,224993623,224996503,del,NA19916,0,,2880
1,766593,769112,del,NA18999,0,,2519
1,194759540,194760546,del,NA18519,0,,1006
1,83124416,83127222,del,HG00708,0,,2806
1,104677180,104678377,del,HG00282,0,,1197
1,19386609,19387143,del,NA18933,0,,534
1,7559480,7560142,del,HG01440,0,,662
1,161531270,161612615,del,NA18941,0,,81345
1,153960711,153961968,del,NA19701,0,,1257
1,233434712,233446053,del,NA19818,0,,11341
1,19371402,19373335,del,HG00418,0,,1933
1,66024173,66030267,del,HG01354,0,,6094
1,78738659,78740213,del,HG00124,0,,1554
1,7552939,7553255,del,NA20787,0,,316
1,31514380,31515199,del,NA19078,0,,819
1,62654216,62656972,del,HG00534,0,,2756
1,109700934,109701469,del,HG00543,0,,535
1,150907554,150912058,del,NA19681,0,,4504
1,84712005,84715883,del,NA19468,0,,3878
1,80221780,80223040,del,HG01069,0,,1260
1,1400359,1408900,del,NA19722,0,,8541
1,50769447,50771391,del,NA19055,0,,1944
1,157540650,157540876,del,NA10847,0,,226
1,41021651,41028590,del,NA19788,0,,6939
1,20932021,20932703,del,NA19130,0,,682
1,47413422,47419602,del,NA19055,0,,6180
1,245487199,245487354,del,HG00448,0,,155
1,211369293,211370480,del,NA18488,0,,1187
1,30758958,31134922,del,HG01061,0,,375964
1,152643792,152646691,del,NA19057,0,,2899
1,46474154,46474524,del,NA19462,0,,370
1,24256916,24361722,del,HG01518,0,,104806
1,160793177,160795132,del,HG00692,0,,1955
1,5766984,5767216,del,NA19372,0,,232
1,87096990,87098378,del,NA19462,0,,1388
1,212297239,212302147,del,HG01350,0,,4908
1,39408400,39409894,del,HG00331,0,,1494
1,17676172,17677665,del,HG01441,0,,1493
1,3238067,3238529,del,NA19443,0,,462
1,220221475,220224289,del,HG00699,0,,2814
1,247850462,247856515,del,NA19723,0,,6053
1,32535980,32537580,del,NA19054,0,,1600
1,227776742,227779040,del,NA19445,0,,2298
1,49914513,49998578,del,HG00173,0,,84065
1,102983273,102984747,del,NA19116,0,,1474
1,2586186,2609097,del,NA18982,0,,22911
1,240557219,240558177,del,NA18563,0,,958
1,75180036,75192562,del,HG01389,0,,12526
1,3082089,3082336,del,HG00619,0,,247
1,11047366,11047568,del,NA20790,0,,202
1,162230748,162231295,del,NA19438,0,,547
1,114925730,114927042,del,NA19080,0,,1312
1,223263067,223264864,del,NA19393,0,,1797
1,113529274,113532730,del,NA19355,0,,3456
1,112835087,112837665,del,NA19313,0,,2578
1,169849518,169849757,del,HG00281,0,,239
1,72449620,72450032,del,NA18543,0,,412
1,99179942,99180049,del,NA19684,0,,107
1,107220682,107224673,del,HG01051,0,,3991
1,224756862,224757657,del,NA19398,0,,795
1,109496525,109501689,del,NA19138,0,,5164
1,222984674,222985961,del,NA19440,0,,1287
1,48722120,48723671,del,NA18507,0,,1551
1,235254996,235256135,del,NA19429,0,,1139
1,173972263,173976265,del,NA19004,0,,4002
1,36098659,36100699,del,NA19346,0,,2040
1,74432332,74435249,del,NA18486,0,,2917
1,119099247,119104975,del,NA19682,0,,5728
1,9817083,9817546,del,HG01072,0,,463
1,196013273,196014919,del,HG00634,0,,1646
1,7163626,7164276,del,NA19084,0,,650
1,230531556,230531703,del,HG00277,0,,147
1,69974032,69985999,del,HG00698,0,,11967
1,13010516,13046822,del,NA19469,0,,36306
1,238316722,238318116,del,NA18510,0,,1394
1,173075625,173089139,del,NA19394,0,,13514
1,55092273,55095966,del,NA11831,0,,3693
1,155659759,155664464,del,NA19257,0,,4705
1,32698985,32700971,del,HG00246,0,,1986
1,11060114,11062306,del,NA19346,0,,2192
1,228431321,228431931,del,NA18504,0,,610
1,45175118,45176015,del,HG00629,0,,897
1,116486558,116493104,del,NA19311,0,,6546
1,17361001,17363337,del,HG01174,0,,2336
1,4882295,4882857,del,HG00251,0,,562
1,154969438,154969571,del,NA18622,0,,133
1,113402173,113406584,del,HG01136,0,,4411
1,76133948,76134996,del,NA19201,0,,1048
1,51128423,51130249,del,NA19444,0,,1826
1,101693299,101699182,del,NA18870,0,,5883
1,12131670,12134030,del,HG00282,0,,2360
1,10543553,10545994,del,NA19713,0,,2441
1,244985081,244986234,del,NA19398,0,,1153
1,154999759,154999863,del,NA20299,0,,104
1,175071266,175076322,del,NA18564,0,,5056
1,241096237,241097289,del,NA20538,0,,1052
1,210261557,210262237,del,HG00186,0,,680
1,166396579,166397093,del,NA19099,0,,514
1,215654412,215656032,del,HG00334,0,,1620
1,111378716,111388472,del,NA19909,0,,9756
1,187399803,187405040,del,NA18858,0,,5237
1,24092016,24097772,del,NA19452,0,,5756
1,8360239,8364039,del,NA19726,0,,3800
1,152327436,152327667,del,NA20802,0,,231
1,73976167,73976779,del,NA20806,0,,612
1,92483219,92484054,del,HG00119,0,,835
1,36733250,36733582,del,HG00123,0,,332
1,246702958,246703587,del,HG01494,0,,629
1,234646521,234647685,del,NA19453,0,,1164
1,240792904,240793369,del,NA20534,0,,465
1,85910985,85915402,del,NA19058,0,,4417
1,224324253,224327273,del,NA19318,0,,3020
1,10096093,10103672,del,NA11892,0,,7579
1,22886525,22888281,del,NA18858,0,,1756
1,14560890,14563965,del,NA19076,0,,3075
1,238750633,238752200,del,NA18489,0,,1567
1,42239899,42245684,del,NA19403,0,,5785
1,203670139,203670317,del,HG01174,0,,178
1,213901131,213903754,del,NA18949,0,,2623
1,46457780,46461764,del,HG01125,0,,3984
1,169391516,169395672,del,NA18635,0,,4156
1,105834666,105842372,del,NA18950,0,,7706
1,54611852,54615182,del,NA19172,0,,3330
1,175071216,175077522,del,NA19725,0,,6306
1,45708639,45709300,del,NA19316,0,,661
1,246167282,246167379,del,HG00318,0,,97
1,210141647,210144758,del,HG00323,0,,3111
1,218245628,218246489,del,NA20778,0,,861
1,22904494,22905580,del,NA20799,0,,1086
1,86273445,86280437,del,HG01489,0,,6992
1,100779700,100780653,del,HG00282,0,,953
1,154157630,154161389,del,NA19312,0,,3759
1,159097228,159101493,del,HG00656,0,,4265
1,77448472,77448805,del,NA18610,0,,333
1,103770211,103776201,del,HG00628,0,,5990
1,213027400,213029208,del,NA19455,0,,1808
1,206286212,206292095,del,NA19009,0,,5883
1,51714045,51720302,del,HG01070,0,,6257
1,873417,874049,del,HG00543,0,,632
1,10482480,10483779,del,HG00264,0,,1299
1,1879774,1880090,del,NA19470,0,,316
1,189704507,189783359,del,NA12892,0,,78852
1,58270030,58273061,del,NA11919,0,,3031
1,98798270,98814501,del,HG00436,0,,16231
1,45822659,45823331,del,HG00369,0,,672
1,19596742,19611385,del,NA18523,0,,14643
1,39998264,40001306,del,NA19390,0,,3042
1,3717002,3717152,del,HG00111,0,,150
1,153133706,153133963,del,NA12775,0,,257
1,84712005,84715874,del,NA18637,0,,3869
1,245190441,245191000,del,HG00707,0,,559
1,13119516,13141422,del,NA07056,0,,21906
1,80116487,80117281,del,NA19701,0,,794
1,106135224,106137437,del,HG00266,0,,2213
1,203935831,203945442,del,NA20816,0,,9611
1,174894285,174898740,del,NA18562,0,,4455
1,72497021,72498578,del,NA20535,0,,1557
1,42648646,42652850,del,HG01052,0,,4204
1,15923946,15927366,del,NA19470,0,,3420
1,248151918,248220387,del,NA20510,0,,68469
1,241355369,241370912,del,HG00611,0,,15543
1,147055489,147060388,del,HG00614,0,,4899
1,45021271,45022357,del,NA19469,0,,1086
1,40552357,40553640,del,NA19065,0,,1283
1,243127771,243129215,del,HG00331,0,,1444
1,200921132,200922921,del,NA19347,0,,1789
1,86882431,86882752,del,HG00613,0,,321
1,174219106,174221571,del,NA11829,0,,2465
1,192137945,192138387,del,NA19147,0,,442
1,111195227,111195397,del,HG00326,0,,170
1,16152682,16155538,del,NA19788,0,,2856
1,46803332,46803624,del,NA18959,0,,292
1,62622932,62624329,del,NA19771,0,,1397
1,57208746,57210363,del,HG00472,0,,1617
1,60106244,60107095,del,HG01148,0,,851
1,41161186,41161789,del,NA19679,0,,603
1,776769,791881,del,HG01357,0,,15112
1,197907954,197909774,del,HG00133,0,,1820
1,152759766,152770772,del,HG00171,0,,11006
1,2618854,2626222,del,NA18486,0,,7368
1,117078164,117078485,del,HG00662,0,,321
1,5359279,5362135,del,HG00638,0,,2856
1,220291659,220293726,del,HG00334,0,,2067
1,177932042,177932538,del,HG00595,0,,496
1,224015003,224016512,del,NA18597,0,,1509
1,12805272,12807019,del,NA19189,0,,1747
1,30617800,30621472,del,HG00146,0,,3672
1,152324343,152325231,del,HG00120,0,,888
1,152760116,152770822,del,NA20522,0,,10706
1,49619277,49620033,del,NA19985,0,,756
1,15486934,15491463,del,NA19373,0,,4529
1,238570030,238575305,del,HG00479,0,,5275
1,202295113,202297672,del,NA19625,0,,2559
1,114099391,114102338,del,NA19661,0,,2947
1,78649316,78652122,del,HG01191,0,,2806
1,40285275,40286788,del,NA18988,0,,1513
1,64388095,64389712,del,HG01125,0,,1617
1,160997312,160999066,del,NA19470,0,,1754
1,1541104,1541447,del,NA18637,0,,343
1,33226412,33228411,del,NA19000,0,,1999
1,159648707,159649657,del,NA18539,0,,950
1,90069778,90075288,del,HG01440,0,,5510
1,157087264,157088463,del,NA18908,0,,1199
1,28036280,28038946,del,HG00331,0,,2666
1,34926115,34932516,del,NA19473,0,,6401
1,160204977,160205582,del,NA20281,0,,605
1,39252613,39253520,del,NA19373,0,,907
1,246035672,246035757,del,HG00418,0,,85
1,163456765,163457405,del,NA07346,0,,640
1,73768783,73769134,del,NA19774,0,,351
1,33418171,33421160,del,NA11830,0,,2989
1,213083016,213087822,del,NA20585,0,,4806
1,43538309,43539043,del,NA19440,0,,734
1,178899077,178900548,del,NA19472,0,,1471
1,91561045,91562133,del,HG00637,0,,1088
1,180401056,180406777,del,NA19900,0,,5721
1,115742906,115743201,del,NA19138,0,,295
1,3063033,3063429,del,NA12287,0,,396
1,109025825,109026295,del,NA19704,0,,470
1,172315232,172319740,del,NA19085,0,,4508
1,246368884,246388773,del,NA18522,0,,19889
1,175022467,175026196,del,NA19461,0,,3729
1,26268407,26269100,del,NA19834,0,,693
1,196733616,196817222,del,NA19914,0,,83606
1,84388342,84388953,del,HG00280,0,,611
1,236549086,236551329,del,HG01489,0,,2243
1,101038084,101039643,del,NA19248,0,,1559
1,155844263,155845011,del,NA07357,0,,748
1,22144620,22144756,del,HG00589,0,,136
1,214853137,214856362,del,NA19449,0,,3225
1,217290152,217295598,del,NA07056,0,,5446
1,198304216,198310122,del,NA18981,0,,5906
1,107081799,107082335,del,NA18916,0,,536
1,54367647,54369730,del,NA19431,0,,2083
1,45537747,45541057,del,NA19917,0,,3310
1,87299981,87300812,del,HG00125,0,,831
1,89767665,89768402,del,NA18868,0,,737
1,234965292,234965849,del,NA19399,0,,557
1,203887670,203889891,del,NA19334,0,,2221
1,10067981,10072312,del,HG00641,0,,4331
1,10249580,10252126,del,NA19377,0,,2546
1,24321116,24362722,del,HG01061,0,,41606
1,81979731,81979852,del,NA19160,0,,121
1,112691790,112704703,del,HG00326,0,,12913
1,14731112,14734654,del,NA12761,0,,3542
1,241469728,241469865,del,NA19379,0,,137
1,22663123,22663382,del,NA19776,0,,259
1,199110047,199113805,del,NA19908,0,,3758
1,106868827,106962741,del,NA19446,0,,93914
1,71820559,71823623,del,HG01389,0,,3064
1,66170995,66173031,del,NA19374,0,,2036
1,146660588,146670162,del,NA19819,0,,9574
1,59017906,59018174,del,HG00343,0,,268
1,221743952,221754425,del,NA19160,0,,10473
1,14548055,14557092,del,NA12058,0,,9037
1,13010016,13039222,del,NA18564,0,,29206
1,86680725,86683023,del,NA19257,0,,2298
1,153488760,153495569,del,HG00671,0,,6809
1,213571342,213577215,del,NA18519,0,,5873
1,234570447,234571872,del,HG00125,0,,1425
1,28959529,28961632,del,HG00513,0,,2103
1,3063483,3063603,del,HG00705,0,,120
1,186784072,186791491,del,NA19443,0,,7419
1,235509784,235515557,del,HG00403,0,,5773
1,90022075,90022810,del,NA19099,0,,735
1,143518103,143519120,del,NA19446,0,,1017
1,152404515,152437479,del,HG00656,0,,32964
1,50528695,50541880,del,NA18555,0,,13185
1,58889985,58898572,del,NA18612,0,,8587
1,247027878,247028188,del,HG00732,0,,310
1,220288688,220291328,del,HG01190,0,,2640
1,28445937,28448321,del,HG00281,0,,2384
1,165421806,165424199,del,NA18516,0,,2393
1,12950216,12965822,del,NA19747,0,,15606
1,166372686,166379709,del,NA19377,0,,7023
1,191867696,191868795,del,NA18952,0,,1099
1,66040939,66043902,del,NA19171,0,,2963
1,246585700,246594500,del,NA18544,0,,8800
1,226002814,226003141,del,HG01072,0,,327
1,236279280,236279829,del,NA18550,0,,549
1,24928795,24929081,del,NA19210,0,,286
1,178495286,178495716,del,HG00268,0,,430
1,16357816,16362122,del,HG00626,0,,4306
1,93276453,93280949,del,HG00672,0,,4496
1,152284896,152285871,del,NA18505,0,,975
1,167479024,167479943,del,NA19776,0,,919
1,10636608,10644047,del,NA19072,0,,7439
1,234798907,234798990,del,NA18488,0,,83
1,45983487,45983583,del,HG00442,0,,96
1,70648212,70650214,del,HG00581,0,,2002
1,31399299,31400013,del,HG00536,0,,714
1,211965060,211965832,del,HG00136,0,,772
1,240138727,240139029,del,NA19247,0,,302
1,41068467,41084711,del,HG00237,0,,16244
1,20407085,20410687,del,NA19900,0,,3602
1,170296808,170299882,del,HG00448,0,,3074
1,81405216,81412122,del,NA20502,0,,6906
1,13368716,13374722,del,NA07357,0,,6006
1,166479201,166480256,del,NA18960,0,,1055
1,166551577,166552528,del,NA18934,0,,951
1,232818695,232818756,del,HG01551,0,,61
1,198886116,198886823,del,NA19108,0,,707
1,39561559,39562115,del,NA19190,0,,556
1,24161807,24166325,del,HG00448,0,,4518
1,108732416,108738322,del,HG00112,0,,5906
1,234702729,234709339,del,HG00614,0,,6610
1,89075129,89076655,del,NA19704,0,,1526
1,152187763,152191263,del,NA18544,0,,3500
1,27571330,27572366,del,NA19435,0,,1036
1,247849666,247858472,del,NA19067,0,,8806
1,120151896,120154470,del,NA19455,0,,2574
1,30030063,30030359,del,HG00252,0,,296
1,10954262,10956128,del,HG01441,0,,1866
1,182777005,182782267,del,HG00118,0,,5262
1,19895501,19901966,del,NA20754,0,,6465
1,947121,948001,del,NA19359,0,,880
1,16186587,16186978,del,HG00525,0,,391
1,196722716,196822322,del,NA18498,0,,99606
1,6434500,6445303,del,HG00684,0,,10803
1,107095681,107101428,del,NA19172,0,,5747
1,19370376,19372867,del,HG00418,0,,2491
1,84517925,84524629,del,NA19058,0,,6704
1,172461514,172461580,del,NA19138,0,,66
1,194451079,194454312,del,HG00367,0,,3233
1,19969467,19969611,del,NA18934,0,,144
1,79160066,79160141,del,NA19114,0,,75
1,207950073,207951704,del,NA12400,0,,1631
1,166273358,166273510,del,HG00656,0,,152
1,159120051,159125577,del,NA20281,0,,5526
1,95891708,95895290,del,NA18861,0,,3582
1,89257817,89259780,del,HG00740,0,,1963
1,111827775,111836090,del,NA18952,0,,8315
1,189726537,189745646,del,NA19434,0,,19109
1,71828462,71828876,del,HG00328,0,,414
1,11054599,11055955,del,NA19350,0,,1356
1,247339437,247348943,del,NA19982,0,,9506
1,236584288,236585043,del,HG00324,0,,755
1,7483023,7486286,del,NA19472,0,,3263
1,33026383,33027982,del,NA19247,0,,1599
1,7924945,7925336,del,HG00653,0,,391
1,204315398,204316838,del,HG00448,0,,1440
1,189402013,189446498,del,NA19372,0,,44485
1,232601535,232602749,del,NA19350,0,,1214
1,179249463,179266517,del,NA18638,0,,17054
1,19761427,19761593,del,NA18633,0,,166
1,25178744,25184034,del,HG00256,0,,5290
1,162837605,162839079,del,NA18870,0,,1474
1,205616286,205617217,del,NA19920,0,,931
1,238750740,238752176,del,NA19076,0,,1436
1,237394912,237395033,del,NA18597,0,,121
1,22868673,22871033,del,NA19712,0,,2360
1,16851838,16989487,del,HG00183,0,,137649
1,110223216,110246022,del,NA20806,0,,22806
1,200652485,200655381,del,NA19711,0,,2896
1,232699727,232700028,del,NA19376,0,,301
1,198773749,198775414,del,HG00119,0,,1665
1,144827960,145367836,del,NA19734,0,,539876
1,111928827,111934824,del,HG00274,0,,5997
1,168427011,168428842,del,NA18989,0,,1831
1,37972794,37990320,del,NA18567,0,,17526
1,2626821,2688226,del,HG00702,0,,61405
1,56831106,56834961,del,NA12750,0,,3855
1,168287991,168290152,del,NA20512,0,,2161
1,152084207,152084735,del,HG01082,0,,528
1,11682893,11683189,del,NA18874,0,,296
1,247712265,247732189,del,NA19239,0,,19924
1,20864032,20864746,del,NA20774,0,,714
1,40274966,40363638,del,NA18626,0,,88672
1,101388551,101388871,del,NA11931,0,,320
1,229373388,229373762,del,HG00634,0,,374
1,179329662,179333854,del,NA19147,0,,4192
1,213328807,213331441,del,NA18504,0,,2634
1,9595612,9597666,del,HG00156,0,,2054
1,1773846,1775600,del,NA18983,0,,1754
1,158786169,158787308,del,NA19439,0,,1139
1,168089040,168091474,del,NA18532,0,,2434
1,234319247,234319377,del,HG00536,0,,130
1,96996377,96997215,del,NA19909,0,,838
1,207700266,207737372,del,NA18617,0,,37106
1,39128512,39132998,del,NA19057,0,,4486
1,235119024,235119999,del,NA19446,0,,975
1,104862162,104865059,del,NA18557,0,,2897
1,202137628,202145842,del,HG00310,0,,8214
1,194060079,194060242,del,NA18964,0,,163
1,71148798,71149047,del,HG00650,0,,249
1,28900951,28902456,del,HG00701,0,,1505
1,237772410,237772566,del,HG01173,0,,156
1,81405216,81417322,del,HG00111,0,,12106
1,147852816,147861722,del,HG00256,0,,8906
1,156731293,156732556,del,NA11831,0,,1263
1,13119916,13141422,del,HG00684,0,,21506
1,62654662,62657844,del,NA18990,0,,3182
1,24520347,24523674,del,HG00138,0,,3327
1,195521899,195529335,del,NA18628,0,,7436
1,173394752,173397372,del,NA19469,0,,2620
1,27487380,27491600,del,HG00500,0,,4220
1,201659410,201659512,del,HG01069,0,,102
1,230531053,230531336,del,HG00708,0,,283
1,222374165,222380541,del,HG00319,0,,6376
1,143663416,143725722,del,NA18535,0,,62306
1,35627127,35627448,del,HG01082,0,,321
1,185783712,185785297,del,NA19099,0,,1585
1,2371994,2374303,del,NA18574,0,,2309
1,169637738,169637898,del,HG01171,0,,160
1,99890881,99891643,del,NA19327,0,,762
1,114886337,114886581,del,NA19099,0,,244
1,16649869,16657222,del,HG00732,0,,7353
1,206281059,206283122,del,HG01048,0,,2063
1,79022429,79032994,del,HG00345,0,,10565
1,104384830,104385498,del,NA19445,0,,668
1,205439855,205440024,del,HG00318,0,,169
1,196852359,196858275,del,NA18545,0,,5916
1,37632534,37687452,del,NA19819,0,,54918
1,13827952,13828141,del,HG00309,0,,189
1,162327324,162327764,del,HG00155,0,,440
1,235536566,235537972,del,HG01374,0,,1406
1,106982448,106987663,del,NA18532,0,,5215
1,16152166,16156622,del,HG01515,0,,4456
1,232775240,232775538,del,NA18964,0,,298
1,152760345,152770828,del,HG01069,0,,10483
1,189416016,189438372,del,NA19908,0,,22356
1,64843753,64845824,del,NA19703,0,,2071
1,69479742,69480628,del,NA19371,0,,886
1,10052732,10063215,del,HG01366,0,,10483
1,145294860,145301156,del,NA19057,0,,6296
1,12743405,12746628,del,HG01365,0,,3223
1,195409344,195416421,del,NA18868,0,,7077
1,170617667,170618528,del,NA12044,0,,861
1,30203332,30203472,del,NA11919,0,,140
1,81999650,82008154,del,HG00463,0,,8504
1,22113086,22121370,del,NA19625,0,,8284
1,158516762,158521743,del,NA19473,0,,4981
1,20932686,20933893,del,NA11920,0,,1207
1,99404825,99407735,del,HG00325,0,,2910
1,201276382,201281310,del,HG01188,0,,4928
1,98200434,98214145,del,HG00325,0,,13711
1,33102049,33102922,del,NA19921,0,,873
1,108733325,108737251,del,NA18943,0,,3926
1,63801252,63807002,del,NA20797,0,,5750
1,117880402,117881842,del,NA20534,0,,1440
1,62437531,62452416,del,NA19130,0,,14885
1,2911536,2911850,del,NA18627,0,,314
1,246816053,247083820,del,HG00428,0,,267767
1,76610658,76613898,del,NA18907,0,,3240
1,15774731,15781767,del,HG01134,0,,7036
1,108201066,108202410,del,NA19703,0,,1344
1,213084222,213086169,del,HG00154,0,,1947
1,217457968,217458400,del,HG01168,0,,432
1,160979498,160979993,del,NA18621,0,,495
1,65100688,65100988,del,NA18606,0,,300
1,16833486,16986155,del,HG00708,0,,152669
1,12485404,12489436,del,HG00232,0,,4032
1,30199947,30204111,del,NA19446,0,,4164
1,2918709,2919905,del,HG01124,0,,1196
1,236538684,236540888,del,NA18557,0,,2204
1,2932976,2933125,del,HG00449,0,,149
1,196764727,196889597,del,NA18873,0,,124870
1,189317541,189383105,del,HG00556,0,,65564
1,120109976,120147302,del,HG00097,0,,37326
1,191717110,191726630,del,NA19328,0,,9520
1,89475908,89478624,del,HG00243,0,,2716
1,77343702,77353392,del,NA19316,0,,9690
1,179806413,179807810,del,HG00174,0,,1397
1,21018093,21019406,del,NA12348,0,,1313
1,16363781,16387040,del,HG00151,0,,23259
1,84271902,84272033,del,NA18870,0,,131
1,201810640,201815648,del,HG00403,0,,5008
1,16836583,16989244,del,HG00698,0,,152661
1,188959061,188966466,del,NA19380,0,,7405
1,158050713,158051038,del,NA12414,0,,325
1,62113413,62119520,del,NA18603,0,,6107
1,225133630,225248654,del,NA19077,0,,115024
1,82866342,82870588,del,NA19711,0,,4246
1,165924194,165928157,del,HG00265,0,,3963
1,207541963,207545564,del,NA18609,0,,3601
1,9495979,9497492,del,NA12763,0,,1513
1,28094221,28096018,del,NA19835,0,,1797
1,227263381,227266355,del,HG00337,0,,2974
1,184402320,184403495,del,NA19780,0,,1175
1,243094554,243095498,del,NA18990,0,,944
1,87636621,87642200,del,NA11831,0,,5579
1,191167163,191167537,del,NA19147,0,,374
1,106164396,106215440,del,NA19404,0,,51044
1,43274693,43275997,del,HG00237,0,,1304
1,53355470,53357657,del,NA18487,0,,2187
1,207376034,207376552,del,HG00653,0,,518
1,190910593,190910775,del,HG00353,0,,182
1,230580074,230589465,del,NA19707,0,,9391
1,144839149,145379033,del,NA19914,0,,539884
1,227842469,227843057,del,NA18596,0,,588
1,2585479,2587266,del,NA18616,0,,1787
1,203907512,203921936,del,HG01048,0,,14424
1,84882972,84884737,del,NA19467,0,,1765
1,105667549,105668461,del,NA18953,0,,912
1,157018860,157019250,del,HG00171,0,,390
1,85262574,85263678,del,NA19783,0,,1104
1,170367385,170387190,del,NA18487,0,,19805
1,10195645,10196153,del,NA20765,0,,508
1,214471185,214473864,del,NA19834,0,,2679
1,192090892,192092025,del,HG00273,0,,1133
1,225673472,225673802,del,HG01137,0,,330
1,37816473,37816722,del,NA20811,0,,249
1,220502943,220503582,del,NA10847,0,,639
1,16185987,16192837,del,HG00654,0,,6850
1,75183597,75186011,del,HG00260,0,,2414
1,231980538,231981834,del,HG00513,0,,1296
1,158488408,158488675,del,HG01079,0,,267
1,11467195,11473365,del,HG01461,0,,6170
1,238527816,238530221,del,HG00369,0,,2405
1,6072194,6072560,del,NA19428,0,,366
1,49535074,49537575,del,NA19921,0,,2501
1,75471195,75483792,del,NA18592,0,,12597
1,179455594,179458296,del,HG00266,0,,2702
1,209854818,209856752,del,NA19074,0,,1934
1,2390843,2391002,del,NA18621,0,,159
1,18061840,18062931,del,NA18544,0,,1091
1,92892965,92901364,del,HG00335,0,,8399
1,47441038,47444370,del,NA19438,0,,3332
1,55927715,55929225,del,NA18953,0,,1510
1,229530890,229531933,del,HG00253,0,,1043
1,157173864,157175396,del,HG01378,0,,1532
1,1651159,1651941,del,NA19652,0,,782
1,222893452,222894027,del,NA18964,0,,575
1,111377666,111389272,del,NA18874,0,,11606
1,30167300,30979742,del,NA20798,0,,812442
1,191011315,191088360,del,NA12775,0,,77045
1,2367820,2367959,del,HG00479,0,,139
1,1183462,1183688,del,NA20126,0,,226
1,120012850,120013628,del,NA19114,0,,778
1,2024647,2027344,del,NA18953,0,,2697
1,173944737,173945067,del,HG00650,0,,330
1,189326009,189544422,del,HG00671,0,,218413
1,248839556,248840913,del,NA19311,0,,1357
1,190309825,190311762,del,HG00704,0,,1937
1,246373648,246447477,del,NA20541,0,,73829
1,66584565,66585285,del,NA19901,0,,720
1,247166396,247167032,del,HG00264,0,,636
1,101452494,101458367,del,NA18597,0,,5873
1,30961117,30961327,del,HG00261,0,,210
1,97403450,97416920,del,HG01079,0,,13470
1,199540954,199545772,del,NA12045,0,,4818
1,1911069,1911310,del,NA07051,0,,241
1,230227101,230228350,del,NA18605,0,,1249
1,200063819,200064810,del,HG00698,0,,991
1,16833382,16986017,del,HG01082,0,,152635
1,227444996,227449309,del,HG01107,0,,4313
1,106307476,106317948,del,NA19099,0,,10472
1,110187159,110191395,del,NA19404,0,,4236
1,31040644,31041659,del,NA19064,0,,1015
1,17676792,17677019,del,HG01101,0,,227
1,107488234,107488728,del,HG00635,0,,494
1,99044265,99044755,del,NA12748,0,,490
1,1223782,1225538,del,NA18853,0,,1756
1,161549117,161630949,del,NA19684,0,,81832
1,45257630,45259269,del,HG01365,0,,1639
1,178659651,178676239,del,NA19394,0,,16588
1,45021261,45022348,del,NA18942,0,,1087
1,84197943,84200602,del,HG00692,0,,2659
1,75136875,75136980,del,HG00479,0,,105
1,45870228,45871171,del,NA19359,0,,943
1,214707856,214708904,del,HG01082,0,,1048
1,87260864,87264101,del,NA19726,0,,3237
1,240122823,240123257,del,NA19685,0,,434
1,243070039,243082137,del,NA12058,0,,12098
1,248755669,248758483,del,NA19469,0,,2814
1,112692016,112706122,del,NA20502,0,,14106
1,207700347,207737459,del,NA19654,0,,37112
1,102674075,102678226,del,HG01197,0,,4151
1,63614636,63615960,del,NA19225,0,,1324
1,193999071,194000136,del,HG00403,0,,1065
1,247536758,247536953,del,HG00559,0,,195
1,145684357,145686931,del,NA18619,0,,2574
1,243127766,243129622,del,NA18557,0,,1856
1,71244098,71249596,del,NA11919,0,,5498
1,216231477,216232006,del,HG00149,0,,529
1,113715631,113715920,del,HG01170,0,,289
1,33898087,33899105,del,HG00118,0,,1018
1,41024158,41024344,del,NA18564,0,,186
1,245002401,245002802,del,NA18631,0,,401
1,52748276,52751862,del,HG00534,0,,3586
1,75534660,75539838,del,NA19437,0,,5178
1,41571562,41573208,del,NA19385,0,,1646
1,80796222,80796617,del,HG00342,0,,395
1,158489639,158491964,del,HG00180,0,,2325
1,241052437,241053633,del,NA19700,0,,1196
1,231319891,231321995,del,NA18870,0,,2104
1,203543570,203549135,del,HG01204,0,,5565
1,221804936,221805881,del,NA18505,0,,945
1,98698451,98705979,del,NA19313,0,,7528
1,5633688,5633986,del,NA12828,0,,298
1,245173062,245177842,del,NA19075,0,,4780
1,86994131,86994526,del,HG01052,0,,395
1,12853865,12919353,del,NA19197,0,,65488
1,9090088,9090675,del,NA19257,0,,587
1,197268850,197269737,del,NA18508,0,,887
1,83804720,83816109,del,HG00272,0,,11389
1,189853340,189854118,del,NA19701,0,,778
1,196777326,196902217,del,HG00258,0,,124891
1,191197533,191201029,del,HG01357,0,,3496
1,62082857,62083701,del,NA20528,0,,844
1,172389184,172396096,del,NA18615,0,,6912
1,147976516,147995822,del,HG00418,0,,19306
1,112074694,112074805,del,HG01251,0,,111
1,109819626,109821928,del,HG00577,0,,2302
1,237342472,237343487,del,NA19394,0,,1015
1,158813807,158823230,del,HG01125,0,,9423
1,242058825,242069429,del,HG00656,0,,10604
1,210706592,210706692,del,HG01366,0,,100
1,247354107,247361389,del,HG00554,0,,7282
1,42144091,42144419,del,NA18505,0,,328
1,83373504,83375064,del,HG00428,0,,1560
1,152278121,152282259,del,NA19755,0,,4138
1,4126018,4126760,del,HG00116,0,,742
1,198304653,198310278,del,HG00701,0,,5625
1,59059616,59059941,del,NA18953,0,,325
1,176507558,176508146,del,NA18579,0,,588
1,16867033,17001601,del,NA19463,0,,134568
1,108369434,108369987,del,NA18612,0,,553
1,16150338,16155538,del,HG01167,0,,5200
1,109609485,109619225,del,NA20785,0,,9740
1,176590628,176613320,del,NA18517,0,,22692
1,221379120,221382507,del,NA19716,0,,3387
1,21246359,21246520,del,HG00323,0,,161
1,152555542,152587740,del,HG00119,0,,32198
1,93187978,93193050,del,HG00577,0,,5072
1,18108502,18109751,del,NA19434,0,,1249
1,164940988,164943308,del,NA19373,0,,2320
1,109573231,109575180,del,HG01182,0,,1949
1,36548738,36552290,del,NA19080,0,,3552
1,89811417,89812282,del,HG01174,0,,865
1,221672230,221674719,del,NA18599,0,,2489
1,244619107,244621630,del,NA20532,0,,2523
1,2566195,2566623,del,NA20818,0,,428
1,202298092,202298384,del,NA19371,0,,292
1,30479740,30489368,del,NA20814,0,,9628
1,222479909,222481716,del,HG01365,0,,1807
1,167765323,167767596,del,HG00313,0,,2273
1,53417053,53419763,del,HG01174,0,,2710
1,9846654,9856699,del,HG00537,0,,10045
1,236282191,236291402,del,HG00154,0,,9211
1,159997324,160007663,del,NA19435,0,,10339
1,20643001,20643816,del,NA19380,0,,815
1,173963401,173968017,del,NA19102,0,,4616
1,4126156,4126878,del,HG00284,0,,722
1,106984649,106988319,del,NA19002,0,,3670
1,9870710,9873100,del,NA20810,0,,2390
1,37918975,37927758,del,NA20771,0,,8783
1,196763477,196888363,del,NA18634,0,,124886
1,187889955,187890147,del,NA18501,0,,192
1,99191815,99202872,del,NA18874,0,,11057
1,237273339,237279134,del,NA20589,0,,5795
1,232385559,232387775,del,NA19360,0,,2216
1,35349256,35350190,del,NA19982,0,,934
1,1583698,1646911,del,HG01354,0,,63213
1,175070941,175076980,del,HG00512,0,,6039
1,3209949,3212147,del,HG00427,0,,2198
1,173207591,173207879,del,HG01072,0,,288
1,187593643,187596895,del,NA19456,0,,3252
1,171861960,171862239,del,NA19377,0,,279
1,201555994,201559122,del,NA19064,0,,3128
1,55371389,55372169,del,NA18498,0,,780
1,53999368,54002649,del,NA19439,0,,3281
1,224815670,224818307,del,NA18961,0,,2637
1,158697260,158709450,del,NA19384,0,,12190
1,193531498,193534349,del,NA19430,0,,2851
1,103414735,103415059,del,NA18519,0,,324
1,210722452,210724880,del,NA18628,0,,2428
1,229120197,229120515,del,HG00125,0,,318
1,113338201,113341438,del,NA18597,0,,3237
1,30664336,30664461,del,HG01183,0,,125
1,113955947,113957978,del,NA11930,0,,2031
1,62259952,62263682,del,NA19777,0,,3730
1,213751962,213755579,del,HG00312,0,,3617
1,24804516,24809322,del,HG00422,0,,4806
1,9594216,9597522,del,NA19371,0,,3306
1,221325135,221326349,del,HG01174,0,,1214
1,99973667,99974138,del,HG00525,0,,471
1,43694061,43695543,del,HG00543,0,,1482
1,79897744,79898209,del,NA19119,0,,465
1,87028211,87039286,del,NA20761,0,,11075
1,49277609,49287594,del,NA20778,0,,9985
1,175411527,175412142,del,NA19920,0,,615
1,168554009,168554157,del,NA18944,0,,148
1,16834562,16836315,del,NA19773,0,,1753
1,15089657,15091690,del,NA18536,0,,2033
1,84126184,84127091,del,NA18520,0,,907
1,29304451,29306209,del,NA18858,0,,1758
1,44370788,44371641,del,NA19317,0,,853
1,912066,914822,del,NA18593,0,,2756
1,47207992,47210659,del,HG00312,0,,2667
1,235298399,235298583,del,NA19385,0,,184
1,63461765,63462114,del,NA19116,0,,349
1,109367019,109371959,del,NA19085,0,,4940
1,241732562,241744264,del,HG00247,0,,11702
1,91914097,91914562,del,NA19746,0,,465
1,95522259,95525936,del,NA19070,0,,3677
1,11988649,11993407,del,HG00683,0,,4758
1,206792779,206793749,del,NA18871,0,,970
1,113504945,113505149,del,NA19443,0,,204
1,161590401,161597949,del,NA18596,0,,7548
1,175072016,175076322,del,HG00335,0,,4306
1,194350508,194351272,del,HG00319,0,,764
1,88189348,88194901,del,NA18632,0,,5553
1,77909409,77911422,del,NA19725,0,,2013
1,2919031,2919366,del,HG01188,0,,335
1,192207158,192220717,del,NA18543,0,,13559
1,102288363,102289577,del,NA20509,0,,1214
1,26460095,26464769,del,NA19116,0,,4674
1,47348208,47364121,del,HG00651,0,,15913
1,144949062,144949391,del,NA18499,0,,329
1,8976892,8978092,del,HG01108,0,,1200
1,36585980,36587199,del,NA19138,0,,1219
1,224661504,224662301,del,NA19058,0,,797
1,12166052,12168783,del,HG00136,0,,2731
1,150383886,150384216,del,HG01079,0,,330
1,24804536,24807440,del,NA12748,0,,2904
1,156366318,156368905,del,NA18573,0,,2587
1,7803173,7804451,del,HG01170,0,,1278
1,229561439,229561527,del,HG00271,0,,88
1,206199886,206205897,del,NA20322,0,,6011
1,32404344,32411575,del,NA20532,0,,7231
1,83293549,83294461,del,HG00537,0,,912
1,186198881,186205699,del,HG00249,0,,6818
1,26148939,26149265,del,NA19397,0,,326
1,70716396,70720250,del,NA19429,0,,3854
1,28906067,28906414,del,NA19704,0,,347
1,26274122,26274354,del,NA20790,0,,232
1,160792281,160792491,del,HG01101,0,,210
1,66473793,66475790,del,NA11829,0,,1997
1,38208245,38208408,del,NA18947,0,,163
1,152278876,152279848,del,NA19712,0,,972
1,27804112,27804441,del,NA18990,0,,329
1,84056667,84057332,del,NA20507,0,,665
1,111521700,111522128,del,NA19446,0,,428
1,212471135,212472616,del,HG00614,0,,1481
1,238083546,238086053,del,HG00701,0,,2507
1,36624193,36632048,del,HG01067,0,,7855
1,16150597,16156385,del,NA20535,0,,5788
1,51608581,51609341,del,HG01389,0,,760
1,168784315,168784503,del,HG01101,0,,188
1,185416351,185418601,del,HG00740,0,,2250
1,81193350,81194546,del,HG00640,0,,1196
1,152495471,152497762,del,NA19921,0,,2291
1,142925772,143502328,del,NA18574,0,,576556
1,88285840,88286001,del,NA18522,0,,161
1,10067279,10068637,del,NA19835,0,,1358
1,15657403,15659444,del,NA19703,0,,2041
1,101684511,101688098,del,NA19380,0,,3587
1,190368407,190370919,del,NA19428,0,,2512
1,153215806,153217059,del,NA19468,0,,1253
1,199564015,199566641,del,NA07037,0,,2626
1,39596335,39597314,del,NA19660,0,,979
1,21684972,21687314,del,HG00501,0,,2342
1,48352567,48353259,del,NA18956,0,,692
1,146818896,146931387,del,HG00732,0,,112491
1,2891195,2891328,del,NA19371,0,,133
1,102587311,102589606,del,NA19451,0,,2295
1,242185410,242188505,del,NA18543,0,,3095
1,239659113,239663623,del,HG01055,0,,4510
1,120163512,120163594,del,NA18916,0,,82
1,240392999,240394782,del,NA18510,0,,1783
1,27287667,27288062,del,NA19900,0,,395
1,27502071,27515638,del,NA19726,0,,13567
1,232836575,232836759,del,NA11995,0,,184
1,210601359,210614183,del,NA20356,0,,12824
1,230132638,230133889,del,HG00581,0,,1251
1,9440121,9440363,del,NA18504,0,,242
1,72460002,72461973,del,NA18631,0,,1971
1,28458027,28458366,del,HG00732,0,,339
1,210078055,210085977,del,NA19332,0,,7922
1,4580881,4580999,del,HG00619,0,,118
1,33049926,33056997,del,NA18912,0,,7071
1,35030916,35037522,del,NA18576,0,,6606
1,5350910,5351276,del,NA19749,0,,366
1,10096026,10103710,del,HG00139,0,,7684
1,242194397,242197544,del,HG00701,0,,3147
1,74312431,74312682,del,HG00448,0,,251
1,238483826,238486627,del,NA19347,0,,2801
1,6072566,6072422,del,HG00315,0,,-144
1,43137006,43138452,del,NA19093,0,,1446
1,65412677,65413700,del,HG00708,0,,1023
1,246187373,246190873,del,NA18555,0,,3500
1,207322006,207347292,del,NA19428,0,,25286
1,26961278,26963544,del,NA19916,0,,2266
1,152555542,152587742,del,NA11893,0,,32200
1,189385816,189398172,del,NA18597,0,,12356
1,145444474,145447394,del,NA19776,0,,2920
1,27935377,27935497,del,HG00338,0,,120
1,26094147,26094482,del,NA19010,0,,335
1,36642416,36644822,del,HG00704,0,,2406
1,82963291,82963615,del,NA20528,0,,324
1,213440177,213441577,del,HG00280,0,,1400
1,113799628,113800090,del,HG00692,0,,462
1,84314476,84318960,del,HG00280,0,,4484
1,101695345,101697780,del,NA19087,0,,2435
1,142619562,142625529,del,NA18572,0,,5967
1,24106738,24108455,del,NA19466,0,,1717
1,53594099,53595603,del,NA12383,0,,1504
1,196733616,196813672,del,NA19431,0,,80056
1,231869288,231869408,del,HG00325,0,,120
1,16376516,16386257,del,NA12155,0,,9741
1,71487175,71489773,del,NA18520,0,,2598
1,53595125,53595603,del,HG00739,0,,478
1,21894472,21896283,del,HG00566,0,,1811
1,66475305,66476366,del,NA18940,0,,1061
1,101215185,101218052,del,NA19720,0,,2867
1,213002368,213013665,del,NA18973,0,,11297
1,242122508,242124687,del,NA18536,0,,2179
1,171423148,171424930,del,NA19172,0,,1782
1,206696516,206698622,del,NA19761,0,,2106
1,95628133,95680318,del,HG01174,0,,52185
1,182083809,182087598,del,HG00188,0,,3789
1,114813956,114817704,del,NA18487,0,,3748
1,48057367,48057457,del,HG01125,0,,90
1,159066085,159068278,del,HG00337,0,,2193
1,168024559,168025732,del,NA18549,0,,1173
1,227143088,227144765,del,HG00525,0,,1677
1,53116165,53116716,del,NA18636,0,,551
1,105091224,105092720,del,NA19437,0,,1496
1,206236332,206237036,del,HG00613,0,,704
1,22303664,22328299,del,HG00360,0,,24635
1,110223216,110244922,del,NA18516,0,,21706
1,246658392,246661733,del,NA18626,0,,3341
1,3501678,3502157,del,NA18956,0,,479
1,188539454,188540229,del,NA20798,0,,775
1,2609210,2626391,del,HG00313,0,,17181
1,160846848,160851381,del,NA19372,0,,4533
1,189530194,189530762,del,NA19398,0,,568
1,15557812,15558556,del,NA19435,0,,744
1,189785852,189787546,del,HG01140,0,,1694
1,209759564,209761259,del,HG00275,0,,1695
1,7645754,7648432,del,NA19374,0,,2678
1,81949556,81951452,del,NA19313,0,,1896
1,160954836,160955151,del,NA07347,0,,315
1,24520347,24523686,del,NA19726,0,,3339
1,16129582,16131430,del,NA19004,0,,1848
1,48032638,48037543,del,HG00334,0,,4905
1,242114948,242115342,del,HG00690,0,,394
1,62622966,62624472,del,HG01492,0,,1506
1,105898535,105900718,del,HG00683,0,,2183
1,21346335,21346941,del,NA19374,0,,606
1,238852307,238853250,del,HG00731,0,,943
1,196877816,196885272,del,NA18634,0,,7456
1,207542216,207545422,del,HG01390,0,,3206
1,196772816,196794122,del,HG01191,0,,21306
1,15920646,15937255,del,NA19834,0,,16609
1,12053139,12053367,del,NA18530,0,,228
1,11412772,11416694,del,HG00151,0,,3922
1,187464828,187466729,del,NA19725,0,,1901
1,247231003,247232739,del,NA19457,0,,1736
1,22904316,22905283,del,NA20769,0,,967
1,192675031,192683629,del,NA19462,0,,8598
1,24223616,24224201,del,HG00418,0,,585
1,248866181,248866417,del,NA07357,0,,236
1,152414963,152418983,del,NA18550,0,,4020
1,154205986,154206412,del,NA19359,0,,426
1,68594525,68594723,del,NA18562,0,,198
1,11037099,11038109,del,HG00159,0,,1010
1,192860400,192861925,del,NA19703,0,,1525
1,249089599,249093354,del,NA19240,0,,3755
1,240838631,240839228,del,NA20792,0,,597
1,4436053,4436357,del,HG01375,0,,304
1,29227581,29227903,del,HG00704,0,,322
1,8182406,8190875,del,NA19107,0,,8469
1,172918527,172923669,del,HG00581,0,,5142
1,236584106,236584862,del,NA20807,0,,756
1,71163761,71167943,del,HG01073,0,,4182
1,4488122,4488222,del,NA18951,0,,100
1,185492520,185494543,del,NA19445,0,,2023
1,8247755,8250065,del,NA19471,0,,2310
1,109625797,109629766,del,HG01167,0,,3969
1,72518869,72546470,del,HG00611,0,,27601
1,147807391,147810477,del,NA20332,0,,3086
1,245636858,245647964,del,NA12058,0,,11106
1,62276435,62285669,del,HG00327,0,,9234
1,106173509,106173628,del,HG00657,0,,119
1,66263909,66264242,del,NA18526,0,,333
1,102325346,102326934,del,HG00189,0,,1588
1,29263972,29265071,del,NA18552,0,,1099
1,248154553,248155593,del,NA19067,0,,1040
1,246877789,246878023,del,NA19360,0,,234
1,177114956,177117573,del,NA19393,0,,2617
1,161003413,161006788,del,NA18538,0,,3375
1,229411560,229413799,del,HG01204,0,,2239
1,80219642,80221267,del,NA19383,0,,1625
1,220436373,220440885,del,HG00533,0,,4512
1,245217662,245219621,del,NA19236,0,,1959
1,208643552,208643754,del,NA20759,0,,202
1,104451498,104451652,del,NA19451,0,,154
1,154728353,154728604,del,NA18924,0,,251
1,247186231,247187121,del,NA19395,0,,890
1,225666377,225667658,del,HG00448,0,,1281
1,204381708,204384657,del,NA19334,0,,2949
1,6436220,6444219,del,NA12342,0,,7999
1,222374166,222382722,del,HG01140,0,,8556
1,196733816,196822322,del,NA06994,0,,88506
1,79238172,79256647,del,HG00619,0,,18475
1,113338015,113341369,del,NA18597,0,,3354
1,226197074,226200041,del,NA18622,0,,2967
1,53025313,53027201,del,HG01176,0,,1888
1,180272408,180273938,del,HG01173,0,,1530
1,55014043,55015448,del,NA18988,0,,1405
1,246373587,246447398,del,NA20541,0,,73811
1,21728826,21729107,del,NA18853,0,,281
1,4284606,4285948,del,NA19240,0,,1342
1,5644646,5645443,del,NA19380,0,,797
1,105255084,105256188,del,NA18976,0,,1104
1,202427247,202427535,del,HG00657,0,,288
1,248867187,248876093,del,NA20291,0,,8906
1,175236917,175239298,del,NA11932,0,,2381
1,40693890,40694187,del,HG00625,0,,297
1,14735785,14742259,del,NA18541,0,,6474
1,189716481,189717040,del,NA19383,0,,559
1,69246645,69266870,del,HG00118,0,,20225
1,225300831,225301044,del,HG00663,0,,213
1,101722734,101724028,del,HG01390,0,,1294
1,190052657,190053879,del,NA19207,0,,1222
1,39032421,39040355,del,HG01440,0,,7934
1,78564344,78565591,del,HG01061,0,,1247
1,98037938,98042633,del,NA19093,0,,4695
1,23677158,23680487,del,NA19921,0,,3329
1,40441768,40442030,del,HG00263,0,,262
1,241908722,241908988,del,NA18909,0,,266
1,191657149,191661068,del,HG00271,0,,3919
1,235603396,235609568,del,NA18612,0,,6172
1,62654737,62657155,del,HG00268,0,,2418
1,73813675,73815108,del,NA19079,0,,1433
1,180683752,180685436,del,NA19473,0,,1684
1,23595466,23595862,del,NA19102,0,,396
1,111376881,111388874,del,HG00306,0,,11993
1,40712445,40712796,del,NA19703,0,,351
1,31547341,31550766,del,NA18565,0,,3425
1,217696039,217697627,del,NA19189,0,,1588
1,204381851,204384657,del,NA19429,0,,2806
1,20286644,20288517,del,NA18984,0,,1873
1,2162155,2163096,del,NA18910,0,,941
1,69074015,69074969,del,NA07347,0,,954
1,1142719,1143140,del,NA12155,0,,421
1,152053195,152054119,del,NA18856,0,,924
1,20498766,20500516,del,NA18505,0,,1750
1,216373818,216377489,del,HG00251,0,,3671
1,45618097,45623380,del,HG00245,0,,5283
1,215858186,215862440,del,HG00264,0,,4254
1,32551060,32552897,del,HG01073,0,,1837
1,146660693,146669585,del,NA19819,0,,8892
1,19656618,19661193,del,HG01359,0,,4575
1,93236028,93237834,del,HG00326,0,,1806
1,11990216,11995272,del,HG00277,0,,5056
1,169320192,169327840,del,HG00116,0,,7648
1,53933587,53933920,del,NA12155,0,,333
1,28551345,28554060,del,HG00173,0,,2715
1,158712031,158712353,del,NA11992,0,,322
1,213039226,213039395,del,NA11830,0,,169
1,111221189,111229085,del,HG00654,0,,7896
1,166575224,166579889,del,NA19385,0,,4665
1,151423643,151426016,del,HG01462,0,,2373
1,5028137,5056274,del,NA19473,0,,28137
1,111264925,111265078,del,HG00236,0,,153
1,20497189,20497737,del,NA19444,0,,548
1,191826501,191868474,del,NA19119,0,,41973
1,193465818,193466719,del,NA19360,0,,901
1,213082016,213088122,del,HG00737,0,,6106
1,5727745,5727896,del,NA18557,0,,151
1,200258970,200259149,del,NA18613,0,,179
1,2591532,2615457,del,HG00635,0,,23925
1,17075259,17232790,del,NA19057,0,,157531
1,30173006,30173965,del,NA20510,0,,959
1,118983754,118986171,del,HG00614,0,,2417
1,68375933,68376762,del,NA18956,0,,829
1,90169020,90174189,del,NA19435,0,,5169
1,963871,964481,del,NA19077,0,,610
1,213081126,213081979,del,NA18560,0,,853
1,225133646,225248670,del,NA20760,0,,115024
1,169226016,169242722,del,NA11919,0,,16706
1,92579198,92585021,del,HG01048,0,,5823
1,57384817,57385647,del,NA18550,0,,830
1,17009575,17012639,del,HG01061,0,,3064
1,198003606,198007016,del,HG01070,0,,3410
1,4123916,4127522,del,HG01519,0,,3606
1,244287438,244287913,del,NA19901,0,,475
1,107777565,107777963,del,HG00185,0,,398
1,16751156,16755118,del,NA18596,0,,3962
1,184961428,184970735,del,NA19453,0,,9307
1,168339923,168343672,del,NA07357,0,,3749
1,78327546,78327852,del,NA20296,0,,306
1,232852426,232852723,del,HG00689,0,,297
1,217917511,217917824,del,HG00473,0,,313
1,243440588,243445638,del,HG00556,0,,5050
1,16354481,16376278,del,NA20533,0,,21797
1,184379726,184384901,del,HG01488,0,,5175
1,230531139,230531558,del,NA18964,0,,419
1,9134123,9136941,del,NA11919,0,,2818
1,115445072,115445435,del,NA18519,0,,363
1,60048636,60049661,del,HG01060,0,,1025
1,188759424,188765223,del,HG00369,0,,5799
1,185009801,185011733,del,NA19235,0,,1932
1,232458590,232460251,del,NA18486,0,,1661
1,44370454,44370605,del,NA20755,0,,151
1,30144422,30149119,del,HG00704,0,,4697
1,49605766,49606991,del,HG01353,0,,1225
1,73539166,73729671,del,HG01052,0,,190505
1,8447365,8475544,del,NA19676,0,,28179
1,16019673,16022120,del,HG00595,0,,2447
1,17642027,17642920,del,NA19713,0,,893
1,160694241,160694590,del,NA18870,0,,349
1,55363915,55369200,del,NA18498,0,,5285
1,24367369,24367790,del,NA19318,0,,421
1,16429702,16435186,del,NA19434,0,,5484
1,243782745,243783763,del,HG00309,0,,1018
1,218082663,218082897,del,HG00346,0,,234
1,227054891,227056180,del,NA20581,0,,1289
1,80192710,80323970,del,NA20771,0,,131260
1,21757337,21760111,del,NA19676,0,,2774
1,1495614,1495807,del,NA18973,0,,193
1,108733325,108735803,del,NA18563,0,,2478
1,248327688,248328227,del,HG01073,0,,539
1,98973830,98975220,del,NA11994,0,,1390
1,32874178,32875606,del,NA19472,0,,1428
1,246301129,246480450,del,NA19435,0,,179321
1,241519316,241521222,del,HG00524,0,,1906
1,60046724,60050636,del,NA19648,0,,3912
1,105038769,105042679,del,NA19397,0,,3910
1,229816955,229829778,del,NA12004,0,,12823
1,178977404,178979698,del,HG00114,0,,2294
1,99003646,99007853,del,HG00428,0,,4207
1,40285167,40287240,del,NA18988,0,,2073
1,39277189,39277843,del,NA19468,0,,654
1,16749866,16756472,del,HG00501,0,,6606
1,108402971,108405484,del,NA19472,0,,2513
1,243425355,243425651,del,HG00344,0,,296
1,173078094,173079816,del,NA20520,0,,1722
1,211655430,211656718,del,NA19474,0,,1288
1,31113480,31116605,del,NA20522,0,,3125
1,111013731,111014892,del,HG00581,0,,1161
1,182924243,182926581,del,HG01488,0,,2338
1,112341934,112359532,del,HG00626,0,,17598
1,226197005,226201747,del,HG00672,0,,4742
1,142794595,142794819,del,NA19360,0,,224
1,119482198,119483619,del,NA19470,0,,1421
1,31720005,31722524,del,HG00595,0,,2519
1,156672097,156672710,del,HG00335,0,,613
1,207714013,207882185,del,NA12058,0,,168172
1,190337916,190443022,del,NA19819,0,,105106
1,86400851,86404538,del,HG00260,0,,3687
1,55300995,55305553,del,NA19108,0,,4558
1,212290745,212290939,del,NA19707,0,,194
1,12907342,13183072,del,HG01067,0,,275730
1,218417913,218421598,del,NA19455,0,,3685
1,21344118,21344885,del,NA19463,0,,767
1,16366654,16389166,del,HG00740,0,,22512
1,9171861,9176267,del,NA18983,0,,4406
1,30435742,30436238,del,HG00635,0,,496
1,60413472,60414784,del,NA20786,0,,1312
1,211285072,211285349,del,HG00524,0,,277
1,218182516,218189622,del,NA19372,0,,7106
1,45021330,45022396,del,NA19334,0,,1066
1,213616229,213617376,del,HG00245,0,,1147
1,247653757,247655202,del,NA19058,0,,1445
1,24787797,24788122,del,NA19129,0,,325
1,50021184,50029419,del,HG00245,0,,8235
1,117593407,117594944,del,HG00596,0,,1537
1,213312442,213320220,del,NA19625,0,,7778
1,101119945,101122363,del,NA18858,0,,2418
1,120115992,120153500,del,HG00705,0,,37508
1,156491962,156495741,del,HG00334,0,,3779
1,5163671,5165084,del,HG00692,0,,1413
1,246029283,246037421,del,NA18550,0,,8138
1,78833897,78835838,del,NA19210,0,,1941
1,5364059,5364212,del,NA18530,0,,153
1,247296940,247301621,del,NA18564,0,,4681
1,111951042,111952228,del,NA20786,0,,1186
1,163509722,163519380,del,NA18603,0,,9658
1,240756209,240756724,del,NA18909,0,,515
1,206814682,206815659,del,NA20790,0,,977
1,13178772,13187516,del,NA19093,0,,8744
1,60487926,60488457,del,NA18615,0,,531
1,30738620,30739931,del,NA12716,0,,1311
1,26961316,26964022,del,HG00596,0,,2706
1,32448817,32452053,del,HG00449,0,,3236
1,12822373,12822586,del,NA18544,0,,213
1,87523400,87524608,del,NA19107,0,,1208
1,187168821,187170414,del,HG00418,0,,1593
1,24895660,24900785,del,NA18505,0,,5125
1,78649163,78654154,del,NA19440,0,,4991
1,174419107,174419912,del,NA19449,0,,805
1,58647362,58649127,del,NA19403,0,,1765
1,154993342,154994386,del,NA19461,0,,1044
1,104746698,104751068,del,NA18612,0,,4370
1,113611322,113613777,del,NA18941,0,,2455
1,94288372,94291256,del,NA19657,0,,2884
1,3063088,3063247,del,NA19470,0,,159
1,4364633,4366698,del,HG00543,0,,2065
1,109571416,109575022,del,NA12341,0,,3606
1,100390694,100390710,del,HG00422,0,,16
1,28900662,28902408,del,HG00701,0,,1746
1,77774503,77781589,del,NA18523,0,,7086
1,177759172,177759902,del,NA18498,0,,730
1,203887266,203889222,del,NA19130,0,,1956
1,191915437,191920112,del,NA19451,0,,4675
1,211000601,211012817,del,NA19189,0,,12216
1,38906514,38908020,del,HG00737,0,,1506
1,24895743,24900868,del,NA19704,0,,5125
1,110223316,110244622,del,HG00252,0,,21306
1,2812730,2813150,del,NA18522,0,,420
1,24256916,24319522,del,HG01048,0,,62606
1,66624448,66631306,del,NA19396,0,,6858
1,64446625,64448002,del,HG00473,0,,1377
1,72755692,72764074,del,NA11892,0,,8382
1,9975694,9980110,del,HG00607,0,,4416
1,207841062,207845814,del,NA19379,0,,4752
1,221113784,221118698,del,NA18605,0,,4914
1,244892725,244900216,del,NA19382,0,,7491
1,106135161,106137374,del,HG00266,0,,2213
1,90136842,90137019,del,NA18520,0,,177
1,220285454,220285774,del,NA06989,0,,320
1,229466962,229468082,del,NA18511,0,,1120
1,175122616,175122844,del,NA19197,0,,228
1,189087084,189093566,del,NA18912,0,,6482
1,36818427,36819512,del,HG01354,0,,1085
1,3716953,3717153,del,NA19375,0,,200
1,196737125,196821817,del,NA19390,0,,84692
1,8283410,8284760,del,HG01171,0,,1350
1,65443324,65871481,del,NA12340,0,,428157
1,15326670,15327478,del,NA19108,0,,808
1,245768428,245769769,del,HG00171,0,,1341
1,89359400,89360778,del,NA18608,0,,1378
1,55342312,55343236,del,NA19332,0,,924
1,213082016,213086122,del,HG00684,0,,4106
1,114039827,114045877,del,NA19056,0,,6050
1,87218387,87231222,del,NA19060,0,,12835
1,52094458,52096158,del,HG01377,0,,1700
1,244034200,244034676,del,NA18543,0,,476
1,77384716,77442920,del,NA18534,0,,58204
1,180749768,180755393,del,NA20535,0,,5625
1,149891680,149892021,del,NA20786,0,,341
1,160935055,160939688,del,HG01079,0,,4633
1,201659219,201659498,del,NA18544,0,,279
1,158492324,158497839,del,NA20282,0,,5515
1,72755344,72755492,del,HG00253,0,,148
1,166464533,166471243,del,HG01048,0,,6710
1,79928825,79929145,del,NA06986,0,,320
1,196956421,196976912,del,NA19908,0,,20491
1,13883505,13884455,del,NA19440,0,,950
1,51102540,51103586,del,HG00635,0,,1046
1,59166855,59167669,del,NA12399,0,,814
1,191916166,191918422,del,NA19207,0,,2256
1,46243606,46251822,del,NA19248,0,,8216
1,25201821,25203635,del,NA19436,0,,1814
1,6167746,6168530,del,HG00476,0,,784
1,35515603,35516299,del,NA19438,0,,696
1,17840390,17844226,del,NA18637,0,,3836
1,153673406,153674383,del,NA18923,0,,977
1,107896819,107899351,del,NA18960,0,,2532
1,182952006,182952307,del,HG01047,0,,301
1,53594516,53596372,del,HG00657,0,,1856
1,2371985,2374312,del,NA18574,0,,2327
1,42838140,42839572,del,NA19087,0,,1432
1,147854416,147861622,del,NA11894,0,,7206
1,16146192,16148782,del,NA18617,0,,2590
1,147832316,147913222,del,NA20798,0,,80906
1,95129011,95155034,del,NA18908,0,,26023
1,80794928,80796678,del,HG00443,0,,1750
1,43384704,43385084,del,NA18974,0,,380
1,169144207,169148086,del,NA19471,0,,3879
1,158867530,158869981,del,NA18973,0,,2451
1,13693316,13773922,del,NA20504,0,,80606
1,1598413,1598580,del,NA18499,0,,167
1,169159416,169159872,del,HG00704,0,,456
1,239071158,239082621,del,NA18550,0,,11463
1,171434153,171434447,del,NA18498,0,,294
1,228431321,228431930,del,NA18501,0,,609
1,14619221,14622441,del,NA19445,0,,3220
1,79115029,79121581,del,NA19835,0,,6552
1,187716104,187722532,del,NA12282,0,,6428
1,245359927,245361464,del,HG00421,0,,1537
1,16809863,16811594,del,NA18520,0,,1731
1,31575085,31577211,del,NA12413,0,,2126
1,196631026,196633113,del,NA19704,0,,2087
1,108733325,108737268,del,NA18618,0,,3943
1,1522874,1524670,del,NA19338,0,,1796
1,243660659,243661180,del,NA19712,0,,521
1,241691690,241692052,del,HG01353,0,,362
1,189416398,189436852,del,NA19921,0,,20454
1,16363969,16387210,del,NA18623,0,,23241
1,14437549,14437666,del,HG00543,0,,117
1,120084102,120087172,del,NA20828,0,,3070
1,191006812,191010233,del,HG01108,0,,3421
1,168178265,168180241,del,HG01149,0,,1976
1,84832968,84834042,del,NA19682,0,,1074
1,9288634,9290828,del,NA07037,0,,2194
1,22904970,22905856,del,NA12546,0,,886
1,112204160,112206733,del,NA20805,0,,2573
1,30758914,31134878,del,NA11843,0,,375964
1,67321661,67324297,del,NA19312,0,,2636
1,230636582,230638580,del,NA19435,0,,1998
1,182289324,182289636,del,NA18965,0,,312
1,222373666,222380872,del,NA19317,0,,7206
1,197229895,197233820,del,NA20588,0,,3925
1,164176123,164176334,del,HG00282,0,,211
1,78884412,78889987,del,NA18984,0,,5575
1,32011912,32012061,del,HG00246,0,,149
1,149891545,149892021,del,HG00284,0,,476
1,178892100,178896884,del,HG01342,0,,4784
1,105832822,105844370,del,HG00566,0,,11548
1,104809600,104809958,del,NA18507,0,,358
1,27979651,27980508,del,NA19360,0,,857
1,21822953,21828057,del,HG00174,0,,5104
1,227452053,227452344,del,NA19257,0,,291
1,119998639,120034563,del,NA20812,0,,35924
1,156207426,156207747,del,NA20340,0,,321
1,3666666,3668383,del,NA19390,0,,1717
1,177509035,177560074,del,NA19079,0,,51039
1,231568657,231581722,del,HG00690,0,,13065
1,195013809,195019758,del,NA18953,0,,5949
1,116831424,116836073,del,NA19321,0,,4649
1,1223581,1225526,del,HG01342,0,,1945
1,25591316,25662422,del,HG01521,0,,71106
1,194936129,194946169,del,NA19457,0,,10040
1,86680816,86684822,del,NA20801,0,,4006
1,203165467,203166729,del,NA19355,0,,1262
1,25614416,25648422,del,HG00181,0,,34006
1,179607281,179608059,del,NA11931,0,,778
1,56130216,56134322,del,HG00512,0,,4106
1,5403452,5404634,del,NA19703,0,,1182
1,60940875,60941391,del,NA19471,0,,516
1,166380883,166463239,del,HG00149,0,,82356
1,49066353,49067868,del,HG00577,0,,1515
1,164748428,164751193,del,HG01069,0,,2765
1,22086827,22087188,del,NA19311,0,,361
1,6438169,6445895,del,NA19914,0,,7726
1,23596104,23597377,del,HG00442,0,,1273
1,28472036,28475736,del,NA19009,0,,3700
1,215029213,215029977,del,NA18853,0,,764
1,165322916,165326322,del,HG00692,0,,3406
1,148002074,148249382,del,NA19435,0,,247308
1,222374316,222381022,del,NA18934,0,,6706
1,207488983,207489176,del,NA19055,0,,193
1,221258481,221264175,del,NA19347,0,,5694
1,44009362,44009909,del,NA18912,0,,547
1,47623426,47625580,del,NA18982,0,,2154
1,12898662,13013306,del,NA19661,0,,114644
1,214770103,214770439,del,NA20795,0,,336
1,181418238,181426277,del,HG00557,0,,8039
1,166374710,166382377,del,NA18868,0,,7667
1,45021177,45022262,del,NA19084,0,,1085
1,169004358,169005229,del,HG00155,0,,871
1,181360279,181361758,del,NA18577,0,,1479
1,205106124,205108236,del,NA19457,0,,2112
1,149961621,149963491,del,HG00422,0,,1870
1,40966772,40970571,del,HG00684,0,,3799
1,228824985,228826365,del,NA19434,0,,1380
1,6458636,6459610,del,NA19331,0,,974
1,153492605,153499850,del,NA19818,0,,7245
1,231303065,231303371,del,NA18873,0,,306
1,239428126,239433452,del,NA18989,0,,5326
1,53949369,53949674,del,NA19681,0,,305
1,105218644,105219462,del,NA19131,0,,818
1,200980879,200985481,del,NA20536,0,,4602
1,183414774,183415284,del,NA20522,0,,510
1,247621763,247621939,del,HG00253,0,,176
1,44630333,44630448,del,HG01350,0,,115
1,80115001,80117281,del,NA19312,0,,2280
1,157033425,157036355,del,NA19102,0,,2930
1,99533415,99536579,del,HG01441,0,,3164
1,47193542,47198091,del,NA19701,0,,4549
1,7975392,7978304,del,HG00159,0,,2912
1,203790442,203793330,del,NA18550,0,,2888
1,160434473,160437473,del,NA19704,0,,3000
1,61671265,61674252,del,NA19189,0,,2987
1,16814625,16963224,del,NA18528,0,,148599
1,16001536,16009767,del,HG01357,0,,8231
1,186551940,186553861,del,NA12044,0,,1921
1,6360584,6360699,del,NA19065,0,,115
1,226612687,226612895,del,NA19116,0,,208
1,54244676,54247476,del,NA19466,0,,2800
1,205249997,205252283,del,NA19779,0,,2286
1,44370505,44370709,del,HG01495,0,,204
1,173072056,173076172,del,NA19236,0,,4116
1,221608160,221609462,del,NA18622,0,,1302
1,15365338,15365503,del,HG01070,0,,165
1,107759244,107763143,del,NA19359,0,,3899
1,668630,850204,dup,HG00306,0,,181574
1,713044,755966,dup,HG01444,0,,42922
1,773090,852664,dup,HG00743,0,,79574
1,963826,974172,dup,HG00130,0,,10346
1,1171539,1179729,dup,HG00341,0,,8190
1,1249799,1265722,dup,HG01631,0,,15923
1,1304952,1323528,dup,HG02401,0,,18576
1,1393861,1427383,dup,HG00109,0,,33522
1,1595368,1612441,dup,HG00320,0,,17073
1,1609210,1615827,dup,HG01441,0,,6617
1,1627805,1673809,dup,HG00121,0,,46004
1,2028833,2052740,dup,HG00610,0,,23907
1,2374226,2379823,dup,HG00130,0,,5597
1,2397655,2401469,dup,HG00097,0,,3814
1,2684305,2719507,dup,HG01063,0,,35202
1,2847963,2898365,dup,HG01063,0,,50402
1,2920631,3005757,dup,HG01063,0,,85126
1,2937832,2979482,dup,HG01063,0,,41650
1,3009447,3137148,dup,HG01063,0,,127701
1,3144724,3209782,dup,HG01063,0,,65058
1,3502139,4320143,dup,HG02481,0,,818004
1,3527608,3553912,dup,NA20872,0,,26304
1,3527725,3603484,dup,NA20872,0,,75759
1,3672777,3685462,dup,NA19355,0,,12685
1,3698222,3711516,dup,HG00610,0,,13294
1,3734485,3844788,dup,HG02481,0,,110303
1,3995323,4001974,dup,HG01191,0,,6651
1,4000527,4147217,dup,HG02481,0,,146690
1,4005849,4114592,dup,HG02481,0,,108743
1,4197459,4220364,dup,HG00704,0,,22905
1,4263601,4353020,dup,HG02481,0,,89419
1,4327442,4349182,dup,HG02481,0,,21740
1,4526142,4531352,dup,HG02505,0,,5210
1,6796042,6803582,dup,HG01776,0,,7540
1,7481066,7503506,dup,HG03615,0,,22440
1,7921468,7952768,dup,NA18941,0,,31300
1,8164787,8186286,dup,NA20882,0,,21499
1,8166041,8207035,dup,NA20882,0,,40994
1,8200707,8211256,dup,HG00096,0,,10549
1,8896797,8908252,dup,HG00437,0,,11455
1,9105430,9109497,dup,HG00105,0,,4067
1,9320144,9403779,dup,HG00257,0,,83635
1,9403667,9411371,dup,NA18544,0,,7704
1,9579979,9583367,dup,HG00259,0,,3388
1,9730089,9752220,dup,HG01867,0,,22131
1,11449834,11536217,dup,HG01162,0,,86383
1,12856327,12893193,dup,HG00120,0,,36866
1,12901370,12921250,dup,HG00100,0,,19880
1,13176833,13182837,dup,HG00118,0,,6004
1,13182563,13196202,dup,HG00118,0,,13639
1,14240342,14255075,dup,HG02395,0,,14733
1,14311598,14371354,dup,HG03130,0,,59756
1,14312976,14373032,dup,HG03130,0,,60056
1,14315459,14370772,dup,HG03130,0,,55313
1,14378346,14435580,dup,NA18618,0,,57234
1,14454385,14465055,dup,NA19308,0,,10670
1,14713511,14743602,dup,NA18618,0,,30091
1,15397849,15412264,dup,HG00732,0,,14415
1,15724685,15754306,dup,HG00590,0,,29621
1,16013837,16080976,dup,HG02690,0,,67139
1,16037975,16071850,dup,HG02690,0,,33875
1,16311970,16330082,dup,HG03792,0,,18112
1,16346751,16367787,dup,HG01063,0,,21036
1,16370620,16381653,dup,HG00329,0,,11033
1,16568887,16592199,dup,HG00160,0,,23312
1,16715499,16733725,dup,HG03978,0,,18226
1,17208619,17225378,dup,HG00096,0,,16759
1,17238417,17266696,dup,HG00096,0,,28279
1,17263114,17273513,dup,HG00096,0,,10399
1,17403943,17437540,dup,HG01935,0,,33597
1,17594229,17623219,dup,HG00136,0,,28990
1,17663971,17701638,dup,NA12829,0,,37667
1,19855608,19885146,dup,NA18629,0,,29538
1,19895022,19900627,dup,HG02731,0,,5605
1,20710219,20714564,dup,HG00626,0,,4345
1,22303020,22322238,dup,HG00097,0,,19218
1,22316148,22334511,dup,HG00097,0,,18363
1,25592642,25661222,dup,HG00096,0,,68580
1,25672907,25678659,dup,HG00445,0,,5752
1,25681734,25694129,dup,HG00445,0,,12395
1,25688926,25700415,dup,HG00096,0,,11489
1,25709998,25722241,dup,NA12776,0,,12243
1,27329988,27356982,dup,HG00368,0,,26994
1,28206060,28261986,dup,HG00583,0,,55926
1,28811628,28826165,dup,NA18528,0,,14537
1,28835165,28841452,dup,HG01028,0,,6287
1,29465025,29480533,dup,HG03559,0,,15508
1,30242237,30924254,dup,NA19684,0,,682017
1,30245968,30289176,dup,NA19684,0,,43208
1,30305891,30362813,dup,NA19684,0,,56922
1,30558573,30726169,dup,NA19684,0,,167596
1,32575417,32581537,dup,HG01892,0,,6120
1,33869825,34425088,dup,NA11893,0,,555263
1,33870510,34086547,dup,NA11893,0,,216037
1,33875399,33965259,dup,NA11893,0,,89860
1,34417621,34424530,dup,HG01525,0,,6909
1,34707635,34730075,dup,HG00254,0,,22440
1,36421773,36428063,dup,HG01551,0,,6290
1,37543312,37558966,dup,NA19321,0,,15654
1,37865700,37892009,dup,HG03729,0,,26309
1,39487268,39498733,dup,HG03437,0,,11465
1,39511831,39515006,dup,HG03160,0,,3175
1,40791694,40808851,dup,HG04152,0,,17157
1,40966808,40970590,dup,HG00422,0,,3782
1,41346261,41381024,dup,HG00119,0,,34763
1,41351470,41370162,dup,HG00119,0,,18692
1,42345990,42349839,dup,HG01198,0,,3849
1,43011378,43034628,dup,HG02283,0,,23250
1,44097640,44107450,dup,HG02009,0,,9810
1,44879444,44882757,dup,HG00171,0,,3313
1,46082501,46096227,dup,HG02775,0,,13726
1,46184288,46343246,dup,HG02675,0,,158958
1,46186033,46501996,dup,HG02675,0,,315963
1,46206327,46226218,dup,HG02675,0,,19891
1,46371534,46441112,dup,HG02675,0,,69578
1,46458427,46550399,dup,HG02675,0,,91972
1,46496380,46619884,dup,HG02675,0,,123504
1,46502191,46619707,dup,HG02675,0,,117516
1,46729838,46764083,dup,HG04146,0,,34245
1,46738403,46761997,dup,HG04146,0,,23594
1,47196468,47454785,dup,HG03458,0,,258317
1,47264437,47303186,dup,HG04100,0,,38749
1,47363207,47415964,dup,HG01885,0,,52757
1,47403009,47429931,dup,HG03458,0,,26922
1,47429257,47435381,dup,HG03458,0,,6124
1,47507071,47525241,dup,HG00136,0,,18170
1,47545813,47586989,dup,HG01885,0,,41176
1,47713997,47724221,dup,HG00613,0,,10224
1,48139046,48229675,dup,HG03007,0,,90629
1,49467099,49570622,dup,HG03135,0,,103523
1,49777181,49851052,dup,HG03905,0,,73871
1,51590637,51603729,dup,HG00108,0,,13092
1,52332138,52361967,dup,HG02250,0,,29829
1,54578538,54592574,dup,HG00159,0,,14036
1,54908690,54923726,dup,HG00109,0,,15036
1,55024355,55050323,dup,HG00457,0,,25968
1,55030468,55052760,dup,HG00457,0,,22292
1,55056456,55064127,dup,HG01396,0,,7671
1,56260673,56292967,dup,HG01600,0,,32294
1,56266873,56298992,dup,HG01600,0,,32119
1,57715384,57735259,dup,NA18635,0,,19875
1,58722032,58735992,dup,HG00125,0,,13960
1,59004542,59014781,dup,NA18536,0,,10239
1,60176495,60201485,dup,HG03681,0,,24990
1,60697880,60800563,dup,NA21089,0,,102683
1,61000968,61073173,dup,NA21089,0,,72205
1,64309547,64314582,dup,HG00155,0,,5035
1,65015838,65092452,dup,HG00704,0,,76614
1,65776407,65797155,dup,NA12340,0,,20748
1,65846235,65855597,dup,HG02052,0,,9362
1,67936163,67940078,dup,HG03084,0,,3915
1,68819615,68832523,dup,HG01618,0,,12908
1,69568736,69579924,dup,NA19648,0,,11188
1,70107266,70130550,dup,NA19351,0,,23284
1,70375395,70390626,dup,HG00690,0,,15231
1,70424730,70429033,dup,HG00513,0,,4303
1,71351243,71367020,dup,HG00177,0,,15777
1,71592553,71665573,dup,HG02923,0,,73020
1,71784758,71854644,dup,HG01684,0,,69886
1,72007083,72076337,dup,HG00139,0,,69254
1,72407365,72477635,dup,HG00683,0,,70270
1,72516113,72546537,dup,HG00611,0,,30424
1,72821848,72829143,dup,HG02654,0,,7295
1,73012472,73094877,dup,HG00244,0,,82405
1,73092779,73115591,dup,NA18632,0,,22812
1,73450689,73457706,dup,HG03472,0,,7017
1,73770840,73775478,dup,NA20858,0,,4638
1,74088398,74332880,dup,HG01807,0,,244482
1,74267467,74404371,dup,HG01807,0,,136904
1,74351405,74364368,dup,HG00422,0,,12963
1,74373853,74641099,dup,HG01807,0,,267246
1,74648740,74674679,dup,HG01069,0,,25939
1,76074285,76122779,dup,NA20767,0,,48494
1,76910860,76919424,dup,HG03745,0,,8564
1,77166921,77192625,dup,HG02012,0,,25704
1,78884196,78889183,dup,NA18941,0,,4987
1,79021916,79025915,dup,HG00345,0,,3999
1,79786730,79816753,dup,HG02733,0,,30023
1,81050646,81067898,dup,HG02490,0,,17252
1,81173889,81263947,dup,HG03629,0,,90058
1,82353594,82358327,dup,HG03722,0,,4733
1,83802380,83979035,dup,HG00096,0,,176655
1,83807367,83816091,dup,HG00145,0,,8724
1,85529569,85535936,dup,HG03716,0,,6367
1,85910910,85915009,dup,HG02184,0,,4099
1,86292518,86297603,dup,HG00105,0,,5085
1,87011072,87067792,dup,HG01933,0,,56720
1,87064962,87095965,dup,HG00513,0,,31003
1,87077058,87092937,dup,HG00150,0,,15879
1,89257193,89300092,dup,HG00107,0,,42899
1,89667276,89677289,dup,NA19085,0,,10013
1,89749291,89846728,dup,HG03112,0,,97437
1,89852216,89878223,dup,HG03112,0,,26007
1,89885299,90113117,dup,HG03112,0,,227818
1,90059036,90159610,dup,HG03112,0,,100574
1,90185071,90325003,dup,HG03112,0,,139932
1,91837768,91855186,dup,HG01603,0,,17418
1,96720428,96763126,dup,HG03838,0,,42698
1,96938318,96954480,dup,HG02082,0,,16162
1,98038851,98042400,dup,HG01789,0,,3549
1,98877302,99028600,dup,NA19083,0,,151298
1,99014474,99156549,dup,NA19083,0,,142075
1,99330681,99347687,dup,HG03410,0,,17006
1,99404771,99407786,dup,HG00233,0,,3015
1,99711830,99719207,dup,HG00183,0,,7377
1,100258363,100268638,dup,NA18549,0,,10275
1,101101811,101106610,dup,HG01111,0,,4799
1,101454213,101457671,dup,NA18597,0,,3458
1,101623643,101816987,dup,HG02489,0,,193344
1,102656055,102861233,dup,HG00290,0,,205178
1,102946074,102955569,dup,HG01844,0,,9495
1,103236940,103322533,dup,HG04159,0,,85593
1,103243265,103303376,dup,HG04159,0,,60111
1,103685101,103722462,dup,NA21097,0,,37361
1,103693675,103785057,dup,NA21097,0,,91382
1,103741196,103791554,dup,NA21097,0,,50358
1,104102743,104136676,dup,HG00102,0,,33933
1,104303431,104335412,dup,HG00662,0,,31981
1,104347284,104499765,dup,NA20892,0,,152481
1,104540845,104579811,dup,HG00260,0,,38966
1,104672029,104689773,dup,NA19089,0,,17744
1,104686734,104700441,dup,NA19089,0,,13707
1,105038849,105042378,dup,HG02586,0,,3529
1,105053648,105063402,dup,NA19428,0,,9754
1,106012275,106235113,dup,HG02394,0,,222838
1,106034504,106093170,dup,HG02394,0,,58666
1,107697196,107717161,dup,HG01971,0,,19965
1,108733288,108737237,dup,HG00099,0,,3949
1,108854982,108870891,dup,HG03844,0,,15909
1,108883755,108899725,dup,NA11931,0,,15970
1,109016790,109057159,dup,HG02014,0,,40369
1,109051221,109084003,dup,NA11931,0,,32782
1,109384724,109411687,dup,HG01437,0,,26963
1,109384961,109433711,dup,HG01437,0,,48750
1,110230075,110241247,dup,HG00096,0,,11172
1,110244978,110253379,dup,HG02389,0,,8401
1,112196934,112207483,dup,HG01512,0,,10549
1,112696055,112740320,dup,NA19385,0,,44265
1,112703933,112738426,dup,NA19385,0,,34493
1,113342098,113433367,dup,NA18523,0,,91269
1,113630146,113751915,dup,NA18523,0,,121769
1,113810961,113933784,dup,NA18523,0,,122823
1,114053474,114409284,dup,NA18523,0,,355810
1,114308291,114333303,dup,NA18523,0,,25012
1,114414325,114478909,dup,NA18523,0,,64584
1,114482901,114515484,dup,NA18523,0,,32583
1,114544914,114707957,dup,NA18523,0,,163043
1,114939198,114968568,dup,NA18523,0,,29370
1,114973622,115104225,dup,NA18523,0,,130603
1,115032828,115050475,dup,NA18633,0,,17647
1,115130092,115157074,dup,NA18523,0,,26982
1,115135445,115163230,dup,HG02188,0,,27785
1,115171093,115221095,dup,NA18523,0,,50002
1,115227074,115245524,dup,NA18523,0,,18450
1,115950365,116107709,dup,NA18523,0,,157344
1,115980653,116000158,dup,NA18523,0,,19505
1,116255705,116380330,dup,NA18523,0,,124625
1,116404020,116499388,dup,NA18523,0,,95368
1,119253543,119261016,dup,HG00610,0,,7473
1,120097223,120135549,dup,HG02642,0,,38326
1,120141568,120152539,dup,HG00734,0,,10971
1,121170751,121219058,dup,HG01049,0,,48307
1,121171965,121349588,dup,HG00096,0,,177623
1,142691593,142713913,dup,HG00404,0,,22320
1,143118175,143136183,dup,HG00119,0,,18008
1,143206368,143282836,dup,HG00119,0,,76468
1,144691202,144710622,dup,HG00096,0,,19420
1,144839080,144849492,dup,HG00096,0,,10412
1,144862244,144892802,dup,HG00096,0,,30558
1,144896457,144906760,dup,HG00278,0,,10303
1,144913699,144951391,dup,HG00096,0,,37692
1,144973077,144989257,dup,HG00096,0,,16180
1,145120320,145182150,dup,HG00096,0,,61830
1,145515121,145541736,dup,HG02390,0,,26615
1,145529907,145610744,dup,HG02390,0,,80837
1,145684026,145785911,dup,HG00698,0,,101885
1,146081807,146164363,dup,HG00096,0,,82556
1,146477770,146490604,dup,HG00123,0,,12834
1,147207808,147217377,dup,HG03837,0,,9569
1,147248189,147399723,dup,HG03746,0,,151534
1,148511449,148574703,dup,HG00119,0,,63254
1,149071634,149169501,dup,HG00100,0,,97867
1,149151838,149203736,dup,HG00100,0,,51898
1,149207860,149218152,dup,HG00100,0,,10292
1,149225406,149230941,dup,HG00100,0,,5535
1,149231192,149241216,dup,HG00096,0,,10024
1,149240213,149249883,dup,HG00100,0,,9670
1,149712970,149728871,dup,HG01280,0,,15901
1,149988183,149996761,dup,HG01488,0,,8578
1,151209849,151239810,dup,HG02546,0,,29961
1,151332095,151408463,dup,HG00584,0,,76368
1,151332732,151385382,dup,HG00584,0,,52650
1,151333216,151413627,dup,HG00356,0,,80411
1,152275202,152288975,dup,HG00115,0,,13773
1,152408415,152436850,dup,HG00608,0,,28435
1,152444503,152456440,dup,HG00275,0,,11937
1,152454691,152472816,dup,HG01504,0,,18125
1,152465315,152481896,dup,HG01504,0,,16581
1,152496676,152522961,dup,HG01504,0,,26285
1,152521684,152555569,dup,HG00743,0,,33885
1,152590538,152642351,dup,HG01504,0,,51813
1,152648554,152663651,dup,HG01504,0,,15097
1,152679657,152706828,dup,HG01504,0,,27171
1,152803950,152855431,dup,NA21107,0,,51481
1,153045096,153067949,dup,NA18982,0,,22853
1,153068826,153087248,dup,HG03103,0,,18422
1,153161766,153165173,dup,HG01894,0,,3407
1,153438602,153571467,dup,HG03838,0,,132865
1,153443041,153485998,dup,HG03838,0,,42957
1,153492623,153502246,dup,NA19818,0,,9623
1,153501106,153542669,dup,HG03838,0,,41563
1,153682976,153696281,dup,HG00103,0,,13305
1,155020329,155147489,dup,HG00310,0,,127160
1,155028402,155071133,dup,HG00310,0,,42731
1,155182795,155205979,dup,HG00109,0,,23184
1,155589492,155665271,dup,HG02546,0,,75779
1,156301735,156318028,dup,HG01566,0,,16293
1,158458404,158484071,dup,HG00338,0,,25667
1,158517149,158521679,dup,HG01896,0,,4530
1,158694006,158727518,dup,NA19384,0,,33512
1,159014810,159018679,dup,HG00111,0,,3869
1,159803875,159807674,dup,HG03684,0,,3799
1,160986424,160999189,dup,HG02019,0,,12765
1,161211491,161270534,dup,HG04158,0,,59043
1,161488444,161519959,dup,HG00178,0,,31515
1,161570323,161598180,dup,HG00127,0,,27857
1,161760383,161776787,dup,NA12340,0,,16404
1,162074260,162364384,dup,HG00428,0,,290124
1,162075572,162151703,dup,HG00428,0,,76131
1,165907287,165922706,dup,NA20524,0,,15419
1,166179413,166194663,dup,HG01124,0,,15250
1,168641545,168648783,dup,NA18917,0,,7238
1,168656343,168663103,dup,HG03640,0,,6760
1,170060691,170080670,dup,HG02386,0,,19979
1,170413623,170417531,dup,HG01275,0,,3908
1,173304573,173307971,dup,HG01583,0,,3398
1,174031893,174061327,dup,NA20505,0,,29434
1,174355300,174411161,dup,HG01973,0,,55861
1,174431282,174481124,dup,HG01973,0,,49842
1,174804383,174819257,dup,HG00589,0,,14874
1,175071066,175077094,dup,HG00096,0,,6028
1,175433100,175491143,dup,HG00313,0,,58043
1,175670240,175720506,dup,HG00313,0,,50266
1,176220601,176277315,dup,HG01578,0,,56714
1,176231528,176266154,dup,HG01578,0,,34626
1,177946426,177951787,dup,HG02819,0,,5361
1,179227443,179242522,dup,HG01673,0,,15079
1,179360852,179389863,dup,HG01678,0,,29011
1,179686009,179735211,dup,HG03680,0,,49202
1,179687023,179734706,dup,HG03680,0,,47683
1,181230694,181238874,dup,HG00698,0,,8180
1,182299180,182319690,dup,HG01556,0,,20510
1,182299314,182318472,dup,HG01556,0,,19158
1,183279017,183334689,dup,HG01971,0,,55672
1,183778314,183785263,dup,HG00422,0,,6949
1,183971706,183976772,dup,HG01108,0,,5066
1,184814696,184974866,dup,HG02379,0,,160170
1,186461001,186471772,dup,HG01122,0,,10771
1,186742716,186762852,dup,HG01858,0,,20136
1,187022182,187097118,dup,HG01841,0,,74936
1,187639143,187779700,dup,HG02339,0,,140557
1,187748853,187772003,dup,HG02339,0,,23150
1,188753735,188865187,dup,HG04195,0,,111452
1,188798693,188810267,dup,HG01565,0,,11574
1,188836713,188863217,dup,HG00956,0,,26504
1,188873898,189031229,dup,HG04195,0,,157331
1,188887604,188894897,dup,HG01791,0,,7293
1,188892236,188968671,dup,HG02278,0,,76435
1,188972875,189006599,dup,HG02278,0,,33724
1,188995550,189038554,dup,HG03127,0,,43004
1,189035431,189066822,dup,HG04195,0,,31391
1,189039907,189197526,dup,HG04195,0,,157619
1,189071987,189078025,dup,HG03127,0,,6038
1,189112438,189192103,dup,HG04195,0,,79665
1,189217102,189304761,dup,HG02102,0,,87659
1,189318010,189323652,dup,HG00556,0,,5642
1,189325461,189362830,dup,HG00556,0,,37369
1,189327193,189545625,dup,HG00566,0,,218432
1,189327916,189375616,dup,HG00513,0,,47700
1,189335550,189464463,dup,HG00566,0,,128913
1,189378869,189446681,dup,HG00513,0,,67812
1,189462666,189517150,dup,HG00513,0,,54484
1,189490728,189548897,dup,HG00513,0,,58169
1,189531191,189621059,dup,HG02184,0,,89868
1,189536326,189617708,dup,HG00608,0,,81382
1,189777343,189785693,dup,HG01894,0,,8350
1,189814704,189833184,dup,HG02649,0,,18480
1,189867914,189878900,dup,HG01498,0,,10986
1,189893401,189929605,dup,HG02138,0,,36204
1,189915128,189977560,dup,HG01498,0,,62432
1,189969109,189989544,dup,HG01855,0,,20435
1,190248809,190281663,dup,HG03380,0,,32854
1,190747327,190773526,dup,NA18991,0,,26199
1,191199622,191354901,dup,HG00406,0,,155279
1,191426026,191529315,dup,HG01914,0,,103289
1,192466059,192474550,dup,HG02406,0,,8491
1,192715081,192719855,dup,HG00176,0,,4774
1,193310433,193335669,dup,NA19198,0,,25236
1,193873803,193917563,dup,HG04118,0,,43760
1,193873832,193917280,dup,HG04118,0,,43448
1,194515215,194529088,dup,HG01414,0,,13873
1,194582643,194593732,dup,HG02568,0,,11089
1,194770750,194985993,dup,NA20530,0,,215243
1,194800305,194835589,dup,HG03744,0,,35284
1,194844745,194887633,dup,NA20530,0,,42888
1,194877861,194951114,dup,HG00560,0,,73253
1,194952990,195003012,dup,HG04183,0,,50022
1,194956466,194987344,dup,HG04183,0,,30878
1,195000142,195119572,dup,NA20530,0,,119430
1,195120996,195187411,dup,HG02545,0,,66415
1,195289776,195317401,dup,HG02291,0,,27625
1,195323240,195334114,dup,HG02291,0,,10874
1,195406654,195445734,dup,NA19678,0,,39080
1,195407417,195468957,dup,NA19152,0,,61540
1,195439996,195471717,dup,NA18868,0,,31721
1,195456421,195679863,dup,NA18868,0,,223442
1,195686623,195782865,dup,NA18868,0,,96242
1,195893836,196014388,dup,NA18868,0,,120552
1,195911251,196026922,dup,NA18868,0,,115671
1,196187886,196225960,dup,HG02681,0,,38074
1,196735895,196764940,dup,HG00102,0,,29045
1,196819616,196870345,dup,HG00171,0,,50729
1,196907957,196911987,dup,HG01437,0,,4030
1,196956145,196980821,dup,HG02449,0,,24676
1,196977710,197028069,dup,HG02309,0,,50359
1,197115894,197185635,dup,HG02012,0,,69741
1,197311827,197442888,dup,HG01052,0,,131061
1,197663304,197734788,dup,HG02012,0,,71484
1,198261283,198273580,dup,HG02012,0,,12297
1,198621255,198632314,dup,NA18531,0,,11059
1,200816427,200891002,dup,HG01936,0,,74575
1,200898996,200904787,dup,NA19792,0,,5791
1,202401972,202415218,dup,HG01890,0,,13246
1,203077863,203081862,dup,HG00258,0,,3999
1,203752272,203755299,dup,HG00142,0,,3027
1,204180775,204214026,dup,HG00406,0,,33251
1,204182971,204203289,dup,HG00406,0,,20318
1,204554808,204594981,dup,HG02675,0,,40173
1,204985309,204996532,dup,HG02464,0,,11223
1,205030296,205051683,dup,NA20506,0,,21387
1,205385800,205390552,dup,HG02793,0,,4752
1,205442346,205456847,dup,HG00246,0,,14501
1,205826108,205843972,dup,NA19776,0,,17864
1,205826316,205845573,dup,NA19776,0,,19257
1,206199929,206205945,dup,HG01055,0,,6016
1,207542027,207545525,dup,HG00096,0,,3498
1,207803800,207900483,dup,NA19725,0,,96683
1,208444000,208457338,dup,HG00126,0,,13338
1,208444187,208457153,dup,HG00253,0,,12966
1,208611523,208625382,dup,HG02406,0,,13859
1,209107727,209162221,dup,HG02854,0,,54494
1,209720496,209744544,dup,HG02019,0,,24048
1,210150119,210164848,dup,HG02433,0,,14729
1,211375931,211392115,dup,HG04182,0,,16184
1,211643670,211651667,dup,HG02236,0,,7997
1,211882512,211918278,dup,HG00537,0,,35766
1,211890105,211908149,dup,HG00537,0,,18044
1,212119256,212208886,dup,HG01870,0,,89630
1,213571759,213576218,dup,HG02442,0,,4459
1,213752028,213755326,dup,HG00176,0,,3298
1,214344343,214352969,dup,HG02184,0,,8626
1,215233299,215248340,dup,NA21093,0,,15041
1,215453667,215531289,dup,HG01682,0,,77622
1,217634250,217655068,dup,HG01247,0,,20818
1,217845939,217851043,dup,HG02568,0,,5104
1,218478059,218509455,dup,HG04080,0,,31396
1,219549203,219564658,dup,HG02968,0,,15455
1,220017750,220041066,dup,NA20876,0,,23316
1,220608859,220618574,dup,HG01871,0,,9715
1,222676799,222692587,dup,NA18486,0,,15788
1,223620632,223645656,dup,HG00187,0,,25024
1,223631224,223646658,dup,HG00334,0,,15434
1,223663683,223679929,dup,NA18961,0,,16246
1,223799237,223857389,dup,HG00457,0,,58152
1,225250256,225354641,dup,HG02078,0,,104385
1,225252615,225288829,dup,HG02078,0,,36214
1,225299285,225347911,dup,HG02078,0,,48626
1,225406540,225463287,dup,HG00288,0,,56747
1,225657604,225686855,dup,HG00442,0,,29251
1,226035903,226054330,dup,HG03604,0,,18427
1,226258230,226263424,dup,HG00139,0,,5194
1,226412613,226422295,dup,HG01811,0,,9682
1,226983117,226991696,dup,NA19439,0,,8579
1,227135651,227145095,dup,HG01353,0,,9444
1,227407631,227597673,dup,NA20544,0,,190042
1,227407668,227438750,dup,NA20544,0,,31082
1,227457628,227551099,dup,NA20544,0,,93471
1,228206508,228214492,dup,HG00674,0,,7984
1,228789588,228807071,dup,HG00116,0,,17483
1,229235711,229243062,dup,HG03973,0,,7351
1,229285184,229300905,dup,NA20886,0,,15721
1,229429015,229461897,dup,HG01613,0,,32882
1,229514478,229545418,dup,HG01613,0,,30940
1,230075255,230321976,dup,HG02020,0,,246721
1,230088978,230214783,dup,HG02020,0,,125805
1,230369963,230415921,dup,HG01168,0,,45958
1,230617783,231412936,dup,HG01089,0,,795153
1,230617824,230702647,dup,HG01089,0,,84823
1,231246035,231414082,dup,HG01089,0,,168047
1,231717173,231811457,dup,NA11830,0,,94284
1,234528228,234621106,dup,HG02449,0,,92878
1,235513744,235525522,dup,HG02645,0,,11778
1,236060192,236111383,dup,NA19385,0,,51191
1,236140014,236223432,dup,NA19385,0,,83418
1,236672034,236679527,dup,HG03520,0,,7493
1,236683722,236741825,dup,NA19916,0,,58103
1,236882341,236891977,dup,NA11832,0,,9636
1,237118692,237133182,dup,HG02314,0,,14490
1,238003942,238216124,dup,NA18633,0,,212182
1,238650819,238665739,dup,HG00739,0,,14920
1,238661519,238729526,dup,HG00739,0,,68007
1,238709960,238794898,dup,HG01501,0,,84938
1,238977411,238989510,dup,NA19038,0,,12099
1,239914903,239921951,dup,NA18566,0,,7048
1,239931900,239973525,dup,NA18566,0,,41625
1,239936024,239962431,dup,NA18566,0,,26407
1,239974636,240117058,dup,HG00240,0,,142422
1,239986957,240087166,dup,HG00240,0,,100209
1,239990195,240075814,dup,HG00240,0,,85619
1,240095737,240104599,dup,HG00240,0,,8862
1,240102764,240111608,dup,HG00240,0,,8844
1,240113266,240221347,dup,HG00240,0,,108081
1,240137922,240302859,dup,HG00240,0,,164937
1,240225050,240242900,dup,NA18566,0,,17850
1,240250119,240254433,dup,HG02688,0,,4314
1,240257457,240298593,dup,NA18566,0,,41136
1,240921653,240935779,dup,HG02716,0,,14126
1,241277814,241347920,dup,HG02006,0,,70106
1,242130159,242137957,dup,HG02595,0,,7798
1,242338136,242344128,dup,HG02088,0,,5992
1,242743749,242784606,dup,HG01565,0,,40857
1,242807013,243032937,dup,NA19475,0,,225924
1,242807543,242961781,dup,NA19475,0,,154238
1,243020383,243075259,dup,HG01525,0,,54876
1,243085711,243126784,dup,NA19475,0,,41073
1,243265739,243351820,dup,NA19475,0,,86081
1,244140197,244282730,dup,NA21106,0,,142533
1,244143319,244200377,dup,NA21106,0,,57058
1,244286214,244381067,dup,NA21106,0,,94853
1,245044464,245047582,dup,HG04177,0,,3118
1,245054298,245203517,dup,NA12776,0,,149219
1,245339739,245369802,dup,HG03432,0,,30063
1,245970966,245999967,dup,HG00288,0,,29001
1,246049652,246131093,dup,HG02081,0,,81441
1,246177098,246225423,dup,HG02407,0,,48325
1,246244340,246342015,dup,HG02407,0,,97675
1,246343053,246489665,dup,HG02407,0,,146612
1,246726453,246734312,dup,HG00551,0,,7859
1,246998444,247009711,dup,HG00479,0,,11267
1,247123161,247343569,dup,NA20863,0,,220408
1,247286100,247337498,dup,NA20863,0,,51398
1,247460694,247517892,dup,NA20859,0,,57198
1,247871833,248160090,dup,HG01879,0,,288257
1,248162752,248200084,dup,HG01148,0,,37332
1,248227457,248276139,dup,HG02884,0,,48682
1,248251444,248285624,dup,HG02884,0,,34180
1,248290373,248327596,dup,HG01889,0,,37223
1,248347878,248429640,dup,NA19028,0,,81762
1,248444246,248457399,dup,HG03397,0,,13153
1,248465997,248538824,dup,HG03397,0,,72827
1,248550162,248567346,dup,HG02298,0,,17184
1,248572358,248596103,dup,HG01705,0,,23745
1,248619876,248634579,dup,HG01248,0,,14703
1,248756741,248797597,dup,HG00097,0,,40856
1,248813331,248825836,dup,HG00139,0,,12505
1,248823883,248866950,dup,HG00178,0,,43067
1,248867276,248876082,dup,HG00619,0,,8806
1,248875302,248908060,dup,HG00619,0,,32758
1,249059477,249079124,dup,HG02298,0,,19647
1,249139926,249185877,dup,NA20868,0,,45951
1,249140013,249237828,dup,HG00179,0,,97815
1,249181010,249198133,dup,NA19042,0,,17123
1,249198914,249214145,dup,NA20868,0,,15231
1,249209633,249222298,dup,HG00244,0,,12665
1,249220713,249232725,dup,HG02231,0,,12012
2,128899888,128900285,del,NA20771,0,,397
2,135550561,135550931,del,NA18991,0,,370
2,189730592,189740048,del,NA18552,0,,9456
2,45300422,45311081,del,NA19429,0,,10659
2,172904416,172910822,del,HG00443,0,,6406
2,139683087,139684442,del,NA20803,0,,1355
2,213370140,213371168,del,HG00149,0,,1028
2,3732805,3738028,del,NA12751,0,,5223
2,91631125,92257154,del,HG00116,0,,626029
2,130355843,130356210,del,NA19469,0,,367
2,89132516,89565122,del,NA18615,0,,432606
2,225534492,225540491,del,NA19681,0,,5999
2,30812773,30850258,del,HG00133,0,,37485
2,3387303,3387792,del,NA19436,0,,489
2,12019035,12022923,del,HG00280,0,,3888
2,40255675,40257767,del,NA12751,0,,2092
2,27006942,27007292,del,NA18618,0,,350
2,172904866,172911372,del,NA19382,0,,6506
2,176709475,176709730,del,NA19434,0,,255
2,53625762,53627999,del,NA19469,0,,2237
2,223865089,223869877,del,NA19395,0,,4788
2,145370202,145379692,del,NA18977,0,,9490
2,86209211,86214485,del,NA19707,0,,5274
2,167742000,167743295,del,NA18611,0,,1295
2,242703366,242706722,del,HG00324,0,,3356
2,127637354,127637572,del,NA20761,0,,218
2,43887560,43893639,del,NA18504,0,,6079
2,48739488,48739678,del,NA18522,0,,190
2,56260620,56264247,del,NA18487,0,,3627
2,1217278,1217831,del,NA18977,0,,553
2,92261559,92262768,del,HG00261,0,,1209
2,29207971,29212527,del,NA20809,0,,4556
2,134091776,134119966,del,HG00331,0,,28190
2,164969831,164970928,del,HG00542,0,,1097
2,33512975,33516699,del,NA19078,0,,3724
2,105207933,105208670,del,NA19835,0,,737
2,233909926,233911313,del,NA19783,0,,1387
2,104037527,104050410,del,HG00421,0,,12883
2,195979966,195985972,del,HG00158,0,,6006
2,133116377,133117075,del,HG01075,0,,698
2,191960764,192028714,del,NA19346,0,,67950
2,182733498,182735626,del,NA19920,0,,2128
2,131639073,131647289,del,NA20340,0,,8216
2,78117890,78118357,del,NA19749,0,,467
2,159622268,159623079,del,HG00251,0,,811
2,183931929,183932080,del,HG00315,0,,151
2,220994454,220995414,del,NA18952,0,,960
2,153795990,153799743,del,NA20512,0,,3753
2,998907,1001025,del,HG00443,0,,2118
2,234543311,234544978,del,NA19783,0,,1667
2,238451216,238453622,del,NA19776,0,,2406
2,222388284,222388583,del,NA19328,0,,299
2,164171703,164175299,del,NA19350,0,,3596
2,110362940,110363885,del,NA12400,0,,945
2,18784762,18786421,del,HG00654,0,,1659
2,30864771,30875862,del,HG00133,0,,11091
2,241818396,241820963,del,NA18567,0,,2567
2,43854261,43854480,del,NA19776,0,,219
2,62108472,62109283,del,HG00607,0,,811
2,87731216,87740222,del,HG00158,0,,9006
2,238771805,238771981,del,NA18856,0,,176
2,200916922,200922961,del,HG01170,0,,6039
2,234282390,234285354,del,NA18536,0,,2964
2,89132416,89490422,del,HG01492,0,,358006
2,2497208,2497367,del,NA18552,0,,159
2,213183962,213192011,del,NA07357,0,,8049
2,234089469,234089474,del,NA19093,0,,5
2,241009281,241010049,del,NA18959,0,,768
2,170747047,170747586,del,NA20538,0,,539
2,109577679,109588057,del,HG00338,0,,10378
2,229303237,229307662,del,NA18501,0,,4425
2,208350983,208359853,del,NA20530,0,,8870
2,21859205,21861416,del,NA19384,0,,2211
2,232617603,232622014,del,NA19471,0,,4411
2,49532614,49543963,del,NA18631,0,,11349
2,44790250,44790712,del,HG00277,0,,462
2,194911630,194988374,del,NA19648,0,,76744
2,51588094,51591667,del,NA19377,0,,3573
2,51433343,51435471,del,NA19434,0,,2128
2,229956769,229956954,del,NA19701,0,,185
2,26620905,26648653,del,NA19080,0,,27748
2,79408043,79408285,del,NA18867,0,,242
2,10842085,10843519,del,NA18977,0,,1434
2,85893376,85893501,del,HG01389,0,,125
2,70125044,70125565,del,NA19248,0,,521
2,70017251,70026628,del,HG00629,0,,9377
2,86453520,86453592,del,NA18505,0,,72
2,34561853,34562934,del,NA18596,0,,1081
2,132995057,133001174,del,NA19713,0,,6117
2,34695829,34736567,del,NA19780,0,,40738
2,115391020,115402665,del,NA18502,0,,11645
2,72172328,72183622,del,HG00513,0,,11294
2,242965505,242970776,del,HG00589,0,,5271
2,209233662,209247223,del,NA18511,0,,13561
2,36362107,36363280,del,NA19007,0,,1173
2,62735938,62761389,del,NA19437,0,,25451
2,89585966,89612822,del,NA18972,0,,26856
2,174155900,174209054,del,HG00273,0,,53154
2,143404096,143414611,del,NA19909,0,,10515
2,166637092,166639809,del,HG01488,0,,2717
2,187184233,187185440,del,HG01055,0,,1207
2,5250480,5252707,del,NA19456,0,,2227
2,120045608,120050535,del,NA18592,0,,4927
2,53489848,53491715,del,NA19130,0,,1867
2,102619487,102619616,del,HG00253,0,,129
2,137777523,137794180,del,NA18983,0,,16657
2,160090239,160090566,del,NA20540,0,,327
2,49014323,49015485,del,NA07051,0,,1162
2,133179987,133180917,del,NA19679,0,,930
2,215627249,215630358,del,NA19448,0,,3109
2,160481929,160488725,del,HG01101,0,,6796
2,216920227,216923447,del,HG01066,0,,3220
2,26217286,26221385,del,NA18599,0,,4099
2,240389452,240389522,del,HG00310,0,,70
2,77206789,77210714,del,NA19717,0,,3925
2,142323616,142328522,del,NA12341,0,,4906
2,225097648,225101012,del,NA18516,0,,3364
2,85335357,85335675,del,NA18967,0,,318
2,2007791,2008459,del,NA18990,0,,668
2,161863430,161869324,del,NA19054,0,,5894
2,89160773,89521170,del,HG01342,0,,360397
2,150751445,150757503,del,HG01083,0,,6058
2,10865861,10867330,del,NA19900,0,,1469
2,29208116,29212567,del,NA19663,0,,4451
2,158237154,158238098,del,NA19463,0,,944
2,102126221,102128725,del,HG00593,0,,2504
2,160872219,160878296,del,NA19435,0,,6077
2,141058369,141062407,del,NA18868,0,,4038
2,32074124,32075431,del,HG00736,0,,1307
2,155257797,155289811,del,NA19379,0,,32014
2,119046647,119046935,del,NA18968,0,,288
2,109307965,109311015,del,NA18909,0,,3050
2,134544274,134544606,del,HG00345,0,,332
2,218963706,218968116,del,NA19383,0,,4410
2,105826070,105828482,del,HG01140,0,,2412
2,8566644,8567967,del,NA19439,0,,1323
2,78976650,78978910,del,NA19399,0,,2260
2,21383874,21385960,del,NA19377,0,,2086
2,83619418,83619945,del,NA19398,0,,527
2,147411656,147414499,del,NA19058,0,,2843
2,117156927,117157181,del,NA18613,0,,254
2,84215895,84261675,del,NA18541,0,,45780
2,196163208,196164308,del,NA19099,0,,1100
2,73081499,73082514,del,NA18597,0,,1015
2,34965729,34967274,del,NA19901,0,,1545
2,117930463,117933837,del,NA18574,0,,3374
2,176346668,176352721,del,NA19401,0,,6053
2,100028143,100028501,del,NA19403,0,,358
2,80679284,80680040,del,NA19904,0,,756
2,136795598,136800559,del,NA19461,0,,4961
2,239626166,239627507,del,HG00473,0,,1341
2,194089380,194090216,del,HG01384,0,,836
2,180381536,180382261,del,HG00323,0,,725
2,1217434,1218397,del,NA19468,0,,963
2,11394743,11400296,del,NA19453,0,,5553
2,4777644,4787159,del,HG00344,0,,9515
2,140246510,140246731,del,NA18486,0,,221
2,23466337,23475574,del,NA19235,0,,9237
2,181316701,181319133,del,NA19681,0,,2432
2,185612041,185614923,del,NA19900,0,,2882
2,35581386,35616487,del,NA19720,0,,35101
2,122731075,122732040,del,NA18952,0,,965
2,64088314,64089990,del,NA19240,0,,1676
2,151393994,151394650,del,NA18526,0,,656
2,228268858,228270003,del,NA19380,0,,1145
2,134555407,134555950,del,NA19776,0,,543
2,176101333,176105052,del,NA19469,0,,3719
2,65421400,65423932,del,HG00464,0,,2532
2,121983389,121983758,del,NA19404,0,,369
2,132534464,132534926,del,HG01073,0,,462
2,167155679,167158793,del,NA19107,0,,3114
2,169135461,169146465,del,NA18907,0,,11004
2,87627395,87627932,del,HG00357,0,,537
2,127045010,127047129,del,NA19085,0,,2119
2,22688473,22689983,del,HG00346,0,,1510
2,174540809,174549256,del,NA19130,0,,8447
2,111576490,111576593,del,HG01359,0,,103
2,11246412,11247360,del,NA19334,0,,948
2,242853252,243035778,del,HG01342,0,,182526
2,202373671,202375070,del,NA18916,0,,1399
2,177352024,177356234,del,HG00140,0,,4210
2,24151236,24156147,del,HG01102,0,,4911
2,108183229,108184689,del,NA18517,0,,1460
2,201249302,201250616,del,NA20770,0,,1314
2,168666569,168667314,del,HG01047,0,,745
2,43800535,43801383,del,NA18616,0,,848
2,234650079,234661759,del,NA19373,0,,11680
2,81343988,81345612,del,HG00436,0,,1624
2,115534971,115542400,del,HG00160,0,,7429
2,26183243,26183342,del,HG01060,0,,99
2,96585239,96587113,del,NA19440,0,,1874
2,45227465,45228370,del,NA18548,0,,905
2,193421629,193421898,del,NA19428,0,,269
2,47152651,47158896,del,HG00512,0,,6245
2,128555681,128557108,del,NA18519,0,,1427
2,70988633,70992378,del,NA19908,0,,3745
2,9925472,9929048,del,HG00637,0,,3576
2,57549283,57553574,del,HG00737,0,,4291
2,186568002,186568238,del,NA20804,0,,236
2,53429532,53444168,del,NA18538,0,,14636
2,28341512,28341833,del,NA19137,0,,321
2,138611859,138613242,del,NA19431,0,,1383
2,66185965,66197059,del,NA12058,0,,11094
2,225468701,225470681,del,NA20756,0,,1980
2,133325424,133327399,del,NA19350,0,,1975
2,6654216,6655216,del,NA19445,0,,1000
2,14923570,14934923,del,HG00640,0,,11353
2,78598439,78601177,del,HG00428,0,,2738
2,46416211,46422144,del,NA19398,0,,5933
2,232397150,232400208,del,HG00344,0,,3058
2,71487393,71487886,del,HG00120,0,,493
2,114151326,114153611,del,HG00448,0,,2285
2,123676244,123765631,del,NA19457,0,,89387
2,146887557,146889522,del,NA18610,0,,1965
2,146280284,146911063,del,HG00383,0,,630779
2,45758061,45759988,del,NA20758,0,,1927
2,129639116,129646222,del,HG01519,0,,7106
2,62483220,62483680,del,NA20356,0,,460
2,76557056,76557290,del,NA19440,0,,234
2,242017537,242018266,del,NA18910,0,,729
2,63741097,63744061,del,NA19462,0,,2964
2,38232627,38360336,del,HG00373,0,,127709
2,241504580,241505854,del,NA18582,0,,1274
2,88600816,88601142,del,NA19381,0,,326
2,20768982,20775810,del,NA18538,0,,6828
2,198894512,198894649,del,HG01356,0,,137
2,236909271,236909844,del,NA18868,0,,573
2,73106194,73108596,del,NA18941,0,,2402
2,89161095,89246809,del,NA06989,0,,85714
2,175583069,175583231,del,NA19720,0,,162
2,24136475,24138884,del,HG00237,0,,2409
2,4212866,4222122,del,NA20581,0,,9256
2,95430273,95438479,del,NA19081,0,,8206
2,232921868,232928205,del,NA19002,0,,6337
2,233203486,233314232,del,NA20533,0,,110746
2,32293096,32295183,del,NA19700,0,,2087
2,11994572,11995213,del,HG01134,0,,641
2,32201458,32203140,del,HG00237,0,,1682
2,233332718,233333480,del,HG00180,0,,762
2,236010926,236011112,del,NA18519,0,,186
2,75092086,75094407,del,NA19437,0,,2321
2,241718482,241718892,del,NA19723,0,,410
2,158973363,158979260,del,NA20810,0,,5897
2,240214350,240216454,del,NA19360,0,,2104
2,159159175,159162728,del,NA18874,0,,3553
2,77580169,77590067,del,NA19440,0,,9898
2,182856914,182857597,del,HG00313,0,,683
2,32030852,32030938,del,HG01107,0,,86
2,227342426,227347475,del,HG00155,0,,5049
2,237899311,237900505,del,NA19835,0,,1194
2,81771354,81771778,del,HG00698,0,,424
2,49659501,49744164,del,HG00335,0,,84663
2,149248668,149250619,del,NA19190,0,,1951
2,125248378,125258681,del,HG00671,0,,10303
2,223824831,223827934,del,NA18948,0,,3103
2,188384303,188389772,del,NA19904,0,,5469
2,196974578,196977066,del,HG00610,0,,2488
2,220373416,220377122,del,NA19312,0,,3706
2,121797805,121798399,del,HG00692,0,,594
2,238554099,238559149,del,NA20528,0,,5050
2,22498593,22498968,del,NA19379,0,,375
2,29106755,29117116,del,NA18633,0,,10361
2,229264344,229268336,del,NA19720,0,,3992
2,51926584,51927767,del,NA19664,0,,1183
2,43230890,43231585,del,HG00629,0,,695
2,74529430,74531190,del,HG00472,0,,1760
2,116669468,116673961,del,HG00267,0,,4493
2,145602655,145607434,del,NA19701,0,,4779
2,73286754,73287040,del,HG00463,0,,286
2,188803263,188804050,del,NA19704,0,,787
2,132382538,132386451,del,HG01174,0,,3913
2,122314961,122315623,del,HG00173,0,,662
2,154863755,154864513,del,HG00251,0,,758
2,172051091,172052282,del,NA19063,0,,1191
2,126341771,126342852,del,HG00608,0,,1081
2,58204651,58206765,del,NA19921,0,,2114
2,102069440,102069612,del,HG01461,0,,172
2,24554850,24558848,del,NA19385,0,,3998
2,89132292,89214575,del,NA19004,0,,82283
2,40764893,40771955,del,NA19338,0,,7062
2,3885212,3885333,del,NA20761,0,,121
2,29227775,29229221,del,NA19107,0,,1446
2,34965729,34967269,del,HG00736,0,,1540
2,46694273,46697681,del,NA18579,0,,3408
2,27899027,27899768,del,NA19457,0,,741
2,178351788,178354176,del,NA19901,0,,2388
2,141790834,141794982,del,NA18486,0,,4148
2,70363695,70364089,del,NA19397,0,,394
2,6693435,6707824,del,HG00185,0,,14389
2,134617201,134620016,del,NA19376,0,,2815
2,129638419,129646203,del,HG01190,0,,7784
2,203899016,203904522,del,HG01515,0,,5506
2,193185907,193191820,del,NA19473,0,,5913
2,121590595,121592507,del,NA18606,0,,1912
2,56652302,56655882,del,NA20518,0,,3580
2,194112803,194113591,del,HG00473,0,,788
2,230834303,230838302,del,HG00124,0,,3999
2,126509711,126510598,del,NA18858,0,,887
2,118223866,118227068,del,HG00122,0,,3202
2,140116880,140117496,del,NA19385,0,,616
2,10573528,10573729,del,NA18582,0,,201
2,119713987,119714124,del,HG00583,0,,137
2,3719391,3720298,del,HG00152,0,,907
2,5487066,5487872,del,NA18599,0,,806
2,126549731,126552128,del,NA19446,0,,2397
2,229148272,229149278,del,NA19256,0,,1006
2,184270811,184275853,del,NA19007,0,,5042
2,184546948,184547086,del,NA19189,0,,138
2,235563704,235572071,del,NA19438,0,,8367
2,105467816,105472622,del,HG00403,0,,4806
2,116422415,116422531,del,HG00251,0,,116
2,97812765,97825388,del,NA18953,0,,12623
2,95703904,95703996,del,NA18853,0,,92
2,22307064,22308414,del,HG01171,0,,1350
2,146862619,146876862,del,HG00500,0,,14243
2,18183183,18185348,del,HG00478,0,,2165
2,229949563,229949659,del,HG00137,0,,96
2,1158868,1159048,del,NA19403,0,,180
2,97298667,97299244,del,NA19081,0,,577
2,3383984,3387061,del,HG01134,0,,3077
2,106552301,106553207,del,NA19904,0,,906
2,170421178,170432863,del,HG00442,0,,11685
2,239886768,239886918,del,NA18620,0,,150
2,173377072,173382646,del,HG00361,0,,5574
2,173179979,173186104,del,HG01334,0,,6125
2,91673854,92000735,del,HG01149,0,,326881
2,114570343,114572819,del,NA18637,0,,2476
2,36180716,36183072,del,NA18562,0,,2356
2,67759050,67766250,del,NA19917,0,,7200
2,239461577,239473523,del,NA20543,0,,11946
2,47880412,47881688,del,NA19399,0,,1276
2,43656298,43657085,del,HG01069,0,,787
2,227681548,227681718,del,HG00418,0,,170
2,152798556,152799189,del,NA19350,0,,633
2,178741004,178742105,del,NA19463,0,,1101
2,59096107,59096763,del,HG00326,0,,656
2,136113056,136114990,del,HG00699,0,,1934
2,218257543,218259344,del,NA19350,0,,1801
2,200179144,200183493,del,NA18517,0,,4349
2,163178379,163180410,del,NA19908,0,,2031
2,234394318,234399954,del,NA18597,0,,5636
2,89132516,89544022,del,HG00312,0,,411506
2,214353523,214353811,del,HG00583,0,,288
2,130954929,130957403,del,HG00152,0,,2474
2,83035638,83036416,del,NA18563,0,,778
2,241206467,241210666,del,NA19099,0,,4199
2,160095984,160100166,del,NA18566,0,,4182
2,102356600,102356915,del,NA19130,0,,315
2,37347651,37348407,del,HG01183,0,,756
2,36998553,36999545,del,HG00274,0,,992
2,57799344,57828739,del,NA11892,0,,29395
2,53898832,53899030,del,HG00252,0,,198
2,67507596,67508004,del,NA19463,0,,408
2,138469168,138469611,del,NA20348,0,,443
2,148440409,148440876,del,HG01170,0,,467
2,103997652,104001843,del,HG01079,0,,4191
2,97876347,97878195,del,NA18638,0,,1848
2,237678772,237682039,del,HG01389,0,,3267
2,39712319,39712953,del,NA19396,0,,634
2,193563112,193566665,del,HG00534,0,,3553
2,224501069,224501489,del,NA19780,0,,420
2,16932641,16934880,del,NA19703,0,,2239
2,61073958,61082519,del,NA19334,0,,8561
2,33717108,33727864,del,NA18552,0,,10756
2,26376092,26378874,del,NA19239,0,,2782
2,208523574,208525321,del,HG00257,0,,1747
2,72812691,72813925,del,NA19431,0,,1234
2,2189252,2189910,del,NA19712,0,,658
2,237537549,237537702,del,NA19355,0,,153
2,109310324,109312259,del,HG00650,0,,1935
2,77976759,77977091,del,HG00147,0,,332
2,219025851,219027217,del,NA19319,0,,1366
2,158118996,158119787,del,NA18960,0,,791
2,43129256,43129587,del,HG00124,0,,331
2,154895771,154899178,del,HG00476,0,,3407
2,236637556,236639241,del,NA19396,0,,1685
2,106695077,106695894,del,NA19077,0,,817
2,199168416,199170086,del,NA18501,0,,1670
2,234631477,234633986,del,HG00628,0,,2509
2,51183189,51185680,del,NA19404,0,,2491
2,184085521,184090946,del,HG01498,0,,5425
2,225161349,225166669,del,NA19213,0,,5320
2,183510417,183573530,del,NA18560,0,,63113
2,234395128,234399882,del,NA18597,0,,4754
2,79361991,79375804,del,NA19377,0,,13813
2,95604723,95607795,del,HG00277,0,,3072
2,154411684,154412006,del,NA19153,0,,322
2,227910955,227912102,del,NA18511,0,,1147
2,215649750,215651009,del,NA19474,0,,1259
2,241579482,241580450,del,NA19729,0,,968
2,238818900,238819133,del,HG01048,0,,233
2,242017539,242018567,del,NA19331,0,,1028
2,164887908,164890437,del,NA19819,0,,2529
2,196172266,196172822,del,HG00150,0,,556
2,226690249,226714002,del,NA18611,0,,23753
2,106348930,106351279,del,NA12842,0,,2349
2,32900026,32901130,del,NA18959,0,,1104
2,165614241,165647542,del,NA19834,0,,33301
2,172832578,172841005,del,NA19379,0,,8427
2,22811278,22811750,del,HG00309,0,,472
2,1968947,1969174,del,NA19985,0,,227
2,105469316,105474622,del,HG00183,0,,5306
2,87731116,87740722,del,HG01522,0,,9606
2,53249255,53252613,del,NA19711,0,,3358
2,53166759,53182198,del,NA12889,0,,15439
2,220052346,220052881,del,HG00112,0,,535
2,109503810,109504338,del,NA18596,0,,528
2,90380034,90381284,del,NA19107,0,,1250
2,73718791,73719356,del,NA18944,0,,565
2,85174402,85175805,del,HG00740,0,,1403
2,196908289,196908956,del,NA19247,0,,667
2,130196157,130200512,del,NA20795,0,,4355
2,36820364,36821614,del,NA18550,0,,1250
2,10702579,10706411,del,NA18526,0,,3832
2,89160438,89544253,del,HG00146,0,,383815
2,118018365,118033651,del,NA18535,0,,15286
2,227001141,227001316,del,NA18511,0,,175
2,398729,400729,del,NA19818,0,,2000
2,209943031,209948950,del,HG00285,0,,5919
2,2007930,2008791,del,NA18516,0,,861
2,66157628,66160397,del,NA18916,0,,2769
2,31455055,31455808,del,NA18982,0,,753
2,20915623,20916549,del,HG00243,0,,926
2,75908440,75910645,del,HG00740,0,,2205
2,100518362,100524717,del,HG00270,0,,6355
2,22864148,22864686,del,NA18505,0,,538
2,98168279,98172046,del,HG00662,0,,3767
2,71306425,71406677,del,NA19070,0,,100252
2,188505186,188505539,del,NA19129,0,,353
2,220423566,220423822,del,HG00231,0,,256
2,86056462,86056981,del,NA18534,0,,519
2,57779120,57784183,del,HG01101,0,,5063
2,28720738,28721280,del,HG00331,0,,542
2,24650563,24651789,del,HG00543,0,,1226
2,21552052,21554918,del,NA19440,0,,2866
2,142255130,142259519,del,HG00701,0,,4389
2,242542709,242542909,del,HG01350,0,,200
2,124170256,124170586,del,HG00500,0,,330
2,143135983,143136069,del,NA18519,0,,86
2,66046348,66055292,del,NA19072,0,,8944
2,9535886,9538037,del,NA19385,0,,2151
2,89132289,89309467,del,HG01356,0,,177178
2,69215813,69217342,del,NA19099,0,,1529
2,232678306,232678450,del,NA18961,0,,144
2,240854007,240854505,del,NA19471,0,,498
2,44095956,44098261,del,HG00708,0,,2305
2,22621278,22629500,del,NA18618,0,,8222
2,233827045,233828322,del,NA19380,0,,1277
2,97248673,97250144,del,NA19394,0,,1471
2,102232581,102233587,del,NA11893,0,,1006
2,179117152,179117826,del,NA19440,0,,674
2,845229,845802,del,NA18563,0,,573
2,135284923,135286893,del,HG01174,0,,1970
2,54744220,54744579,del,NA11920,0,,359
2,1218281,1218441,del,NA19375,0,,160
2,132273646,132274035,del,HG01462,0,,389
2,222065886,222067410,del,HG01342,0,,1524
2,44318598,44321179,del,NA18963,0,,2581
2,84527468,84527559,del,NA19114,0,,91
2,241718729,241718967,del,NA20341,0,,238
2,78976653,78978769,del,HG01083,0,,2116
2,213620960,213624810,del,NA19313,0,,3850
2,147548291,147554582,del,NA18501,0,,6291
2,205999232,205999669,del,HG00418,0,,437
2,43547815,43569318,del,HG01489,0,,21503
2,242396816,242397140,del,NA18595,0,,324
2,172907916,172910822,del,NA20502,0,,2906
2,117334924,117335240,del,NA12058,0,,316
2,95474295,95475599,del,NA18988,0,,1304
2,155373748,155374612,del,NA12272,0,,864
2,14343891,14348958,del,HG00556,0,,5067
2,307220,308870,del,NA19779,0,,1650
2,4184262,4188193,del,NA19470,0,,3931
2,49494607,49525712,del,NA20807,0,,31105
2,58444270,58447211,del,NA19247,0,,2941
2,62119721,62120706,del,NA19393,0,,985
2,50134700,50135511,del,NA12749,0,,811
2,84101234,84106320,del,NA18907,0,,5086
2,92261454,92262690,del,HG00315,0,,1236
2,219521411,219523368,del,NA18623,0,,1957
2,11474752,11475104,del,NA12878,0,,352
2,235841028,235843336,del,NA19451,0,,2308
2,241818436,241821152,del,NA18567,0,,2716
2,63497273,63502018,del,HG01101,0,,4745
2,161164383,161166933,del,NA19701,0,,2550
2,124166614,124167978,del,NA19679,0,,1364
2,44824986,44830338,del,NA19379,0,,5352
2,146417428,146418336,del,NA19818,0,,908
2,177591367,177591801,del,HG01383,0,,434
2,154686266,154687115,del,HG00683,0,,849
2,234329721,234330165,del,NA18973,0,,444
2,192809434,192810287,del,NA19332,0,,853
2,169587034,169588175,del,NA19075,0,,1141
2,193900455,193904651,del,HG00419,0,,4196
2,116865326,116866182,del,HG00117,0,,856
2,228268890,228270064,del,NA19240,0,,1174
2,167844952,167851208,del,HG00501,0,,6256
2,80427835,80428676,del,NA19455,0,,841
2,89160108,89246768,del,NA18501,0,,86660
2,133179958,133180846,del,NA18873,0,,888
2,225735969,225737648,del,HG01134,0,,1679
2,130249215,130254963,del,NA19359,0,,5748
2,56537585,56541082,del,NA20516,0,,3497
2,214914070,214914247,del,NA18516,0,,177
2,14191344,14198984,del,NA20773,0,,7640
2,240398247,240398511,del,HG00331,0,,264
2,5137414,5139633,del,NA19376,0,,2219
2,221568811,221572219,del,NA20799,0,,3408
2,97853544,97859162,del,NA12399,0,,5618
2,2178327,2179465,del,NA19819,0,,1138
2,195475409,195479599,del,HG01051,0,,4190
2,4714321,4737106,del,HG01148,0,,22785
2,85934769,85935112,del,HG00345,0,,343
2,8129694,8137173,del,NA11932,0,,7479
2,130437875,130445380,del,NA19197,0,,7505
2,115173294,115174909,del,HG00614,0,,1615
2,29641663,29645389,del,HG01456,0,,3726
2,123783289,123783518,del,NA20508,0,,229
2,122057066,122057922,del,NA19373,0,,856
2,242971303,242974354,del,NA18636,0,,3051
2,38308067,38313388,del,HG00342,0,,5321
2,57113430,57113770,del,NA18912,0,,340
2,59736964,59737276,del,NA19225,0,,312
2,3036531,3088371,del,NA19469,0,,51840
2,51767276,51777622,del,NA19449,0,,10346
2,43523453,43534554,del,NA19648,0,,11101
2,22062404,22064784,del,HG00242,0,,2380
2,122092170,122093699,del,NA19236,0,,1529
2,176203281,176210985,del,HG00335,0,,7704
2,130549379,130553556,del,NA19189,0,,4177
2,70552568,70552755,del,HG00689,0,,187
2,131450976,132057645,del,NA18873,0,,606669
2,134649021,134650309,del,NA20816,0,,1288
2,11994702,11995108,del,NA19663,0,,406
2,229410807,229422825,del,HG00560,0,,12018
2,24547139,24548358,del,HG01461,0,,1219
2,90160274,90163571,del,HG00320,0,,3297
2,211132734,211133038,del,NA18522,0,,304
2,235243959,235252214,del,NA18596,0,,8255
2,122266156,122271902,del,HG00512,0,,5746
2,195297135,195298444,del,NA20586,0,,1309
2,102406690,102406768,del,NA18622,0,,78
2,216858684,216859453,del,NA18501,0,,769
2,242945681,242945915,del,HG00464,0,,234
2,150759300,150759621,del,HG00256,0,,321
2,27413396,27415406,del,NA19393,0,,2010
2,53292310,53293079,del,HG00613,0,,769
2,105662103,105665588,del,HG00271,0,,3485
2,180680754,180683665,del,HG00653,0,,2911
2,163847032,163847744,del,NA19381,0,,712
2,10076624,10077797,del,NA19116,0,,1173
2,3612669,3612826,del,NA19453,0,,157
2,147984690,147986253,del,HG00320,0,,1563
2,89132416,89420322,del,HG00610,0,,287906
2,5830616,5834622,del,HG01389,0,,4006
2,239614055,239618355,del,NA19453,0,,4300
2,110945226,110945894,del,HG00657,0,,668
2,1625833,1625960,del,HG01060,0,,127
2,153797016,153799622,del,HG01101,0,,2606
2,44467107,44468831,del,HG00324,0,,1724
2,52793414,52798843,del,NA19373,0,,5429
2,5830216,5833622,del,HG00613,0,,3406
2,66577146,66580606,del,NA18628,0,,3460
2,207861827,207861910,del,NA18504,0,,83
2,26822757,26823089,del,HG00372,0,,332
2,5845562,5846564,del,NA19428,0,,1002
2,213329683,213333183,del,NA19456,0,,3500
2,89161059,89214538,del,NA18907,0,,53479
2,213735798,213741232,del,NA18619,0,,5434
2,208706910,208709282,del,NA20815,0,,2372
2,182642194,182642635,del,NA18544,0,,441
2,137285510,137287722,del,NA19004,0,,2212
2,49413661,49413833,del,NA18622,0,,172
2,209492333,209496377,del,NA19703,0,,4044
2,231884072,231885252,del,HG00650,0,,1180
2,157400834,157401192,del,HG00537,0,,358
2,78650804,78677622,del,NA19652,0,,26818
2,174797263,174800946,del,HG00693,0,,3683
2,25148416,25148565,del,HG01378,0,,149
2,54396419,54399327,del,NA20812,0,,2908
2,189119619,189120982,del,NA18983,0,,1363
2,116501208,116503398,del,NA19654,0,,2190
2,15156443,15197787,del,NA18615,0,,41344
2,190346817,190347523,del,NA18561,0,,706
2,55928481,55930881,del,NA19010,0,,2400
2,149874511,149878695,del,NA18545,0,,4184
2,107269449,107269743,del,NA19399,0,,294
2,75363348,75376658,del,NA12154,0,,13310
2,119432955,119436451,del,NA19455,0,,3496
2,136222840,136222950,del,HG00614,0,,110
2,218673925,218674228,del,HG01125,0,,303
2,30546097,30546791,del,NA18599,0,,694
2,36761565,36761710,del,NA18505,0,,145
2,56828111,56829855,del,NA07346,0,,1744
2,78566417,78571817,del,HG00428,0,,5400
2,1101746,1101925,del,NA19700,0,,179
2,206999229,207000276,del,NA19332,0,,1047
2,171929241,171932691,del,NA20773,0,,3450
2,61067448,61073338,del,NA19334,0,,5890
2,238665546,238665721,del,NA18573,0,,175
2,74677126,74679247,del,NA19463,0,,2121
2,97705370,97708305,del,HG00531,0,,2935
2,108517632,109131903,del,NA18985,0,,614271
2,57343539,57344143,del,HG00704,0,,604
2,35034437,35034682,del,NA19467,0,,245
2,212351220,212415770,del,HG00269,0,,64550
2,167448004,167448001,del,NA11993,0,,-3
2,133719910,133720694,del,NA19663,0,,784
2,224619273,224619870,del,NA18870,0,,597
2,195828927,195830832,del,NA18950,0,,1905
2,89132292,89277975,del,NA18501,0,,145683
2,1526055,1526151,del,HG01389,0,,96
2,44308492,44308817,del,NA18507,0,,325
2,201836478,201837356,del,HG00543,0,,878
2,205343851,205349156,del,NA19704,0,,5305
2,34827208,34829303,del,NA18868,0,,2095
2,87625641,87655943,del,NA19399,0,,30302
2,242751806,242751890,del,NA18562,0,,84
2,175839184,175841876,del,NA18960,0,,2692
2,202603851,202604939,del,NA19381,0,,1088
2,2007741,2008588,del,NA18510,0,,847
2,232434312,232439498,del,HG01107,0,,5186
2,96399707,96405492,del,HG01066,0,,5785
2,128651619,128654184,del,HG00478,0,,2565
2,230427919,230429217,del,NA18499,0,,1298
2,82541123,82547622,del,NA19380,0,,6499
2,114526817,114531698,del,NA19239,0,,4881
2,208374430,208375990,del,HG00278,0,,1560
2,151509144,151515491,del,HG00592,0,,6347
2,32837435,32837632,del,NA19129,0,,197
2,165483422,165486519,del,HG00692,0,,3097
2,1023333,1023467,del,NA18572,0,,134
2,227562650,227563933,del,HG01187,0,,1283
2,22328337,22331847,del,HG00346,0,,3510
2,226782210,226786927,del,NA20536,0,,4717
2,102126079,102128583,del,HG00593,0,,2504
2,222232813,222233293,del,NA19129,0,,480
2,2798772,2799242,del,HG00133,0,,470
2,16935237,16937720,del,NA19703,0,,2483
2,389328,390466,del,NA12489,0,,1138
2,238310021,238315314,del,HG01456,0,,5293
2,31942954,31958397,del,NA19431,0,,15443
2,137266910,137273409,del,HG00705,0,,6499
2,173004238,173007480,del,NA19152,0,,3242
2,130243436,130249504,del,NA19397,0,,6068
2,16271567,16273799,del,NA20506,0,,2232
2,134592050,134593331,del,NA19082,0,,1281
2,156167311,156178754,del,NA18572,0,,11443
2,119653317,119659368,del,NA19004,0,,6051
2,160694125,160694213,del,NA18489,0,,88
2,67816945,67820557,del,NA18963,0,,3612
2,234140196,234141933,del,NA20769,0,,1737
2,170105115,170111162,del,NA07037,0,,6047
2,35827768,35831876,del,HG00705,0,,4108
2,197793138,197793304,del,HG00657,0,,166
2,146884857,146887382,del,NA18610,0,,2525
2,226454001,226463077,del,NA19099,0,,9076
2,62350359,62351153,del,NA19404,0,,794
2,126648005,126654138,del,HG01072,0,,6133
2,151031138,151038246,del,NA20586,0,,7108
2,169084371,169094271,del,NA19717,0,,9900
2,138470702,138470938,del,NA18523,0,,236
2,118384475,118410408,del,NA20344,0,,25933
2,131436010,132042732,del,HG01354,0,,606722
2,153460023,153461186,del,NA18534,0,,1163
2,161648811,161649520,del,HG00635,0,,709
2,178287637,178288061,del,HG00578,0,,424
2,203295425,203312915,del,NA19107,0,,17490
2,227165424,227171169,del,NA20539,0,,5745
2,90239972,90248706,del,HG00243,0,,8734
2,184686820,184699166,del,NA20539,0,,12346
2,208168962,208174323,del,HG01052,0,,5361
2,206929944,206935194,del,HG00740,0,,5250
2,173391384,173392546,del,NA18868,0,,1162
2,35287467,35290627,del,NA19921,0,,3160
2,18118862,18120016,del,HG00146,0,,1154
2,164144217,164144357,del,HG00671,0,,140
2,34151388,34152192,del,NA19456,0,,804
2,127312250,127348917,del,HG00731,0,,36667
2,162446483,162449358,del,NA12827,0,,2875
2,71272731,71273046,del,NA18983,0,,315
2,51937645,51942111,del,NA19473,0,,4466
2,239453053,239454317,del,HG01465,0,,1264
2,81584269,81584981,del,NA19443,0,,712
2,176190118,176190259,del,HG00584,0,,141
2,79331825,79339573,del,NA19471,0,,7748
2,213415609,213422076,del,HG01075,0,,6467
2,5449506,5450064,del,NA18856,0,,558
2,67612202,67613280,del,NA18517,0,,1078
2,83066838,83068234,del,HG00342,0,,1396
2,124157435,124160948,del,HG00537,0,,3513
2,104187050,104187208,del,HG00338,0,,158
2,233292850,233296570,del,NA19248,0,,3720
2,242881824,242896342,del,NA18520,0,,14518
2,54513214,54517731,del,NA19437,0,,4517
2,62057983,62059007,del,NA19070,0,,1024
2,113460459,113484651,del,NA18960,0,,24192
2,1641312,1641615,del,NA19009,0,,303
2,67271281,67331279,del,NA18989,0,,59998
2,194833619,194838619,del,NA19355,0,,5000
2,14521915,14567033,del,NA20790,0,,45118
2,128223691,128225824,del,HG00637,0,,2133
2,41638937,41639603,del,NA18523,0,,666
2,119158946,119160857,del,NA19116,0,,1911
2,100776861,100779618,del,HG01108,0,,2757
2,25079765,25082123,del,HG00671,0,,2358
2,121821002,121823793,del,HG00346,0,,2791
2,24599953,24611505,del,NA19439,0,,11552
2,133085452,133088161,del,HG00689,0,,2709
2,65285620,65287149,del,NA18486,0,,1529
2,61635027,61640579,del,NA20809,0,,5552
2,56827154,56830351,del,HG01173,0,,3197
2,213465999,213470444,del,NA19093,0,,4445
2,30303126,30303272,del,HG00274,0,,146
2,186740881,186748949,del,NA19660,0,,8068
2,214846564,214846919,del,NA18501,0,,355
2,187827569,187827688,del,HG00442,0,,119
2,66008584,66009736,del,HG00542,0,,1152
2,195979936,195983618,del,HG01492,0,,3682
2,89160431,89567756,del,NA18940,0,,407325
2,35060103,35068519,del,NA19374,0,,8416
2,166012902,166016518,del,HG01488,0,,3616
2,203219547,203222243,del,NA19346,0,,2696
2,174562591,174562857,del,HG01465,0,,266
2,39406473,39420081,del,NA19072,0,,13608
2,76706591,76707200,del,HG00651,0,,609
2,130544848,130555544,del,NA18907,0,,10696
2,209335127,209335389,del,NA19147,0,,262
2,203899071,203904306,del,HG00261,0,,5235
2,71214074,71214658,del,HG01489,0,,584
2,5845572,5846428,del,NA18856,0,,856
2,67974875,67975068,del,HG00237,0,,193
2,10551945,10557801,del,NA19066,0,,5856
2,239456853,239460361,del,NA19676,0,,3508
2,242987113,242987354,del,NA19397,0,,241
2,231325294,231325637,del,HG00247,0,,343
2,133151424,133152300,del,NA18910,0,,876
2,150916725,150918159,del,HG00610,0,,1434
2,211892111,211901597,del,NA19474,0,,9486
2,11994183,11995195,del,NA19717,0,,1012
2,214431871,214437989,del,NA18502,0,,6118
2,231705995,231706948,del,NA18520,0,,953
2,117728479,117736191,del,NA18523,0,,7712
2,214988939,214993861,del,HG01375,0,,4922
2,208934368,208941834,del,NA19398,0,,7466
2,185179189,185181967,del,HG00111,0,,2778
2,81073413,81074022,del,NA18907,0,,609
2,131482,131662,del,NA18557,0,,180
2,209942916,209949322,del,HG01048,0,,6406
2,172805890,172807486,del,NA07048,0,,1596
2,122564384,122564701,del,NA18570,0,,317
2,181453907,181454631,del,HG01491,0,,724
2,214062246,214069532,del,NA19377,0,,7286
2,142255009,142259308,del,HG00701,0,,4299
2,203295616,203314122,del,NA19909,0,,18506
2,193554624,193559147,del,HG00613,0,,4523
2,72172349,72183245,del,HG00513,0,,10896
2,217378302,217379863,del,HG00437,0,,1561
2,225219929,225220468,del,NA18486,0,,539
2,102302294,102306945,del,HG00330,0,,4651
2,139975608,139976093,del,NA18499,0,,485
2,241200150,241200819,del,NA19057,0,,669
2,234932251,234945492,del,NA19375,0,,13241
2,25274215,25275042,del,NA18499,0,,827
2,51433291,51435855,del,NA19350,0,,2564
2,38706833,38707031,del,NA19380,0,,198
2,111860307,111862041,del,NA19446,0,,1734
2,222987883,222989457,del,NA18624,0,,1574
2,30531981,30536207,del,NA20770,0,,4226
2,239902389,239902561,del,HG01073,0,,172
2,167079160,167079502,del,NA19114,0,,342
2,36057971,36058806,del,NA18956,0,,835
2,124843845,124845459,del,NA19452,0,,1614
2,31709977,31710759,del,NA19235,0,,782
2,240640400,240640518,del,HG00328,0,,118
2,11503602,11504586,del,NA20585,0,,984
2,142325301,142329046,del,NA12761,0,,3745
2,132827428,132827589,del,NA18602,0,,161
2,160098166,160100022,del,NA18516,0,,1856
2,67679085,67679234,del,HG00116,0,,149
2,8568482,8583775,del,HG00656,0,,15293
2,4651630,4653945,del,NA19900,0,,2315
2,56071107,56071397,del,NA20506,0,,290
2,118881403,118882291,del,NA19654,0,,888
2,83079850,83081195,del,HG00580,0,,1345
2,219275161,219289547,del,NA18620,0,,14386
2,57548616,57553472,del,NA18487,0,,4856
2,53821472,53821844,del,NA19472,0,,372
2,178857976,178859101,del,NA18609,0,,1125
2,30732463,30733129,del,NA18870,0,,666
2,206412715,206417423,del,HG00565,0,,4708
2,210970707,210971976,del,NA19438,0,,1269
2,52130685,52133244,del,NA19004,0,,2559
2,84298255,84299329,del,NA19834,0,,1074
2,226955071,226962108,del,NA18934,0,,7037
2,234476566,234477322,del,HG00693,0,,756
2,199686413,199696151,del,NA18984,0,,9738
2,14531291,14531618,del,NA18627,0,,327
2,134745636,134754105,del,HG00525,0,,8469
2,184921025,184931630,del,NA19334,0,,10605
2,98140116,98158222,del,NA20585,0,,18106
2,215728761,215730831,del,NA19074,0,,2070
2,106879557,106885915,del,HG00306,0,,6358
2,195477627,195477734,del,HG00321,0,,107
2,59623256,59631048,del,NA18989,0,,7792
2,133669648,133674444,del,HG00182,0,,4796
2,237623302,237623816,del,HG00448,0,,514
2,33224462,33227292,del,HG00404,0,,2830
2,38944837,38947070,del,NA18619,0,,2233
2,169332781,169335727,del,HG00479,0,,2946
2,242055281,242055564,del,NA19359,0,,283
2,28359754,28360349,del,NA19077,0,,595
2,123364878,123365376,del,NA19059,0,,498
2,24439572,24439985,del,HG01437,0,,413
2,73138439,73141255,del,HG00148,0,,2816
2,14469279,14470809,del,NA19379,0,,1530
2,227735969,227743651,del,NA19063,0,,7682
2,49179710,49248217,del,NA19726,0,,68507
2,239482930,239484868,del,NA19130,0,,1938
2,156733512,156741092,del,NA19466,0,,7580
2,13171157,13171438,del,NA19834,0,,281
2,143926139,143927714,del,HG00231,0,,1575
2,29957972,29963352,del,NA18858,0,,5380
2,242919307,242952131,del,NA06984,0,,32824
2,219931778,219932062,del,NA12750,0,,284
2,76844758,76845505,del,NA11933,0,,747
2,163587666,163587972,del,HG01170,0,,306
2,67811099,67812786,del,HG00123,0,,1687
2,240409289,240411604,del,NA18989,0,,2315
2,125793154,125800767,del,HG00183,0,,7613
2,71904840,71907005,del,NA12761,0,,2165
2,240202642,240202866,del,HG00336,0,,224
2,103109650,103110895,del,NA19360,0,,1245
2,38960330,38961709,del,NA20760,0,,1379
2,196736411,196736690,del,NA19200,0,,279
2,10374009,10374159,del,HG00436,0,,150
2,111883194,111886097,del,HG00543,0,,2903
2,129456016,129463822,del,NA19059,0,,7806
2,166014693,166016744,del,NA18602,0,,2051
2,70491522,70496531,del,HG00274,0,,5009
2,127926188,127929500,del,HG00513,0,,3312
2,101569485,101569664,del,HG00281,0,,179
2,4210916,4222972,del,HG00131,0,,12056
2,6973174,6986127,del,NA20507,0,,12953
2,29228189,29228854,del,NA19444,0,,665
2,165499227,165499485,del,NA18517,0,,258
2,172904866,172910572,del,NA20332,0,,5706
2,128804219,128805218,del,NA19713,0,,999
2,188096551,188105779,del,NA20281,0,,9228
2,78427017,78427972,del,NA18511,0,,955
2,63496913,63502365,del,HG01101,0,,5452
2,147941341,147946809,del,HG00610,0,,5468
2,126678222,126681976,del,HG00182,0,,3754
2,4210816,4222022,del,NA12154,0,,11206
2,235259877,235261493,del,NA19350,0,,1616
2,44484266,44491352,del,NA20535,0,,7086
2,240288478,240288752,del,NA19240,0,,274
2,34695616,34736422,del,HG01519,0,,40806
2,121664270,121666860,del,NA18619,0,,2590
2,148574410,148575554,del,HG01465,0,,1144
2,132429580,132430485,del,HG01383,0,,905
2,168829952,168836182,del,NA19065,0,,6230
2,17865333,17867490,del,HG00501,0,,2157
2,19987251,19987811,del,NA19240,0,,560
2,52351244,52351472,del,HG00478,0,,228
2,32331908,32335317,del,NA19236,0,,3409
2,130166916,130173122,del,NA18856,0,,6206
2,221882974,221883170,del,HG00449,0,,196
2,216553785,216553919,del,HG00318,0,,134
2,183989568,183990105,del,NA19657,0,,537
2,59624266,59630472,del,HG00472,0,,6206
2,131893712,131894772,del,NA19239,0,,1060
2,195946658,195948677,del,HG00261,0,,2019
2,17606471,17608134,del,NA19138,0,,1663
2,5736051,5737331,del,NA12273,0,,1280
2,242503259,242503955,del,HG01069,0,,696
2,36998544,36999554,del,HG00565,0,,1010
2,16580948,16581519,del,NA19712,0,,571
2,238373409,238373616,del,NA18612,0,,207
2,214448920,214449548,del,NA18907,0,,628
2,159002672,159011168,del,NA19391,0,,8496
2,225753289,225753493,del,NA18559,0,,204
2,192564562,192564704,del,HG00421,0,,142
2,19186016,19224922,del,NA19676,0,,38906
2,90267516,90276722,del,HG01149,0,,9206
2,116974633,116978303,del,HG00419,0,,3670
2,222678608,222680981,del,NA19716,0,,2373
2,96598266,96631646,del,HG01069,0,,33380
2,21104235,21131132,del,HG01080,0,,26897
2,146842402,146842549,del,NA19670,0,,147
2,105545573,105550058,del,HG01390,0,,4485
2,126363089,126371860,del,NA18635,0,,8771
2,123400735,123411039,del,HG00422,0,,10304
2,1723711,1724052,del,NA18602,0,,341
2,57519748,57520499,del,NA19385,0,,751
2,173702864,173704307,del,HG01101,0,,1443
2,3825559,3825683,del,HG00273,0,,124
2,154446088,154453026,del,NA18555,0,,6938
2,11841298,11842035,del,NA20753,0,,737
2,48990526,48991164,del,NA12045,0,,638
2,175396086,175398637,del,HG01173,0,,2551
2,2652852,2653230,del,NA19679,0,,378
2,138611859,138613240,del,NA19440,0,,1381
2,106388512,106391430,del,NA20756,0,,2918
2,39829989,39837095,del,HG00281,0,,7106
2,195312222,195326359,del,NA19448,0,,14137
2,1706916,1707822,del,NA20530,0,,906
2,109691466,109695372,del,HG00373,0,,3906
2,176308884,176314475,del,NA18973,0,,5591
2,153816435,153821753,del,NA19676,0,,5318
2,195981516,195986222,del,NA18960,0,,4706
2,73430931,73431243,del,NA18968,0,,312
2,67319165,67334447,del,NA18973,0,,15282
2,442180,442419,del,HG00650,0,,239
2,81361545,81368768,del,NA11830,0,,7223
2,46023396,46031310,del,HG00311,0,,7914
2,218254719,218259335,del,NA19350,0,,4616
2,69712546,69724503,del,HG00328,0,,11957
2,25103428,25105030,del,NA19428,0,,1602
2,36986401,36990994,del,NA10851,0,,4593
2,136098340,136101571,del,NA19914,0,,3231
2,115727940,115741283,del,NA18557,0,,13343
2,241890579,241890764,del,NA19819,0,,185
2,22351944,22359666,del,NA18614,0,,7722
2,130232035,130243164,del,NA19376,0,,11129
2,201074471,201079207,del,HG00151,0,,4736
2,76336945,76338089,del,NA20287,0,,1144
2,239290379,239295657,del,NA20531,0,,5278
2,193393004,193394754,del,NA19834,0,,1750
2,203295716,203313122,del,NA19138,0,,17406
2,52587874,52594839,del,NA20527,0,,6965
2,89132516,89544422,del,NA20813,0,,411906
2,18574230,18574524,del,HG00634,0,,294
2,106272603,106272911,del,HG01111,0,,308
2,166669677,166674170,del,NA18622,0,,4493
2,59355685,59358654,del,HG00437,0,,2969
2,6400508,6402193,del,NA11931,0,,1685
2,163934117,163935794,del,NA19116,0,,1677
2,59355685,59358683,del,HG00437,0,,2998
2,217955891,217957266,del,NA18498,0,,1375
2,225058838,225067848,del,HG00543,0,,9010
2,4280115,4281402,del,HG00306,0,,1287
2,159724621,159740624,del,NA19472,0,,16003
2,128216578,128218061,del,NA12750,0,,1483
2,222085742,222089603,del,NA19355,0,,3861
2,195363692,195367441,del,HG00327,0,,3749
2,2189651,2189970,del,NA20276,0,,319
2,184913239,184927850,del,HG00139,0,,14611
2,4881890,4887884,del,HG00702,0,,5994
2,187556354,187556715,del,NA19189,0,,361
2,132221718,132223860,del,NA18498,0,,2142
2,241124781,241125027,del,NA18964,0,,246
2,89260819,89303654,del,NA19213,0,,42835
2,125651791,125659029,del,NA19914,0,,7238
2,56461626,56464228,del,HG00614,0,,2602
2,21271994,21275694,del,NA20544,0,,3700
2,56847529,56853124,del,NA18623,0,,5595
2,10837776,10837918,del,HG00701,0,,142
2,190272310,190277223,del,NA19452,0,,4913
2,102393809,102401441,del,NA19238,0,,7632
2,213525923,213526342,del,NA19375,0,,419
2,6436759,6437192,del,HG01148,0,,433
2,231564424,231567637,del,NA19213,0,,3213
2,180226918,180227454,del,NA19701,0,,536
2,129784538,129787189,del,HG00138,0,,2651
2,230319588,230328060,del,NA18867,0,,8472
2,14236177,14236757,del,NA19318,0,,580
2,130493305,130493676,del,HG00125,0,,371
2,208474482,208476784,del,NA19063,0,,2302
2,175459318,175459572,del,NA19376,0,,254
2,32146,34838,del,NA11894,0,,2692
2,62457099,62457426,del,NA19087,0,,327
2,35872628,35873898,del,NA19012,0,,1270
2,57242169,57245381,del,HG01345,0,,3212
2,117594339,117625039,del,HG00421,0,,30700
2,47327351,47335056,del,HG01048,0,,7705
2,172906516,172910722,del,HG01148,0,,4206
2,17041621,17043383,del,NA18546,0,,1762
2,105333692,105334494,del,HG01047,0,,802
2,31342725,31343040,del,HG00276,0,,315
2,236396773,236397205,del,HG00608,0,,432
2,4212676,4223478,del,HG01188,0,,10802
2,145593011,145594084,del,NA18597,0,,1073
2,164641197,164646489,del,NA18973,0,,5292
2,208351416,208359422,del,NA12342,0,,8006
2,151659837,151662996,del,NA19384,0,,3159
2,157881426,157884916,del,NA12347,0,,3490
2,102124409,102129163,del,HG00119,0,,4754
2,398564,400516,del,HG00699,0,,1952
2,51836536,51845259,del,HG00284,0,,8723
2,15285047,15288047,del,NA19093,0,,3000
2,220053145,220056233,del,HG01148,0,,3088
2,123989134,123989464,del,NA19247,0,,330
2,37746416,37747322,del,HG00123,0,,906
2,108275310,108279108,del,NA11829,0,,3798
2,116662076,116662656,del,NA19398,0,,580
2,222289674,222289879,del,NA19461,0,,205
2,232580430,232580602,del,NA20346,0,,172
2,55634250,55636191,del,NA19114,0,,1941
2,194810947,194813519,del,NA18871,0,,2572
2,121058506,121067579,del,NA20809,0,,9073
2,235812266,235812577,del,NA19448,0,,311
2,229449510,229452062,del,NA19700,0,,2552
2,50481032,50481796,del,NA19172,0,,764
2,42346259,42347318,del,NA19129,0,,1059
2,170646258,170647846,del,NA19236,0,,1588
2,130242244,130251411,del,NA12878,0,,9167
2,17865280,17867452,del,HG00501,0,,2172
2,62347939,62348962,del,NA12751,0,,1023
2,218695605,218695862,del,HG00154,0,,257
2,79331525,79339582,del,NA19819,0,,8057
2,78863041,78866294,del,HG00174,0,,3253
2,197614616,197614948,del,NA19770,0,,332
2,82757145,82757444,del,HG01069,0,,299
2,207706339,207708115,del,NA20534,0,,1776
2,184625110,184628375,del,HG00662,0,,3265
2,64479607,64484388,del,HG00177,0,,4781
2,97852857,97858492,del,HG01378,0,,5635
2,118224116,118227622,del,HG00276,0,,3506
2,208351016,208359422,del,HG01113,0,,8406
2,239718227,239719155,del,NA18989,0,,928
2,162001725,162002451,del,NA19379,0,,726
2,28642605,28645806,del,HG00553,0,,3201
2,92260916,92263022,del,NA20759,0,,2106
2,29228568,29228637,del,NA18613,0,,69
2,3848195,3848453,del,HG00707,0,,258
2,226744345,226745236,del,HG00705,0,,891
2,72906389,72914656,del,HG01378,0,,8267
2,174327626,174330787,del,HG00554,0,,3161
2,133671902,133674394,del,HG00320,0,,2492
2,107418355,107420739,del,NA20531,0,,2384
2,89132516,89551522,del,NA19428,0,,419006
2,220946412,220946561,del,NA19474,0,,149
2,242867328,242921102,del,HG00613,0,,53774
2,236643588,236643733,del,HG00324,0,,145
2,202779647,202780310,del,NA19456,0,,663
2,27637605,27639836,del,NA19463,0,,2231
2,33126527,33126764,del,NA19257,0,,237
2,205706116,205712053,del,NA19247,0,,5937
2,144514453,144517413,del,NA19077,0,,2960
2,174602619,174602934,del,HG00707,0,,315
2,113843603,113843908,del,NA19712,0,,305
2,234942685,234956007,del,NA18511,0,,13322
2,8043622,8043609,del,HG00319,0,,-13
2,189267259,189277248,del,HG01134,0,,9989
2,41199079,41199196,del,HG00138,0,,117
2,212598163,212598704,del,NA19436,0,,541
2,7229955,7235772,del,NA19439,0,,5817
2,140716332,140718792,del,NA19312,0,,2460
2,1706765,1707236,del,HG01055,0,,471
2,51009200,51016002,del,HG01375,0,,6802
2,38851419,38851728,del,NA19722,0,,309
2,147941341,147946806,del,NA18614,0,,5465
2,47152623,47158809,del,HG00512,0,,6186
2,306492,307197,del,NA19675,0,,705
2,114444742,114445653,del,NA19079,0,,911
2,185985825,185987838,del,NA18941,0,,2013
2,177799434,177802693,del,NA19391,0,,3259
2,15819121,15819332,del,NA12891,0,,211
2,151686699,151687893,del,NA19443,0,,1194
2,215505268,215556279,del,HG00323,0,,51011
2,168845295,168848800,del,NA19468,0,,3505
2,239456441,239458716,del,HG00701,0,,2275
2,200312455,200312679,del,HG00243,0,,224
2,203897316,203904122,del,HG01183,0,,6806
2,49038417,49056204,del,NA20510,0,,17787
2,131382837,132362791,del,HG01067,0,,979954
2,189267305,189277320,del,HG01134,0,,10015
2,129456290,129463170,del,NA19072,0,,6880
2,1540699,1541451,del,NA19445,0,,752
2,140522682,140574091,del,HG00143,0,,51409
2,51504569,51507669,del,NA19377,0,,3100
2,181796938,181798947,del,NA18636,0,,2009
2,214349772,214354561,del,NA19456,0,,4789
2,2386348,2392153,del,HG01108,0,,5805
2,239500395,239501732,del,NA18562,0,,1337
2,89132282,89399343,del,NA19077,0,,267061
2,67324566,67329168,del,NA18535,0,,4602
2,208037755,208041905,del,NA19383,0,,4150
2,126814801,126820072,del,HG01051,0,,5271
2,25682574,25683994,del,HG00122,0,,1420
2,146884929,146889385,del,NA19078,0,,4456
2,198758395,198761639,del,HG00141,0,,3244
2,180065450,180081661,del,HG00345,0,,16211
2,222532639,222540318,del,NA19473,0,,7679
2,124093035,124093471,del,HG01108,0,,436
2,226121826,226127227,del,HG00683,0,,5401
2,70384499,70386475,del,HG01197,0,,1976
2,239779627,239780181,del,NA18963,0,,554
2,85189329,85194584,del,NA19446,0,,5255
2,233364546,233364739,del,NA18543,0,,193
2,78701452,78723025,del,HG00309,0,,21573
2,232849574,232857147,del,NA19462,0,,7573
2,122478085,122478473,del,HG01149,0,,388
2,48122083,48128212,del,HG00421,0,,6129
2,19767581,19770562,del,HG01384,0,,2981
2,82877071,82879005,del,NA19107,0,,1934
2,95450951,95453596,del,HG00236,0,,2645
2,232922092,232928258,del,NA19002,0,,6166
2,134423448,134426300,del,NA19900,0,,2852
2,130063715,130066337,del,NA07037,0,,2622
2,197313699,197317542,del,HG01095,0,,3843
2,128220313,128222542,del,NA19236,0,,2229
2,107165516,107167822,del,HG00556,0,,2306
2,148169767,148171249,del,NA19334,0,,1482
2,44612639,44614529,del,HG00331,0,,1890
2,36075973,36085989,del,HG01390,0,,10016
2,42741649,42742302,del,NA18599,0,,653
2,138735516,138737422,del,HG00531,0,,1906
2,4681549,4681837,del,NA19108,0,,288
2,133151046,133152230,del,NA18933,0,,1184
2,66031483,66036224,del,NA19625,0,,4741
2,208486241,208487421,del,NA18961,0,,1180
2,81812099,81816819,del,NA19130,0,,4720
2,57007526,57012381,del,NA19776,0,,4855
2,70432559,70433237,del,NA19462,0,,678
2,95730817,95736955,del,HG00651,0,,6138
2,107899183,107903821,del,HG01133,0,,4638
2,30607671,30608535,del,NA19239,0,,864
2,46312696,46312947,del,NA18488,0,,251
2,38185478,38187120,del,NA18519,0,,1642
2,68710078,68716212,del,NA18499,0,,6134
2,206845198,206845314,del,HG00260,0,,116
2,216782147,216782520,del,HG00628,0,,373
2,97854244,97856134,del,HG00263,0,,1890
2,42684845,42685670,del,HG00277,0,,825
2,4781291,4787356,del,HG00336,0,,6065
2,196428217,196428576,del,NA18559,0,,359
2,17102400,17104210,del,NA18487,0,,1810
2,29731190,29737144,del,NA19818,0,,5954
2,229448916,229452922,del,NA19347,0,,4006
2,130554155,130558786,del,NA19236,0,,4631
2,44465416,44468672,del,HG00320,0,,3256
2,84490003,84494796,del,NA19380,0,,4793
2,211232467,211238754,del,HG01440,0,,6287
2,226829141,226831028,del,NA19474,0,,1887
2,206113943,206121614,del,NA12778,0,,7671
2,231659041,231662104,del,HG00139,0,,3063
2,241087073,241087455,del,NA20342,0,,382
2,174151785,174152103,del,NA19818,0,,318
2,65676037,65676396,del,HG00372,0,,359
2,35078527,35093110,del,NA19138,0,,14583
2,126328477,126329671,del,HG01173,0,,1194
2,129356064,129356322,del,HG00334,0,,258
2,214759900,214760127,del,NA18909,0,,227
2,42986946,42988288,del,NA18910,0,,1342
2,228651318,228658062,del,NA19107,0,,6744
2,237537507,237537711,del,HG01073,0,,204
2,29227762,29228664,del,NA20770,0,,902
2,84829300,84830063,del,HG00589,0,,763
2,155891178,155891494,del,HG01171,0,,316
2,90240078,90248805,del,HG00243,0,,8727
2,226191608,226195916,del,NA18504,0,,4308
2,165850155,165865306,del,NA20508,0,,15151
2,208144306,208147091,del,NA19466,0,,2785
2,70850847,70855687,del,NA19921,0,,4840
2,89291917,89384671,del,NA12413,0,,92754
2,70308668,70309732,del,HG00327,0,,1064
2,45725254,45736488,del,HG00108,0,,11234
2,153205322,153205649,del,HG00361,0,,327
2,232580503,232580592,del,NA18853,0,,89
2,107236282,107236856,del,NA19472,0,,574
2,76932221,76952980,del,HG00182,0,,20759
2,133669639,133674453,del,HG00182,0,,4814
2,108499963,109116846,del,NA19012,0,,616883
2,62566277,62567759,del,NA19440,0,,1482
2,57242160,57245231,del,NA19719,0,,3071
2,161288077,161289410,del,HG01390,0,,1333
2,121826515,121828154,del,HG00346,0,,1639
2,49561482,49561626,del,HG01488,0,,144
2,139104470,139105564,del,NA19395,0,,1094
2,224142338,224144126,del,HG00253,0,,1788
2,56064753,56066068,del,NA12155,0,,1315
2,55323854,55336822,del,NA20541,0,,12968
2,136485156,136487211,del,HG00189,0,,2055
2,121590528,121592349,del,NA18986,0,,1821
2,79076570,79081206,del,NA18987,0,,4636
2,113045414,113047137,del,NA19445,0,,1723
2,175169286,175171486,del,HG01462,0,,2200
2,39754665,39755436,del,HG00256,0,,771
2,197426,197651,del,NA20536,0,,225
2,56321107,56328494,del,NA19435,0,,7387
2,188638314,188642266,del,NA19467,0,,3952
2,135595292,135596271,del,HG01083,0,,979
2,143967831,143968531,del,HG00179,0,,700
2,108016608,108019316,del,NA19713,0,,2708
2,127718903,127722347,del,NA20340,0,,3444
2,181320690,181323619,del,NA18617,0,,2929
2,110278183,110278489,del,HG00338,0,,306
2,44098418,44098565,del,HG01079,0,,147
2,52635608,52636451,del,NA19058,0,,843
2,77363893,77364650,del,NA19093,0,,757
2,121427313,121428088,del,NA18622,0,,775
2,237333265,237335184,del,NA19130,0,,1919
2,44082349,44086770,del,NA18595,0,,4421
2,1217386,1217885,del,HG00131,0,,499
2,193844785,193898125,del,HG00689,0,,53340
2,173554470,173556235,del,NA18534,0,,1765
2,148372237,148375628,del,NA19394,0,,3391
2,158343171,158345868,del,NA18559,0,,2697
2,138275257,138278729,del,HG00442,0,,3472
2,19406393,19409964,del,NA19404,0,,3571
2,92292495,92321913,del,NA19352,0,,29418
2,145356400,145379689,del,HG00146,0,,23289
2,31124824,31132535,del,NA18567,0,,7711
2,31342720,31343013,del,HG01334,0,,293
2,203891336,203898037,del,HG00653,0,,6701
2,208534461,208534612,del,NA19397,0,,151
2,132221916,132224322,del,NA20332,0,,2406
2,42005984,42009535,del,NA19452,0,,3551
2,41921748,41923053,del,NA19468,0,,1305
2,98385307,98385703,del,HG00566,0,,396
2,224473100,224473334,del,NA18550,0,,234
2,89458930,89495514,del,NA19003,0,,36584
2,98769134,98772307,del,NA18572,0,,3173
2,24687215,24687794,del,HG00159,0,,579
2,16932659,16935010,del,NA19703,0,,2351
2,150392864,150394559,del,HG00369,0,,1695
2,177612218,177614205,del,HG00734,0,,1987
2,18435693,18438971,del,NA19213,0,,3278
2,106347811,106353321,del,HG00150,0,,5510
2,204181670,204191741,del,HG00179,0,,10071
2,127447790,127451399,del,NA20806,0,,3609
2,240001488,240001887,del,NA19430,0,,399
2,2627237,2628761,del,HG00106,0,,1524
2,40927063,40949263,del,HG00628,0,,22200
2,40612419,40614930,del,NA19403,0,,2511
2,11248606,11248971,del,HG00276,0,,365
2,54593807,54595505,del,NA19114,0,,1698
2,17977816,17981721,del,HG00583,0,,3905
2,132765333,132804619,del,HG01198,0,,39286
2,185099370,185139470,del,NA19382,0,,40100
2,195981516,195985472,del,NA19385,0,,3956
2,80235485,80250560,del,NA11932,0,,15075
2,100762064,100762860,del,HG00345,0,,796
2,128551813,128554807,del,NA19716,0,,2994
2,170816851,170817881,del,NA19703,0,,1030
2,4116664,4132923,del,HG00276,0,,16259
2,167976857,168025986,del,NA20819,0,,49129
2,29275861,29277225,del,NA19360,0,,1364
2,166049578,166062479,del,HG00580,0,,12901
2,42341831,42359804,del,NA20778,0,,17973
2,70270347,70271655,del,NA18595,0,,1308
2,163189244,163190382,del,HG01366,0,,1138
2,63540649,63565181,del,HG00671,0,,24532
2,221046080,221046203,del,NA19399,0,,123
2,176102678,176106305,del,NA18592,0,,3627
2,123214328,123222606,del,HG01462,0,,8278
2,134611924,134613578,del,NA20815,0,,1654
2,98544778,98547870,del,NA19240,0,,3092
2,125766560,125768247,del,HG00698,0,,1687
2,117175159,117177899,del,HG01383,0,,2740
2,105791491,105794203,del,NA19678,0,,2712
2,227447554,227448001,del,NA19437,0,,447
2,84193825,84194261,del,HG00737,0,,436
2,174508098,174510310,del,HG01134,0,,2212
2,56081161,56082565,del,HG00437,0,,1404
2,211768350,211779850,del,NA18853,0,,11500
2,14190095,14199560,del,HG01048,0,,9465
2,118277329,118277838,del,NA18498,0,,509
2,165721516,165722353,del,HG00335,0,,837
2,25117090,25117941,del,NA19055,0,,851
2,739996,740122,del,HG00328,0,,126
2,166669753,166674277,del,NA18622,0,,4524
2,119223629,119233828,del,NA19311,0,,10199
2,158985311,158986209,del,HG01366,0,,898
2,217497816,217501922,del,HG00181,0,,4106
2,27314694,27324115,del,HG00187,0,,9421
2,66978407,66983508,del,NA11994,0,,5101
2,240202708,240203038,del,NA12777,0,,330
2,187025352,187029133,del,NA19067,0,,3781
2,58688946,58691192,del,HG00608,0,,2246
2,212771238,212775156,del,NA18982,0,,3918
2,194740989,194741385,del,NA18562,0,,396
2,183028781,183029678,del,NA11930,0,,897
2,234372004,234372344,del,NA19682,0,,340
2,6298293,6308718,del,NA19373,0,,10425
2,195060757,195217499,del,HG01072,0,,156742
2,38871925,38882405,del,NA19462,0,,10480
2,117954900,117958729,del,HG01075,0,,3829
2,16560716,16562522,del,NA19144,0,,1806
2,95936381,95938318,del,NA19711,0,,1937
2,51224547,51225542,del,HG00377,0,,995
2,52749686,52785275,del,HG00536,0,,35589
2,50182410,50192057,del,NA18627,0,,9647
2,5845816,5846222,del,NA19434,0,,406
2,16560266,16562622,del,NA19324,0,,2356
2,128821534,128827144,del,NA19468,0,,5610
2,241787487,241788124,del,NA12778,0,,637
2,171684689,171685065,del,NA18916,0,,376
2,2532429,2533455,del,HG00133,0,,1026
2,77657668,77659020,del,NA18487,0,,1352
2,176874085,176880061,del,NA12058,0,,5976
2,174800659,174803454,del,HG00331,0,,2795
2,14452370,14455257,del,HG01107,0,,2887
2,185117343,185121975,del,HG00188,0,,4632
2,102931447,102936868,del,NA19466,0,,5421
2,231207810,231208377,del,HG00442,0,,567
2,231918518,231920400,del,NA19914,0,,1882
2,211788649,211789169,del,NA19472,0,,520
2,5547389,5553907,del,NA18613,0,,6518
2,16271816,16273922,del,NA18592,0,,2106
2,211360857,211368610,del,HG00112,0,,7753
2,226831963,226838411,del,HG00638,0,,6448
2,73262003,73280479,del,NA18508,0,,18476
2,154896366,154900222,del,HG00138,0,,3856
2,220232674,220233179,del,HG00342,0,,505
2,214583005,214586497,del,HG01441,0,,3492
2,240386311,240389848,del,NA19437,0,,3537
2,172363551,172363693,del,HG00325,0,,142
2,69706298,69707920,del,HG00328,0,,1622
2,33282143,33282341,del,HG01173,0,,198
2,98140116,98158622,del,HG00271,0,,18506
2,98942603,98944661,del,NA18537,0,,2058
2,160290713,160291889,del,NA12777,0,,1176
2,203344120,203344922,del,HG01342,0,,802
2,29085428,29087203,del,HG01102,0,,1775
2,221945358,221945662,del,NA19257,0,,304
2,1217358,1218502,del,NA18861,0,,1144
2,188732861,188733105,del,NA20544,0,,244
2,59451009,59454211,del,NA19010,0,,3202
2,10551994,10557824,del,NA19066,0,,5830
2,130788835,130805423,del,NA19312,0,,16588
2,89203506,89544261,del,HG00334,0,,340755
2,126898361,126898607,del,NA18516,0,,246
2,225240814,225242861,del,HG00590,0,,2047
2,48105069,48105748,del,NA19920,0,,679
2,31251793,31258085,del,HG00705,0,,6292
2,234648331,234659988,del,NA19448,0,,11657
2,89161078,89442047,del,HG00689,0,,280969
2,98856259,98886525,del,NA19153,0,,30266
2,130822750,130823390,del,HG00243,0,,640
2,242144790,242145942,del,NA18610,0,,1152
2,233393031,233396158,del,NA19347,0,,3127
2,154688070,154693589,del,HG01342,0,,5519
2,13532999,13549184,del,HG01492,0,,16185
2,138044145,138044306,del,NA18550,0,,161
2,56338447,56341121,del,NA18960,0,,2674
2,137081986,137083012,del,NA18567,0,,1026
2,109803452,109803611,del,NA18582,0,,159
2,161164357,161167356,del,NA19701,0,,2999
2,59095438,59100030,del,NA19474,0,,4592
2,126026993,126027163,del,HG00282,0,,170
2,198141819,198143247,del,NA18910,0,,1428
2,153666770,153798065,del,NA19068,0,,131295
2,65293055,65297155,del,NA12842,0,,4100
2,187674646,187676515,del,NA19403,0,,1869
2,30812782,30850249,del,HG00133,0,,37467
2,53558083,53559777,del,HG00262,0,,1694
2,107926381,107926722,del,NA19009,0,,341
2,149917511,149918699,del,NA19383,0,,1188
2,5649981,5650527,del,NA20289,0,,546
2,89132416,89544822,del,HG00143,0,,412406
2,135316292,135319600,del,NA19474,0,,3308
2,73853044,73913363,del,HG01441,0,,60319
2,58177140,58178796,del,NA19082,0,,1656
2,61282146,61285557,del,NA19235,0,,3411
2,14704169,14710116,del,HG01465,0,,5947
2,82412216,82415422,del,HG00280,0,,3206
2,165483204,165486402,del,HG00692,0,,3198
2,240202939,240204512,del,NA07056,0,,1573
2,29228269,29228848,del,NA19675,0,,579
2,59948198,59953778,del,NA19716,0,,5580
2,208227040,208231840,del,NA12341,0,,4800
2,35975984,35997142,del,NA19359,0,,21158
2,216835189,216839489,del,NA19065,0,,4300
2,46253997,46258416,del,NA20508,0,,4419
2,88821957,88822489,del,HG00139,0,,532
2,7871632,7879356,del,NA19371,0,,7724
2,190095850,190102917,del,HG00366,0,,7067
2,231671160,231673916,del,HG01102,0,,2756
2,176346116,176352572,del,NA18945,0,,6456
2,172664712,172664830,del,NA18910,0,,118
2,238425928,238426371,del,HG00120,0,,443
2,196089127,196094791,del,HG00244,0,,5664
2,125435188,125438796,del,HG01492,0,,3608
2,156833709,156835505,del,HG01197,0,,1796
2,71318564,71321792,del,NA19430,0,,3228
2,26237190,26242940,del,NA20520,0,,5750
2,232043354,232044103,del,HG00734,0,,749
2,121891956,121892266,del,NA12890,0,,310
2,236094668,236094997,del,HG00242,0,,329
2,145480775,145485358,del,NA19700,0,,4583
2,108335885,108337872,del,NA20808,0,,1987
2,164438172,164443807,del,NA19625,0,,5635
2,169267724,169297986,del,NA19248,0,,30262
2,38581118,38584253,del,NA19397,0,,3135
2,129408279,129409977,del,NA18538,0,,1698
2,76818494,76951094,del,HG00672,0,,132600
2,40291745,40291881,del,NA18505,0,,136
2,35007245,35007825,del,NA12383,0,,580
2,29817612,29824890,del,HG00537,0,,7278
2,28059782,28060219,del,NA18519,0,,437
2,29227882,29228758,del,HG01492,0,,876
2,242179818,242181084,del,NA12778,0,,1266
2,208969969,208973926,del,HG00273,0,,3957
2,160014875,160015955,del,NA18961,0,,1080
2,47479199,47482518,del,NA20796,0,,3319
2,79767809,79771081,del,HG01461,0,,3272
2,57202126,57213398,del,NA19625,0,,11272
2,128103654,128114045,del,NA19819,0,,10391
2,142104971,142113369,del,NA19469,0,,8398
2,123221852,123227577,del,HG01051,0,,5725
2,142324916,142328422,del,HG00315,0,,3506
2,215902548,215904482,del,NA18628,0,,1934
2,85941274,85944935,del,NA19087,0,,3661
2,1760606,1760992,del,HG00705,0,,386
2,227515281,227515814,del,NA19093,0,,533
2,229759288,229759907,del,NA20796,0,,619
2,193186003,193191955,del,NA19473,0,,5952
2,212801925,212809254,del,NA19147,0,,7329
2,229957750,229958220,del,HG01188,0,,470
2,136970923,136972525,del,NA19440,0,,1602
2,53249351,53252613,del,HG00501,0,,3262
2,184794430,184804030,del,NA20802,0,,9600
2,236742158,236742737,del,HG01491,0,,579
2,230877116,230879676,del,HG00319,0,,2560
2,47777321,47783191,del,HG00419,0,,5870
2,183090386,183091633,del,NA18487,0,,1247
2,196301137,196302296,del,NA19661,0,,1159
2,134195282,134197642,del,NA18867,0,,2360
2,78474742,78481268,del,HG01366,0,,6526
2,89113551,89122330,del,NA18999,0,,8779
2,25680848,25683892,del,HG00657,0,,3044
2,54744211,54744589,del,NA19398,0,,378
2,139598341,139599281,del,NA20773,0,,940
2,56658341,56698453,del,HG00542,0,,40112
2,71352458,71353477,del,HG00476,0,,1019
2,160140079,160140174,del,HG00251,0,,95
2,156656757,156656860,del,HG00264,0,,103
2,97817830,97822204,del,HG01060,0,,4374
2,59564288,59569791,del,NA18986,0,,5503
2,239409371,239409697,del,HG01390,0,,326
2,212078711,212080507,del,HG00638,0,,1796
2,14574297,14574869,del,HG00428,0,,572
2,60283552,60288218,del,HG01067,0,,4666
2,41238366,41250293,del,HG00325,0,,11927
2,114257316,114262022,del,NA19785,0,,4706
2,17585127,17590610,del,HG00475,0,,5483
2,151313784,151315158,del,NA20522,0,,1374
2,76410430,76414036,del,NA18948,0,,3606
2,241940561,241943768,del,NA19332,0,,3207
2,47805277,47809313,del,HG00593,0,,4036
2,175910712,175911063,del,HG00479,0,,351
2,100894615,100897684,del,NA19070,0,,3069
2,33051611,33052645,del,HG01047,0,,1034
2,187420030,187420965,del,NA20773,0,,935
2,133246416,133248413,del,NA20528,0,,1997
2,195362116,195367922,del,HG00361,0,,5806
2,186142049,186148844,del,NA20814,0,,6795
2,180287951,180301072,del,NA18544,0,,13121
2,182443195,182445144,del,HG01134,0,,1949
2,213530456,213530464,del,HG01055,0,,8
2,16560521,16561534,del,NA19129,0,,1013
2,89160433,89384670,del,NA18873,0,,224237
2,59383341,59384636,del,NA18615,0,,1295
2,7007535,7008077,del,NA19007,0,,542
2,164993283,164996154,del,HG00404,0,,2871
2,52749686,52785270,del,NA18947,0,,35584
2,58953603,58957833,del,NA19438,0,,4230
2,187656567,187658041,del,NA19404,0,,1474
2,106438746,106440729,del,NA18505,0,,1983
2,48851190,48857952,del,NA18621,0,,6762
2,177158021,177160563,del,HG01133,0,,2542
2,208317069,208317847,del,NA19398,0,,778
2,130493077,130493715,del,NA19099,0,,638
2,112763822,112765339,del,NA19373,0,,1517
2,38640561,38641684,del,HG00097,0,,1123
2,154494935,154495152,del,NA19770,0,,217
2,234991876,234994942,del,NA18909,0,,3066
2,34229703,34234353,del,NA19711,0,,4650
2,44082601,44087044,del,NA18595,0,,4443
2,237355514,237356210,del,NA18907,0,,696
2,241120893,241121083,del,NA12878,0,,190
2,25445030,25446759,del,NA18549,0,,1729
2,449481,450752,del,NA19059,0,,1271
2,155825174,155827307,del,NA19347,0,,2133
2,135281898,135282586,del,HG00692,0,,688
2,64046443,64053540,del,NA12383,0,,7097
2,7660195,7660395,del,NA12340,0,,200
2,138637460,138639797,del,NA19372,0,,2337
2,104545701,104549769,del,HG00472,0,,4068
2,233214177,233224382,del,HG01437,0,,10205
2,242529642,242530575,del,NA19749,0,,933
2,48744099,48747459,del,NA19007,0,,3360
2,172906237,172910119,del,NA20768,0,,3882
2,107780835,107781324,del,HG00543,0,,489
2,204170871,204174819,del,NA19190,0,,3948
2,191995075,191998655,del,NA20818,0,,3580
2,14504853,14504997,del,NA19676,0,,144
2,117059338,117059661,del,NA19771,0,,323
2,159661994,159662872,del,NA06989,0,,878
2,184601731,184604706,del,NA19380,0,,2975
2,83154012,83154809,del,HG00473,0,,797
2,77357417,77368588,del,HG00260,0,,11171
2,92285629,92287335,del,NA19070,0,,1706
2,220052292,220055965,del,HG00246,0,,3673
2,119834071,119834246,del,NA19382,0,,175
2,146885241,146889108,del,NA19078,0,,3867
2,54820999,54821983,del,NA19834,0,,984
2,89132290,89567750,del,NA18486,0,,435460
2,128812159,128813751,del,HG00560,0,,1592
2,215015429,215016535,del,HG00142,0,,1106
2,35257428,35259896,del,NA12748,0,,2468
2,175507355,175508418,del,NA19108,0,,1063
2,130380409,130381505,del,NA18564,0,,1096
2,88317661,88319377,del,NA18520,0,,1716
2,211915961,211918564,del,NA19434,0,,2603
2,26086482,26092102,del,HG00117,0,,5620
2,109689900,109695214,del,HG00131,0,,5314
2,1107761,1108700,del,NA19108,0,,939
2,2532723,2533437,del,HG00133,0,,714
2,50473378,50481012,del,HG00250,0,,7634
2,51096228,51112194,del,NA20771,0,,15966
2,70118981,70122859,del,NA18963,0,,3878
2,4973926,4976309,del,HG00611,0,,2383
2,174842785,174842926,del,NA18523,0,,141
2,151785214,151789235,del,NA19085,0,,4021
2,222370021,222402051,del,NA18856,0,,32030
2,36159527,36159966,del,HG01072,0,,439
2,136653678,136654183,del,NA19382,0,,505
2,74102273,74102757,del,HG00736,0,,484
2,14178777,14179830,del,NA18965,0,,1053
2,145759320,145761785,del,NA18989,0,,2465
2,114789311,114789392,del,NA18504,0,,81
2,39438282,39517013,del,HG00437,0,,78731
2,195979616,195985172,del,NA19189,0,,5556
2,102119423,102119614,del,NA19240,0,,191
2,91703371,91704038,del,NA19380,0,,667
2,20645657,20645927,del,NA19401,0,,270
2,66505589,66507553,del,HG00593,0,,1964
2,214874703,214876213,del,NA19144,0,,1510
2,238501643,238501832,del,NA19084,0,,189
2,89160424,89160711,del,NA11894,0,,287
2,27810785,27811722,del,NA20515,0,,937
2,51839931,51845884,del,NA11994,0,,5953
2,226734995,226735607,del,NA19257,0,,612
2,114147078,114150257,del,HG01462,0,,3179
2,2583962,2585139,del,NA19379,0,,1177
2,6314816,6317922,del,NA19064,0,,3106
2,73142916,73146922,del,HG00345,0,,4006
2,238474553,238474715,del,NA18486,0,,162
2,132128396,132128807,del,HG00707,0,,411
2,193781793,193782004,del,NA18502,0,,211
2,54954310,54954544,del,NA18933,0,,234
2,240580016,240582122,del,HG00156,0,,2106
2,168262,172474,del,HG00150,0,,4212
2,134093295,134094129,del,NA18553,0,,834
2,118996935,119001996,del,NA18544,0,,5061
2,196172288,196174023,del,NA19440,0,,1735
2,133473567,133476956,del,HG00663,0,,3389
2,150565120,150565708,del,NA18952,0,,588
2,14276763,14276927,del,HG01107,0,,164
2,142395973,142396578,del,HG00581,0,,605
2,84816747,84817530,del,NA19685,0,,783
2,206128036,206129857,del,NA20527,0,,1821
2,123477016,123482322,del,NA18609,0,,5306
2,38464229,38465768,del,NA19350,0,,1539
2,117133783,117134014,del,NA19324,0,,231
2,151287237,151291476,del,NA20811,0,,4239
2,97442972,97445620,del,NA19332,0,,2648
2,110688016,110733022,del,HG00338,0,,45006
2,91646138,91973673,del,HG01073,0,,327535
2,126368483,126370220,del,HG01353,0,,1737
2,153795916,153799622,del,NA20792,0,,3706
2,241787549,241787737,del,NA18573,0,,188
2,66296823,66297658,del,NA18547,0,,835
2,76706657,76707398,del,HG00537,0,,741
2,12019026,12022932,del,NA19917,0,,3906
2,167545950,167547092,del,HG00127,0,,1142
2,112009619,112016185,del,HG00421,0,,6566
2,201234708,201237213,del,HG01061,0,,2505
2,62670855,62671146,del,NA18944,0,,291
2,196484244,196485337,del,NA18870,0,,1093
2,47138826,47140737,del,NA19648,0,,1911
2,12121702,12132440,del,NA19338,0,,10738
2,40861326,40862833,del,NA19909,0,,1507
2,65512752,65517504,del,HG00583,0,,4752
2,185246701,185264659,del,NA19372,0,,17958
2,64315562,64316375,del,HG01082,0,,813
2,216782093,216782497,del,NA19079,0,,404
2,132393367,132394645,del,NA19652,0,,1278
2,49442581,49447434,del,NA18549,0,,4853
2,8391680,8393675,del,NA19461,0,,1995
2,86570482,86570720,del,HG00278,0,,238
2,225094821,225097118,del,NA18498,0,,2297
2,195689098,195691602,del,NA19189,0,,2504
2,16551218,16552694,del,NA19114,0,,1476
2,1217107,1217325,del,NA19701,0,,218
2,221936355,221938738,del,NA19382,0,,2383
2,73502985,73504015,del,NA19201,0,,1030
2,142324116,142328322,del,HG00253,0,,4206
2,89277912,89291825,del,HG00245,0,,13913
2,36167093,36167546,del,NA19055,0,,453
2,196214814,196215226,del,NA18976,0,,412
2,75070493,75071302,del,NA19704,0,,809
2,183055209,183061515,del,NA20530,0,,6306
2,81017494,81019825,del,HG00278,0,,2331
2,237663485,237680353,del,NA18908,0,,16868
2,68265778,68267316,del,NA20814,0,,1538
2,133670696,133673555,del,NA19678,0,,2859
2,92071678,92073794,del,HG00436,0,,2116
2,24657749,24658079,del,NA19311,0,,330
2,190989205,190994318,del,NA19384,0,,5113
2,11081839,11082195,del,HG00285,0,,356
2,173302490,173304467,del,HG01187,0,,1977
2,132087259,132096607,del,NA18856,0,,9348
2,84679607,84683623,del,NA19350,0,,4016
2,220754011,220760336,del,HG00247,0,,6325
2,73852944,73913295,del,NA19443,0,,60351
2,53843811,53846638,del,NA19137,0,,2827
2,210405219,210406359,del,NA18522,0,,1140
2,199793917,199794662,del,NA18636,0,,745
2,205517452,205519254,del,NA18923,0,,1802
2,217158346,217158727,del,HG00239,0,,381
2,234219413,234225768,del,HG00246,0,,6355
2,25253970,25260555,del,NA19651,0,,6585
2,225520880,225523155,del,HG00151,0,,2275
2,82756074,82757502,del,NA18561,0,,1428
2,108861748,108862976,del,NA18519,0,,1228
2,229357132,229357360,del,NA18945,0,,228
2,187839327,187842002,del,NA20589,0,,2675
2,161741929,161742166,del,NA18510,0,,237
2,178855455,178857212,del,NA20800,0,,1757
2,1614685,1615060,del,HG00419,0,,375
2,57579796,57581975,del,NA19371,0,,2179
2,5856368,5859317,del,HG00422,0,,2949
2,43658769,43659294,del,NA19355,0,,525
2,51973823,51974240,del,HG00650,0,,417
2,135487120,135491331,del,NA19716,0,,4211
2,173888920,173889244,del,HG00641,0,,324
2,117799716,117801522,del,HG00268,0,,1806
2,243027044,243027331,del,HG01080,0,,287
2,29535156,29539375,del,NA18910,0,,4219
2,137983304,137984459,del,HG01437,0,,1155
2,184498587,184502723,del,NA20812,0,,4136
2,14852902,14855241,del,NA18912,0,,2339
2,208351130,208359372,del,NA19776,0,,8242
2,130037098,130037407,del,NA19116,0,,309
2,25052538,25053155,del,HG00343,0,,617
2,208664945,208667073,del,HG01124,0,,2128
2,306597,307469,del,NA18519,0,,872
2,42852364,42853631,del,NA19359,0,,1267
2,731916,733122,del,HG00556,0,,1206
2,238746300,238746692,del,NA07051,0,,392
2,89475817,89495556,del,NA19461,0,,19739
2,71342538,71347890,del,HG00653,0,,5352
2,82681099,82700613,del,NA18627,0,,19514
2,48781835,48784867,del,HG00560,0,,3032
2,56767652,56770283,del,NA18960,0,,2631
2,130963417,130967285,del,HG01198,0,,3868
2,138490115,138490492,del,NA20516,0,,377
2,152873509,152873939,del,HG01134,0,,430
2,90249766,90275422,del,HG00361,0,,25656
2,147611550,147640146,del,NA20581,0,,28596
2,1683031,1683317,del,NA20340,0,,286
2,19407977,19409932,del,NA12828,0,,1955
2,228918443,228925048,del,HG00577,0,,6605
2,34696266,34735172,del,NA20816,0,,38906
2,170438631,170440600,del,NA19625,0,,1969
2,154856580,154856836,del,NA18511,0,,256
2,235714235,235716098,del,NA19114,0,,1863
2,19002874,19003391,del,HG01498,0,,517
2,216835226,216839586,del,NA19065,0,,4360
2,122057046,122057805,del,HG01354,0,,759
2,17969508,17979528,del,NA19920,0,,10020
2,168174658,168176379,del,HG01073,0,,1721
2,121847005,121856269,del,NA19726,0,,9264
2,195408991,195410906,del,NA19716,0,,1915
2,216105972,216106888,del,NA20344,0,,916
2,203184402,203185354,del,HG01197,0,,952
2,242865564,242865717,del,NA19374,0,,153
2,126378587,126385342,del,HG00357,0,,6755
2,89132516,89552622,del,NA20294,0,,420106
2,193706303,193706465,del,NA18870,0,,162
2,223866816,223869722,del,NA19403,0,,2906
2,49713713,49728362,del,HG01134,0,,14649
2,229759227,229759693,del,HG00310,0,,466
2,71253818,71254802,del,NA19461,0,,984
2,23163,99614,dup,HG02888,0,,76451
2,45283,210119,dup,HG02820,0,,164836
2,117322,178829,dup,HG03603,0,,61507
2,250064,298533,dup,NA18987,0,,48469
2,251988,283726,dup,NA18987,0,,31738
2,314968,694521,dup,HG02165,0,,379553
2,315309,841550,dup,HG02165,0,,526241
2,696374,857829,dup,HG02165,0,,161455
2,1188819,1244863,dup,NA19078,0,,56044
2,1203413,1214877,dup,HG01868,0,,11464
2,1226503,1245724,dup,NA19078,0,,19221
2,1263904,1333536,dup,NA20775,0,,69632
2,1378281,1411942,dup,NA19078,0,,33661
2,1426764,1486374,dup,HG03303,0,,59610
2,2438255,2441353,dup,HG01812,0,,3098
2,3372322,3437212,dup,HG03074,0,,64890
2,3501585,3582491,dup,HG03074,0,,80906
2,4566061,4576813,dup,HG03190,0,,10752
2,5472929,5513523,dup,NA12748,0,,40594
2,5475131,5506835,dup,NA12748,0,,31704
2,5885065,5901900,dup,NA20581,0,,16835
2,6009245,6031589,dup,HG00448,0,,22344
2,6887688,6897522,dup,HG02982,0,,9834
2,8602604,8642062,dup,HG00341,0,,39458
2,9223053,9403530,dup,NA18941,0,,180477
2,9925419,9928927,dup,HG00105,0,,3508
2,9930303,9946535,dup,HG02545,0,,16232
2,9950593,9979069,dup,HG00705,0,,28476
2,10166024,10176001,dup,HG03868,0,,9977
2,10334124,10386855,dup,HG00269,0,,52731
2,10630463,10675782,dup,NA18564,0,,45319
2,10885628,10893536,dup,HG00244,0,,7908
2,11027663,11037606,dup,HG03709,0,,9943
2,11486888,11497987,dup,HG01174,0,,11099
2,13199895,13284265,dup,HG00102,0,,84370
2,13200672,13249918,dup,HG00102,0,,49246
2,13635034,13689846,dup,HG04141,0,,54812
2,13851163,13963266,dup,HG03520,0,,112103
2,14345021,14349163,dup,HG00556,0,,4142
2,14349664,14372041,dup,HG00256,0,,22377
2,14485223,14621268,dup,HG03790,0,,136045
2,14619537,14648276,dup,HG03907,0,,28739
2,14803437,14885296,dup,NA21129,0,,81859
2,14909200,14923172,dup,HG00375,0,,13972
2,15144033,15216834,dup,HG01853,0,,72801
2,17023846,17038317,dup,HG00173,0,,14471
2,17937146,18216823,dup,HG00663,0,,279677
2,18318474,18352902,dup,HG00109,0,,34428
2,18323363,18344852,dup,HG00109,0,,21489
2,21112157,21132788,dup,HG01080,0,,20631
2,21416646,21433626,dup,NA18617,0,,16980
2,21640799,21657139,dup,HG00123,0,,16340
2,25294183,25299260,dup,HG00132,0,,5077
2,25907970,25913629,dup,HG01435,0,,5659
2,26810289,26821784,dup,HG03775,0,,11495
2,29194455,29276815,dup,NA18579,0,,82360
2,29532790,29685648,dup,HG01798,0,,152858
2,29579444,29599671,dup,HG01798,0,,20227
2,29922026,29938998,dup,HG03653,0,,16972
2,30409295,30510372,dup,NA18579,0,,101077
2,30872595,30882292,dup,HG00956,0,,9697
2,32342831,32366835,dup,HG00500,0,,24004
2,32383097,32428884,dup,HG00500,0,,45787
2,32443022,32483339,dup,HG00500,0,,40317
2,32488149,32503705,dup,HG00500,0,,15556
2,32598145,32613192,dup,HG00500,0,,15047
2,32628940,33332430,dup,HG00275,0,,703490
2,32630625,32650530,dup,HG00275,0,,19905
2,32644827,32773930,dup,HG00275,0,,129103
2,32652861,32681586,dup,HG00275,0,,28725
2,32673976,32965429,dup,HG00275,0,,291453
2,32838747,32948602,dup,HG00275,0,,109855
2,32979165,33123337,dup,NA20342,0,,144172
2,33244027,33333001,dup,NA20342,0,,88974
2,33626286,33641596,dup,HG01577,0,,15310
2,33716158,33727375,dup,NA18552,0,,11217
2,34098141,34124742,dup,HG02568,0,,26601
2,34209072,34259206,dup,NA19752,0,,50134
2,34478448,34492284,dup,HG04186,0,,13836
2,34498819,34538182,dup,HG02885,0,,39363
2,34525946,34602665,dup,HG04186,0,,76719
2,34594266,34664956,dup,NA19794,0,,70690
2,34695856,34736534,dup,HG00097,0,,40678
2,34736460,34797407,dup,HG04186,0,,60947
2,34815714,34915852,dup,HG03947,0,,100138
2,34932672,35001909,dup,HG01589,0,,69237
2,35765535,35774268,dup,HG01509,0,,8733
2,35817244,35945112,dup,HG01766,0,,127868
2,35955754,36096438,dup,HG01766,0,,140684
2,36097793,36135418,dup,HG00180,0,,37625
2,37906525,37927500,dup,NA20790,0,,20975
2,38748822,38764316,dup,NA20881,0,,15494
2,38956737,38974142,dup,HG00096,0,,17405
2,39437864,39481620,dup,HG00437,0,,43756
2,39703412,39763117,dup,HG02070,0,,59705
2,39705078,39930345,dup,HG02070,0,,225267
2,40248605,40253575,dup,HG01412,0,,4970
2,40465957,40476867,dup,NA21124,0,,10910
2,40519627,40547682,dup,HG03702,0,,28055
2,40524182,40546175,dup,HG03702,0,,21993
2,40924855,40960614,dup,HG00500,0,,35759
2,41722037,41770142,dup,HG03464,0,,48105
2,43400619,43416811,dup,NA19350,0,,16192
2,43649698,43694990,dup,NA19726,0,,45292
2,43879284,44011997,dup,HG02715,0,,132713
2,43882419,43952543,dup,HG02715,0,,70124
2,44517273,44533889,dup,NA19818,0,,16616
2,44533165,44548027,dup,NA19818,0,,14862
2,44726065,44803075,dup,HG03947,0,,77010
2,45132799,45138616,dup,HG02643,0,,5817
2,45298049,45330979,dup,HG03947,0,,32930
2,45309313,45336278,dup,HG00190,0,,26965
2,45331199,45352443,dup,HG03947,0,,21244
2,45331280,45353214,dup,HG03947,0,,21934
2,45506482,45528794,dup,HG02351,0,,22312
2,46669432,46747072,dup,HG02067,0,,77640
2,46775529,46790115,dup,NA19131,0,,14586
2,47327072,47334761,dup,HG00189,0,,7689
2,47429871,47472444,dup,NA19225,0,,42573
2,47777732,47783117,dup,HG00419,0,,5385
2,47997151,48000253,dup,NA11881,0,,3102
2,48812543,48825044,dup,HG00584,0,,12501
2,48837815,48851080,dup,HG02737,0,,13265
2,48857859,48868164,dup,HG02737,0,,10305
2,49042547,49070161,dup,HG00102,0,,27614
2,49144045,49167937,dup,HG04017,0,,23892
2,49250224,49260552,dup,HG00589,0,,10328
2,49402619,49536763,dup,HG01536,0,,134144
2,49407026,49480319,dup,HG01536,0,,73293
2,49492659,49525371,dup,NA20807,0,,32712
2,49867319,49880730,dup,HG00611,0,,13411
2,49956468,49966042,dup,HG01456,0,,9574
2,50182899,50192857,dup,NA18627,0,,9958
2,50497042,50516033,dup,HG01917,0,,18991
2,51298425,51337653,dup,HG02497,0,,39228
2,51377361,51424024,dup,NA20525,0,,46663
2,51396962,51485141,dup,NA20869,0,,88179
2,51433009,51484180,dup,NA20869,0,,51171
2,51559673,51584531,dup,HG02020,0,,24858
2,51687530,51786195,dup,HG02804,0,,98665
2,52670099,52748362,dup,HG02003,0,,78263
2,52784057,52851058,dup,HG02003,0,,67001
2,52785825,52806016,dup,HG02003,0,,20191
2,52837637,52874289,dup,HG01188,0,,36652
2,52917502,52936503,dup,HG03685,0,,19001
2,53122532,53141347,dup,HG02819,0,,18815
2,53172815,53290227,dup,HG01799,0,,117412
2,54743354,54752245,dup,HG03742,0,,8891
2,55345355,55352743,dup,HG02155,0,,7388
2,55910747,55941865,dup,HG01108,0,,31118
2,55937974,55982528,dup,NA20535,0,,44554
2,56288969,56391138,dup,HG02064,0,,102169
2,56291036,56334836,dup,HG02064,0,,43800
2,56370977,56398141,dup,HG02064,0,,27164
2,56720316,56748509,dup,HG01914,0,,28193
2,56738615,56820730,dup,HG02399,0,,82115
2,56946197,56950955,dup,HG00419,0,,4758
2,57232150,57476901,dup,HG02450,0,,244751
2,57378701,57446580,dup,HG02450,0,,67879
2,57398757,57451817,dup,HG02450,0,,53060
2,57450657,57469228,dup,HG02450,0,,18571
2,57462606,57599632,dup,NA07347,0,,137026
2,57463756,57546276,dup,NA20544,0,,82520
2,57521485,57656650,dup,NA07347,0,,135165
2,57725411,57907957,dup,HG01789,0,,182546
2,57732112,57956605,dup,HG00443,0,,224493
2,57781776,57812586,dup,NA18570,0,,30810
2,58358560,58369865,dup,HG03449,0,,11305
2,58474856,58518830,dup,HG04176,0,,43974
2,58676585,58718988,dup,HG04186,0,,42403
2,58802534,59219776,dup,HG04186,0,,417242
2,59387877,59402606,dup,HG02586,0,,14729
2,59402974,59490476,dup,HG04186,0,,87502
2,59948949,59952576,dup,NA19068,0,,3627
2,60994138,61095407,dup,HG00375,0,,101269
2,62298970,62315800,dup,NA18987,0,,16830
2,62734718,62760017,dup,NA19351,0,,25299
2,62917798,62922151,dup,NA12890,0,,4353
2,64293128,64303831,dup,HG00105,0,,10703
2,64342138,64515515,dup,HG00266,0,,173377
2,64370384,64523545,dup,HG03123,0,,153161
2,66865772,66876327,dup,NA18516,0,,10555
2,67758940,67766220,dup,HG01134,0,,7280
2,70568999,70592653,dup,HG00590,0,,23654
2,71237811,71257953,dup,NA19707,0,,20142
2,71251148,71277011,dup,HG02813,0,,25863
2,71524901,71577712,dup,HG02702,0,,52811
2,71595455,71658457,dup,HG03941,0,,63002
2,73875648,73913665,dup,HG00596,0,,38017
2,74345112,74371408,dup,HG03679,0,,26296
2,74357241,74370708,dup,HG03679,0,,13467
2,74900922,75052085,dup,HG03908,0,,151163
2,74903729,74976620,dup,HG03391,0,,72891
2,75777685,75812529,dup,HG02107,0,,34844
2,75809036,75890898,dup,NA18555,0,,81862
2,75820989,75917176,dup,NA18555,0,,96187
2,76331091,76352144,dup,NA20846,0,,21053
2,76545942,76593908,dup,HG00149,0,,47966
2,76650342,76777179,dup,HG03687,0,,126837
2,76650782,76733881,dup,HG03687,0,,83099
2,76781886,76924960,dup,HG03687,0,,143074
2,76872511,76984275,dup,HG01840,0,,111764
2,76973024,77018818,dup,HG03687,0,,45794
2,77023809,77036320,dup,HG02026,0,,12511
2,77043887,77124358,dup,HG03687,0,,80471
2,77050153,77199582,dup,HG03687,0,,149429
2,77329240,77354008,dup,HG03687,0,,24768
2,77640798,77765205,dup,HG03687,0,,124407
2,77974656,78003333,dup,HG00376,0,,28677
2,78264689,78451075,dup,HG01784,0,,186386
2,78584856,78696225,dup,HG01784,0,,111369
2,78699802,78735370,dup,HG00113,0,,35568
2,79106189,79117762,dup,HG03856,0,,11573
2,79329995,79343747,dup,NA18507,0,,13752
2,79832221,79852724,dup,HG04212,0,,20503
2,80187311,80239871,dup,HG01271,0,,52560
2,81071994,81139755,dup,HG02837,0,,67761
2,81165702,81193256,dup,HG02837,0,,27554
2,81626863,81680082,dup,HG04176,0,,53219
2,82103023,82187328,dup,NA07051,0,,84305
2,82196919,82229438,dup,HG00739,0,,32519
2,82201362,82321606,dup,HG00739,0,,120244
2,82220526,82300589,dup,HG00739,0,,80063
2,82384488,82403134,dup,NA07051,0,,18646
2,82403401,82445293,dup,HG02699,0,,41892
2,82833703,82839198,dup,HG03136,0,,5495
2,83748392,83864442,dup,NA06985,0,,116050
2,83990864,84024731,dup,HG02562,0,,33867
2,84090686,84098965,dup,NA20796,0,,8279
2,84449336,84466789,dup,HG04006,0,,17453
2,86281586,86285895,dup,HG00266,0,,4309
2,86281875,86392327,dup,HG01479,0,,110452
2,86282713,86510932,dup,HG00246,0,,228219
2,86290822,86392766,dup,HG00246,0,,101944
2,86395471,86403877,dup,HG03919,0,,8406
2,86400826,86513487,dup,HG00246,0,,112661
2,86401004,86509359,dup,HG00319,0,,108355
2,86972696,87178267,dup,HG00096,0,,205571
2,86991467,87059573,dup,NA12287,0,,68106
2,87307987,87348993,dup,HG00699,0,,41006
2,87463157,87492134,dup,HG00129,0,,28977
2,87510505,87519915,dup,HG00129,0,,9410
2,87524756,87565019,dup,HG00129,0,,40263
2,87720551,87822741,dup,HG00129,0,,102190
2,87864501,87894709,dup,HG00102,0,,30208
2,87928699,87997635,dup,HG00129,0,,68936
2,88827972,88831307,dup,NA18630,0,,3335
2,89117046,89132281,dup,NA21141,0,,15235
2,89876399,89910324,dup,HG00096,0,,33925
2,89959483,90006636,dup,HG00129,0,,47153
2,90008595,90044399,dup,HG00129,0,,35804
2,90066423,90120854,dup,HG00129,0,,54431
2,90212408,90249248,dup,HG00129,0,,36840
2,91865750,91925129,dup,HG00096,0,,59379
2,91925130,92023923,dup,NA18530,0,,98793
2,92029917,92060280,dup,NA18530,0,,30363
2,92059524,92071528,dup,HG01968,0,,12004
2,92083797,92128124,dup,HG03692,0,,44327
2,92117378,92201432,dup,HG02334,0,,84054
2,95363020,95433630,dup,HG03850,0,,70610
2,95441068,95522042,dup,HG03850,0,,80974
2,95539661,95650436,dup,HG04171,0,,110775
2,95652601,95812502,dup,HG04171,0,,159901
2,95902573,95919454,dup,NA19332,0,,16881
2,96246611,96252450,dup,HG01777,0,,5839
2,96433401,96443909,dup,HG00380,0,,10508
2,96460113,96551434,dup,HG01813,0,,91321
2,97357480,97388752,dup,HG02811,0,,31272
2,97741576,97817195,dup,HG01108,0,,75619
2,98136216,98156567,dup,HG00096,0,,20351
2,98169655,98184861,dup,NA19316,0,,15206
2,98189544,98225505,dup,NA19020,0,,35961
2,98240947,98276655,dup,NA12005,0,,35708
2,98288149,98304316,dup,HG03934,0,,16167
2,99740157,99798629,dup,HG02688,0,,58472
2,99805249,99817013,dup,HG01286,0,,11764
2,100315244,100330074,dup,HG00479,0,,14830
2,101215395,101233723,dup,HG03229,0,,18328
2,102018771,102150457,dup,HG01807,0,,131686
2,102019582,102050941,dup,HG01807,0,,31359
2,102129508,102141633,dup,HG01807,0,,12125
2,102130236,102141745,dup,HG00403,0,,11509
2,102867140,102891045,dup,HG00689,0,,23905
2,102951839,102971935,dup,NA19043,0,,20096
2,104396064,104413544,dup,NA19099,0,,17480
2,106335041,106379897,dup,HG01253,0,,44856
2,106388254,106391515,dup,HG00117,0,,3261
2,106507548,106547876,dup,HG02580,0,,40328
2,106859467,106871202,dup,NA12155,0,,11735
2,106874018,106878674,dup,HG00179,0,,4656
2,106880209,106885796,dup,HG00096,0,,5587
2,106885047,106898142,dup,HG01775,0,,13095
2,106895656,106926312,dup,HG00671,0,,30656
2,106915098,106958907,dup,HG00671,0,,43809
2,106960945,107023988,dup,HG00671,0,,63043
2,107085287,107132835,dup,HG00671,0,,47548
2,107126134,107140824,dup,HG01775,0,,14690
2,107148269,107244734,dup,HG01775,0,,96465
2,107256301,107327729,dup,HG01775,0,,71428
2,107981621,108040970,dup,HG01775,0,,59349
2,108101237,108311232,dup,HG01775,0,,209995
2,108280314,108442236,dup,HG01775,0,,161922
2,108311982,108440743,dup,HG01775,0,,128761
2,108504538,109121423,dup,NA18870,0,,616885
2,108522174,108538992,dup,HG01112,0,,16818
2,108542579,108626789,dup,NA18870,0,,84210
2,108544668,108663909,dup,NA18870,0,,119241
2,108903256,109007041,dup,NA18870,0,,103785
2,110348959,110425616,dup,HG03120,0,,76657
2,110372032,110437545,dup,HG03120,0,,65513
2,110441457,110547945,dup,HG00096,0,,106488
2,110852853,110982974,dup,HG00120,0,,130121
2,110853839,110952320,dup,HG00120,0,,98481
2,110864030,110887000,dup,HG00120,0,,22970
2,110896990,110917922,dup,HG00120,0,,20932
2,111152885,111606197,dup,HG00096,0,,453312
2,111399660,111586830,dup,HG01915,0,,187170
2,112033189,112076862,dup,NA19648,0,,43673
2,112113216,112145950,dup,HG03857,0,,32734
2,112152878,112177566,dup,HG00102,0,,24688
2,112276726,112282525,dup,HG01131,0,,5799
2,112501387,112513082,dup,HG00421,0,,11695
2,113990255,114141550,dup,HG03644,0,,151295
2,113990905,114562213,dup,HG03644,0,,571308
2,114292886,114314702,dup,HG00479,0,,21816
2,114319705,114337313,dup,HG02325,0,,17608
2,114408008,114501937,dup,HG03644,0,,93929
2,114428840,114465916,dup,HG03644,0,,37076
2,114526852,114530954,dup,HG01308,0,,4102
2,114534653,114561464,dup,HG03644,0,,26811
2,115092526,115114239,dup,HG01586,0,,21713
2,115486901,115509258,dup,HG03949,0,,22357
2,115552570,115595087,dup,HG03949,0,,42517
2,116312584,116372404,dup,HG00122,0,,59820
2,116337315,116498791,dup,HG01441,0,,161476
2,116511432,116522620,dup,HG01441,0,,11188
2,116530749,116690130,dup,HG00766,0,,159381
2,116533046,116652393,dup,HG00436,0,,119347
2,116692797,116712168,dup,HG01441,0,,19371
2,116724624,117419557,dup,HG03514,0,,694933
2,116782208,116842614,dup,HG03514,0,,60406
2,117004502,117398340,dup,HG03514,0,,393838
2,117422714,117450828,dup,HG00277,0,,28114
2,117453289,117499226,dup,HG01441,0,,45937
2,117510367,117552153,dup,HG01248,0,,41786
2,117514871,117577517,dup,HG01248,0,,62646
2,117566775,117583978,dup,HG01248,0,,17203
2,117594365,117638428,dup,HG00421,0,,44063
2,117617158,117732952,dup,HG01248,0,,115794
2,117741146,117749028,dup,HG01393,0,,7882
2,117761454,117792710,dup,HG01441,0,,31256
2,117793586,117828732,dup,HG01441,0,,35146
2,117803120,117836983,dup,HG01441,0,,33863
2,117835720,117882343,dup,HG01441,0,,46623
2,118223781,118227048,dup,HG00122,0,,3267
2,118247274,118252949,dup,HG01530,0,,5675
2,120158673,120280334,dup,HG01767,0,,121661
2,121240725,121470526,dup,HG03645,0,,229801
2,121242703,121825544,dup,HG03645,0,,582841
2,121245121,121291358,dup,HG03645,0,,46237
2,121464376,121491138,dup,HG03645,0,,26762
2,121497939,121509408,dup,HG03645,0,,11469
2,121508984,121553727,dup,HG03645,0,,44743
2,121572973,121794938,dup,HG03645,0,,221965
2,121874092,121881216,dup,NA19755,0,,7124
2,122315930,122335126,dup,HG03978,0,,19196
2,122316251,122888725,dup,HG03978,0,,572474
2,122333077,122376995,dup,HG03240,0,,43918
2,122390708,122459550,dup,HG03978,0,,68842
2,122477990,122558216,dup,HG03978,0,,80226
2,122552887,122910213,dup,HG02283,0,,357326
2,122609379,122674482,dup,HG01802,0,,65103
2,122656507,122897167,dup,HG02283,0,,240660
2,122927329,122932708,dup,HG02283,0,,5379
2,122941232,123060473,dup,HG01802,0,,119241
2,123723008,123906084,dup,HG03963,0,,183076
2,123781249,123829723,dup,HG03963,0,,48474
2,123872340,123934363,dup,HG03963,0,,62023
2,123913464,124049288,dup,HG03963,0,,135824
2,124012546,124133027,dup,HG03963,0,,120481
2,124065557,124237546,dup,HG03963,0,,171989
2,124242258,124296322,dup,HG03963,0,,54064
2,124297697,124312395,dup,HG02136,0,,14698
2,124826641,124840134,dup,HG03461,0,,13493
2,125474358,125498986,dup,NA20522,0,,24628
2,125912035,126165461,dup,HG02470,0,,253426
2,126611228,126621364,dup,NA20881,0,,10136
2,126747578,126766573,dup,HG02050,0,,18995
2,127385230,127407754,dup,HG02649,0,,22524
2,127928180,127968516,dup,HG03082,0,,40336
2,127995686,128019578,dup,HG03040,0,,23892
2,128323875,128335933,dup,HG01046,0,,12058
2,128949541,129319024,dup,HG03788,0,,369483
2,129029046,129279181,dup,HG03788,0,,250135
2,129032261,129037725,dup,HG00404,0,,5464
2,129043628,129080877,dup,HG03788,0,,37249
2,129073660,129125484,dup,HG03788,0,,51824
2,129137544,129194394,dup,HG03788,0,,56850
2,129240426,129325507,dup,HG01921,0,,85081
2,129277165,129325877,dup,HG01921,0,,48712
2,129490150,129697515,dup,HG03788,0,,207365
2,129573058,129642458,dup,HG03788,0,,69400
2,129641959,129764073,dup,HG03788,0,,122114
2,129709268,129857502,dup,HG03788,0,,148234
2,129779920,129787480,dup,HG01761,0,,7560
2,129789031,129800866,dup,HG03788,0,,11835
2,129798160,129855095,dup,HG03788,0,,56935
2,130860205,130885518,dup,HG00154,0,,25313
2,130903394,130954779,dup,HG00154,0,,51385
2,130992177,131044243,dup,HG01257,0,,52066
2,131034213,131089610,dup,HG01353,0,,55397
2,131040434,131159105,dup,HG01353,0,,118671
2,131074401,131100225,dup,HG01353,0,,25824
2,131969202,131993658,dup,HG01257,0,,24456
2,132031571,132051579,dup,HG00154,0,,20008
2,132058772,132089346,dup,HG00154,0,,30574
2,132090980,132142372,dup,HG00154,0,,51392
2,132135680,132190805,dup,HG00154,0,,55125
2,132160010,132189020,dup,HG01600,0,,29010
2,132235493,132284728,dup,HG01600,0,,49235
2,132271236,132309089,dup,HG00565,0,,37853
2,132310697,132331102,dup,HG02890,0,,20405
2,132326093,132371262,dup,HG00565,0,,45169
2,132362227,132470561,dup,HG00565,0,,108334
2,132496467,132502417,dup,HG00282,0,,5950
2,132522461,132765006,dup,HG03234,0,,242545
2,133280674,133311088,dup,HG00734,0,,30414
2,133787362,133809025,dup,HG01528,0,,21663
2,133944144,133952209,dup,HG01894,0,,8065
2,134091056,134120682,dup,HG00331,0,,29626
2,134514722,134537845,dup,HG03873,0,,23123
2,134514754,134541897,dup,HG00524,0,,27143
2,136204924,136233285,dup,NA18940,0,,28361
2,136513445,136562625,dup,HG03762,0,,49180
2,136795594,136800626,dup,HG02477,0,,5032
2,137270960,137318457,dup,NA18749,0,,47497
2,137358965,137390587,dup,HG03578,0,,31622
2,137890760,137942433,dup,NA19023,0,,51673
2,137949693,138251250,dup,NA19023,0,,301557
2,138038871,138073811,dup,HG01188,0,,34940
2,138203759,138227244,dup,NA19023,0,,23485
2,138256852,138330005,dup,NA19023,0,,73153
2,138330376,138522694,dup,NA19023,0,,192318
2,139551297,139585178,dup,NA18960,0,,33881
2,140086330,140093632,dup,HG02215,0,,7302
2,140899541,140911336,dup,HG02759,0,,11795
2,140915665,141031735,dup,HG02084,0,,116070
2,141135532,141151478,dup,HG01867,0,,15946
2,141794210,141797300,dup,HG02178,0,,3090
2,142072570,142077713,dup,HG01853,0,,5143
2,142123647,142150604,dup,HG04020,0,,26957
2,142184749,142243006,dup,HG02760,0,,58257
2,142618563,142641013,dup,HG02589,0,,22450
2,143372027,143416805,dup,NA19355,0,,44778
2,144495007,144507177,dup,HG00136,0,,12170
2,145205192,145238786,dup,HG00146,0,,33594
2,145284987,145298650,dup,HG00146,0,,13663
2,148952595,148968588,dup,HG00384,0,,15993
2,149004439,149016315,dup,HG03593,0,,11876
2,149075377,149080265,dup,HG02861,0,,4888
2,149326761,149345513,dup,NA19355,0,,18752
2,149997240,150014244,dup,HG01685,0,,17004
2,150345158,150409552,dup,HG02384,0,,64394
2,150378021,150412254,dup,HG02384,0,,34233
2,150465203,150498459,dup,HG03045,0,,33256
2,150526648,150549783,dup,NA19355,0,,23135
2,150670514,150699681,dup,NA19355,0,,29167
2,151522708,151569598,dup,NA12760,0,,46890
2,151588795,151638565,dup,NA12760,0,,49770
2,151751538,151769371,dup,NA19355,0,,17833
2,152052989,152131885,dup,HG01599,0,,78896
2,152668671,152696997,dup,HG03160,0,,28326
2,152933192,152980757,dup,HG03160,0,,47565
2,153362306,153384451,dup,HG03160,0,,22145
2,153393702,153416341,dup,HG03160,0,,22639
2,153795918,153799667,dup,HG00097,0,,3749
2,153929697,153942195,dup,NA19374,0,,12498
2,153975901,153992988,dup,HG03160,0,,17087
2,154026230,154075573,dup,HG03160,0,,49343
2,154088531,154150777,dup,HG03160,0,,62246
2,154160811,154205031,dup,HG03160,0,,44220
2,154336042,154370068,dup,HG03160,0,,34026
2,154460258,154511683,dup,HG03160,0,,51425
2,154688161,154693754,dup,HG01342,0,,5593
2,154753840,154845623,dup,HG02283,0,,91783
2,154849265,154900055,dup,HG02283,0,,50790
2,154915247,155022879,dup,HG02283,0,,107632
2,155022305,155115976,dup,HG01762,0,,93671
2,155108734,155233648,dup,HG01762,0,,124914
2,155157270,155233599,dup,HG02283,0,,76329
2,155250729,155293763,dup,NA19379,0,,43034
2,155302159,155309894,dup,HG02283,0,,7735
2,155304068,155409697,dup,NA19355,0,,105629
2,155339013,155404316,dup,HG02283,0,,65303
2,155700494,155704361,dup,NA11920,0,,3867
2,155818938,155833162,dup,NA12878,0,,14224
2,155832038,155843821,dup,HG02879,0,,11783
2,156167616,156179199,dup,HG00634,0,,11583
2,157827892,157862010,dup,NA19355,0,,34118
2,158888858,158902034,dup,NA19355,0,,13176
2,159136176,159149680,dup,NA19328,0,,13504
2,159646634,159703391,dup,NA19355,0,,56757
2,159646846,159674220,dup,HG01280,0,,27374
2,159693974,159700149,dup,HG00409,0,,6175
2,159701327,159798713,dup,HG01280,0,,97386
2,159747504,159955059,dup,HG01308,0,,207555
2,159807650,159815703,dup,HG03048,0,,8053
2,159822036,159947145,dup,HG01280,0,,125109
2,159844950,159860497,dup,NA19355,0,,15547
2,159910436,159930286,dup,NA19355,0,,19850
2,160017587,160023586,dup,NA18558,0,,5999
2,160040316,160057539,dup,NA19355,0,,17223
2,160144259,160182866,dup,NA19355,0,,38607
2,161511818,161529048,dup,HG02462,0,,17230
2,161867243,161882433,dup,HG04162,0,,15190
2,162280167,162292485,dup,HG02727,0,,12318
2,162477168,162742754,dup,HG03455,0,,265586
2,163060753,163143691,dup,NA19355,0,,82938
2,163065044,163139512,dup,HG03258,0,,74468
2,163826519,163879180,dup,NA18853,0,,52661
2,163829021,163884029,dup,HG02557,0,,55008
2,165224430,165232980,dup,HG00422,0,,8550
2,165445071,165463284,dup,NA19355,0,,18213
2,165601869,165727045,dup,NA18986,0,,125176
2,165849750,165874491,dup,HG00130,0,,24741
2,165858060,165923690,dup,NA19355,0,,65630
2,165878370,165913021,dup,NA18986,0,,34651
2,166958521,166973766,dup,HG03660,0,,15245
2,167253022,167273869,dup,NA19670,0,,20847
2,167494545,167500589,dup,HG00180,0,,6044
2,167504609,167784872,dup,HG01242,0,,280263
2,167763507,167800263,dup,HG01242,0,,36756
2,167792108,167857252,dup,HG00589,0,,65144
2,167793424,167951258,dup,HG01242,0,,157834
2,167861254,167978383,dup,HG01242,0,,117129
2,167866356,167883309,dup,HG00717,0,,16953
2,167889066,167938798,dup,HG02836,0,,49732
2,167945908,167975583,dup,HG01242,0,,29675
2,168518448,168637204,dup,HG00704,0,,118756
2,170631617,170639929,dup,HG03517,0,,8312
2,171776522,171784001,dup,HG03720,0,,7479
2,171820617,171848226,dup,NA19385,0,,27609
2,172416499,172447834,dup,NA19175,0,,31335
2,174785832,174797458,dup,HG01121,0,,11626
2,174938667,174944117,dup,NA18498,0,,5450
2,176102601,176106308,dup,HG00443,0,,3707
2,177128982,177142449,dup,HG02155,0,,13467
2,177166822,177204055,dup,NA18871,0,,37233
2,177351992,177356252,dup,HG00105,0,,4260
2,177890977,177906081,dup,HG01066,0,,15104
2,178482855,178704685,dup,HG00543,0,,221830
2,178549587,178580102,dup,HG00543,0,,30515
2,178587307,178675830,dup,HG00543,0,,88523
2,178715232,178723818,dup,HG02345,0,,8586
2,179114377,179124987,dup,HG00614,0,,10610
2,179674101,179709787,dup,HG02952,0,,35686
2,180976689,180984759,dup,NA19909,0,,8070
2,182710947,182847824,dup,HG01275,0,,136877
2,182711388,182795606,dup,HG01079,0,,84218
2,182991334,183028239,dup,HG01936,0,,36905
2,183593766,183705993,dup,HG01936,0,,112227
2,183756106,183793596,dup,HG00272,0,,37490
2,183853627,183921885,dup,HG01936,0,,68258
2,183960776,184137164,dup,HG01936,0,,176388
2,184270204,184274599,dup,NA19007,0,,4395
2,185170945,185181935,dup,NA21102,0,,10990
2,185357553,185408383,dup,NA19350,0,,50830
2,185364227,185403161,dup,NA19043,0,,38934
2,185749734,185775773,dup,HG00404,0,,26039
2,186038973,186049108,dup,HG02449,0,,10135
2,186547086,186668006,dup,NA18645,0,,120920
2,187005387,187037116,dup,HG02588,0,,31729
2,187011053,187027546,dup,HG02588,0,,16493
2,187398517,187485159,dup,NA11992,0,,86642
2,187408274,187462848,dup,NA11992,0,,54574
2,188353335,188411711,dup,NA18871,0,,58376
2,188431857,188449900,dup,NA18871,0,,18043
2,188688618,188714955,dup,NA19091,0,,26337
2,188811135,188843791,dup,HG02493,0,,32656
2,188955325,188995921,dup,HG03781,0,,40596
2,188985705,189002541,dup,HG02420,0,,16836
2,189011569,189090007,dup,HG00428,0,,78438
2,189019070,189069265,dup,HG00428,0,,50195
2,189466864,189557629,dup,HG03594,0,,90765
2,189567890,189581229,dup,HG01060,0,,13339
2,190409675,190422429,dup,NA12342,0,,12754
2,191995173,191998533,dup,HG01140,0,,3360
2,192752737,192756836,dup,NA20894,0,,4099
2,193421818,193426159,dup,HG01171,0,,4341
2,193529303,193533428,dup,HG00350,0,,4125
2,194578564,194613101,dup,HG00458,0,,34537
2,194717947,194736454,dup,HG00656,0,,18507
2,194923525,194961076,dup,HG01605,0,,37551
2,194971736,194988043,dup,HG01605,0,,16307
2,195060109,195227467,dup,HG00740,0,,167358
2,195361661,195435545,dup,HG02399,0,,73884
2,195540061,195666695,dup,HG04022,0,,126634
2,197364910,197537498,dup,HG00318,0,,172588
2,198230788,198241201,dup,HG02445,0,,10413
2,198598691,198606107,dup,HG00131,0,,7416
2,198758284,198761579,dup,HG00096,0,,3295
2,200179032,200183614,dup,HG02143,0,,4582
2,202739723,202743221,dup,HG01054,0,,3498
2,203295679,203309603,dup,HG00743,0,,13924
2,203756340,203793625,dup,HG04161,0,,37285
2,204764071,204774542,dup,HG01440,0,,10471
2,205657589,205682750,dup,NA18981,0,,25161
2,205975916,205986249,dup,HG01083,0,,10333
2,206824145,206845231,dup,HG03681,0,,21086
2,207662299,207668098,dup,HG00310,0,,5799
2,208473392,208516122,dup,HG03472,0,,42730
2,208518346,208528917,dup,HG02623,0,,10571
2,208547956,208562943,dup,HG03472,0,,14987
2,208977543,208986365,dup,NA19201,0,,8822
2,209488754,209557572,dup,HG01082,0,,68818
2,209654626,209670828,dup,HG02685,0,,16202
2,209669009,209678317,dup,HG00478,0,,9308
2,209680976,209699930,dup,HG00449,0,,18954
2,209996297,210031992,dup,HG01798,0,,35695
2,210085340,210116689,dup,HG00362,0,,31349
2,210212815,210287143,dup,HG02407,0,,74328
2,210219519,210271451,dup,HG02407,0,,51932
2,210366740,210431302,dup,HG03694,0,,64562
2,212608731,212712557,dup,HG00458,0,,103826
2,212645589,212850273,dup,HG00458,0,,204684
2,212784184,212827839,dup,HG00458,0,,43655
2,212842648,212874597,dup,HG00458,0,,31949
2,212871696,212938800,dup,HG00458,0,,67104
2,213179699,213394515,dup,HG00458,0,,214816
2,213239643,213278164,dup,HG00458,0,,38521
2,213311629,213344557,dup,HG04093,0,,32928
2,213350233,213373258,dup,HG04093,0,,23025
2,214057995,214063238,dup,HG00113,0,,5243
2,214211365,214230926,dup,HG04019,0,,19561
2,215096897,215122931,dup,HG02491,0,,26034
2,216506111,216584502,dup,NA20524,0,,78391
2,216836020,216839305,dup,NA19065,0,,3285
2,217756002,217785715,dup,HG04019,0,,29713
2,217802650,217907941,dup,NA19055,0,,105291
2,217803118,217905572,dup,NA19055,0,,102454
2,218099119,218104915,dup,HG02586,0,,5796
2,218242251,218357846,dup,HG00881,0,,115595
2,218245280,218357977,dup,HG00881,0,,112697
2,218641666,218696047,dup,HG03515,0,,54381
2,219007081,219061647,dup,HG03722,0,,54566
2,219007170,219091356,dup,HG03722,0,,84186
2,219181290,219212391,dup,HG02050,0,,31101
2,219281032,219293896,dup,NA18620,0,,12864
2,220637323,220670296,dup,HG03775,0,,32973
2,222532100,222540154,dup,NA19320,0,,8054
2,222849139,222871932,dup,HG03419,0,,22793
2,224081031,224085085,dup,NA20785,0,,4054
2,224680651,224689125,dup,NA19248,0,,8474
2,225610453,225675016,dup,HG02111,0,,64563
2,226954938,226962187,dup,HG01111,0,,7249
2,227537886,227575953,dup,HG02470,0,,38067
2,227738067,227743691,dup,NA19063,0,,5624
2,228240601,228258237,dup,HG00109,0,,17636
2,228653815,228658002,dup,HG01668,0,,4187
2,229079466,229095629,dup,HG02820,0,,16163
2,229384253,229409537,dup,HG00266,0,,25284
2,229819642,229847692,dup,HG03160,0,,28050
2,229948366,230001160,dup,HG03160,0,,52794
2,230081755,230097142,dup,HG03160,0,,15387
2,230212068,230281750,dup,HG03160,0,,69682
2,230291264,230375778,dup,HG03160,0,,84514
2,230391878,230405198,dup,HG03160,0,,13320
2,230698603,230758840,dup,HG00136,0,,60237
2,230720959,230904614,dup,HG03160,0,,183655
2,230804344,230817176,dup,HG00099,0,,12832
2,230870858,230888026,dup,NA12748,0,,17168
2,230890900,230904581,dup,HG00136,0,,13681
2,230911176,230933119,dup,HG03160,0,,21943
2,230936851,231035090,dup,HG03160,0,,98239
2,231408722,231435846,dup,HG03593,0,,27124
2,232260564,232272852,dup,NA19669,0,,12288
2,232440965,232451170,dup,NA21093,0,,10205
2,233200004,233214555,dup,HG01188,0,,14551
2,233224395,233234634,dup,NA19439,0,,10239
2,233246159,233281149,dup,HG02307,0,,34990
2,233271701,233311914,dup,HG02307,0,,40213
2,233440712,233488116,dup,HG03854,0,,47404
2,233443822,233465838,dup,HG03854,0,,22016
2,233476970,233483393,dup,HG03556,0,,6423
2,234649036,234660305,dup,HG00256,0,,11269
2,234975032,235031171,dup,HG03691,0,,56139
2,235673290,235725036,dup,HG02557,0,,51746
2,235681599,235754627,dup,HG02557,0,,73028
2,235727063,235805033,dup,HG02557,0,,77970
2,236347178,236385810,dup,NA21127,0,,38632
2,236352233,236360107,dup,HG04061,0,,7874
2,236356255,236387380,dup,NA20808,0,,31125
2,237386987,237432906,dup,HG02053,0,,45919
2,237541811,237555081,dup,HG03781,0,,13270
2,237633988,237660837,dup,NA18908,0,,26849
2,238706416,238777343,dup,HG03139,0,,70927
2,238732820,238775892,dup,HG03139,0,,43072
2,238745541,238775639,dup,HG03139,0,,30098
2,239279437,239292246,dup,HG02231,0,,12809
2,239778614,239801004,dup,NA20800,0,,22390
2,241274358,241376306,dup,HG02836,0,,101948
2,241389891,241401130,dup,HG02836,0,,11239
2,241411035,241417593,dup,HG02836,0,,6558
2,241427220,241464256,dup,NA18942,0,,37036
2,241427252,241514219,dup,NA18942,0,,86967
2,241613135,241651311,dup,HG03681,0,,38176
2,241641752,241708177,dup,HG01107,0,,66425
2,242202190,242219408,dup,HG02836,0,,17218
2,242250329,242257556,dup,HG02836,0,,7227
2,242261995,242278608,dup,HG02836,0,,16613
2,242265175,242275348,dup,HG01431,0,,10173
2,242289944,242337075,dup,HG02836,0,,47131
2,242358810,242429456,dup,HG02836,0,,70646
2,242380529,242389786,dup,HG02836,0,,9257
2,242393167,242427089,dup,HG02836,0,,33922
2,242737000,242749098,dup,HG01702,0,,12098
2,242839138,242856982,dup,HG00590,0,,17844
2,242852906,242902712,dup,HG00118,0,,49806
2,242890091,242926595,dup,HG00118,0,,36504
2,242953041,242994310,dup,HG00099,0,,41269
2,242988769,243037176,dup,HG00099,0,,48407
2,243027553,243069648,dup,HG00099,0,,42095
3,194560629,194568511,del,NA19471,0,,7882
3,158898196,158900698,del,NA18917,0,,2502
3,165219961,165224443,del,NA18912,0,,4482
3,174077077,174080640,del,NA19381,0,,3563
3,94918853,94919239,del,NA18635,0,,386
3,122616113,122617715,del,HG01066,0,,1602
3,106259289,106268047,del,NA19360,0,,8758
3,89670044,89678085,del,NA20816,0,,8041
3,107395888,107397663,del,HG00123,0,,1775
3,194290516,194290372,del,HG01107,0,,-144
3,70013474,70013887,del,NA19054,0,,413
3,189596462,189596662,del,HG00275,0,,200
3,39998162,39998897,del,NA19311,0,,735
3,141633916,141634319,del,NA19720,0,,403
3,75616216,75679122,del,HG00173,0,,62906
3,114832605,114833263,del,NA19391,0,,658
3,73143185,73145039,del,NA19404,0,,1854
3,82373110,82373218,del,NA18620,0,,108
3,29756452,29760871,del,NA18560,0,,4419
3,152306923,152307159,del,NA19707,0,,236
3,179398609,179398798,del,NA18628,0,,189
3,150738835,150744100,del,NA19436,0,,5265
3,32203877,32204164,del,HG01140,0,,287
3,80348667,80351791,del,HG01134,0,,3124
3,190977159,190977808,del,HG00139,0,,649
3,174621336,174630193,del,NA19469,0,,8857
3,13681182,13682272,del,HG00158,0,,1090
3,14291163,14296084,del,NA19462,0,,4921
3,111243620,111248925,del,NA20341,0,,5305
3,188779392,188779676,del,HG00662,0,,284
3,128672369,128675077,del,NA19920,0,,2708
3,180091266,180093522,del,HG01389,0,,2256
3,37245031,37251710,del,HG00472,0,,6679
3,7368447,7372641,del,NA19065,0,,4194
3,24745459,24820421,del,NA18620,0,,74962
3,77005637,77006775,del,NA19430,0,,1138
3,1365573,1366706,del,NA19102,0,,1133
3,46654698,46656258,del,NA19054,0,,1560
3,167971264,167973180,del,HG00524,0,,1916
3,97481424,97495545,del,HG00613,0,,14121
3,39757963,39766967,del,NA12892,0,,9004
3,172274279,172276462,del,HG01191,0,,2183
3,195856858,195862362,del,HG01519,0,,5504
3,98943416,98948972,del,NA12043,0,,5556
3,10991774,10992275,del,HG00512,0,,501
3,1682693,1694368,del,NA18637,0,,11675
3,11566541,11567059,del,NA19130,0,,518
3,6430197,6430485,del,NA18534,0,,288
3,131708253,131713434,del,NA20815,0,,5181
3,162215516,162235322,del,NA18990,0,,19806
3,19422648,19426506,del,NA20761,0,,3858
3,196565814,196566598,del,NA19625,0,,784
3,195133675,195144429,del,HG00629,0,,10754
3,197551175,197551682,del,NA18570,0,,507
3,65188869,65214748,del,HG00188,0,,25879
3,43859063,43864335,del,HG01351,0,,5272
3,160696547,160698385,del,NA20813,0,,1838
3,28765988,28766474,del,NA19099,0,,486
3,12771189,12771868,del,NA19248,0,,679
3,46976980,46978124,del,HG00276,0,,1144
3,93633015,93635016,del,HG00650,0,,2001
3,75512345,75517859,del,NA19469,0,,5514
3,21723705,21725857,del,NA18989,0,,2152
3,152744774,152748944,del,NA19661,0,,4170
3,186494821,186496662,del,NA19717,0,,1841
3,129076016,129082722,del,NA18961,0,,6706
3,125672300,125676376,del,NA19431,0,,4076
3,181931473,181936839,del,HG00149,0,,5366
3,39045939,39049302,del,NA19236,0,,3363
3,3791258,3792232,del,NA20753,0,,974
3,195559819,195561231,del,NA19360,0,,1412
3,82080551,82080712,del,NA18861,0,,161
3,99210288,99218361,del,HG00252,0,,8073
3,4932898,4938302,del,NA12489,0,,5404
3,78588006,78589398,del,NA18870,0,,1392
3,131988916,131993422,del,NA18960,0,,4506
3,192095747,192096272,del,NA20356,0,,525
3,128208416,128211922,del,HG00185,0,,3506
3,85542618,85549388,del,NA18986,0,,6770
3,125016263,125016597,del,NA20346,0,,334
3,64914566,64914754,del,HG00254,0,,188
3,80402030,80405850,del,NA19403,0,,3820
3,155463229,155463363,del,HG00272,0,,134
3,98170767,98174823,del,HG00336,0,,4056
3,10926406,10928089,del,NA20766,0,,1683
3,166070433,166074652,del,NA19056,0,,4219
3,175081066,175083472,del,NA20818,0,,2406
3,197307302,197314490,del,NA19436,0,,7188
3,43053657,43054553,del,NA19395,0,,896
3,165264620,165269161,del,HG00331,0,,4541
3,170115955,170120171,del,NA19355,0,,4216
3,105305316,105312322,del,HG00310,0,,7006
3,165447794,165661441,del,HG00258,0,,213647
3,141849748,141852487,del,NA19236,0,,2739
3,186407898,186419969,del,HG00243,0,,12071
3,78779418,78779718,del,HG01491,0,,300
3,32806746,32808061,del,NA19380,0,,1315
3,159257021,159257690,del,NA18553,0,,669
3,144236150,144241300,del,NA19917,0,,5150
3,191293213,191302186,del,HG01082,0,,8973
3,97869810,97922419,del,NA18522,0,,52609
3,8325638,8326811,del,NA20795,0,,1173
3,88468226,88480073,del,HG00684,0,,11847
3,98409901,98410405,del,HG01461,0,,504
3,44640455,44644122,del,NA19382,0,,3667
3,61069587,61112311,del,NA18621,0,,42724
3,87889775,87902357,del,NA18508,0,,12582
3,152606168,152612690,del,NA12045,0,,6522
3,125712244,125722069,del,NA19239,0,,9825
3,87263411,87263680,del,NA19712,0,,269
3,184266341,184273533,del,NA18574,0,,7192
3,20945212,20945311,del,HG00323,0,,99
3,68890204,68890495,del,HG00281,0,,291
3,130208617,130218369,del,NA19471,0,,9752
3,131354662,131354937,del,NA19331,0,,275
3,76190213,76192167,del,NA19448,0,,1954
3,173600634,173600892,del,NA19712,0,,258
3,139003743,139005339,del,NA18519,0,,1596
3,61666415,61666685,del,NA20127,0,,270
3,36555695,36557466,del,NA12400,0,,1771
3,129763566,129805122,del,HG01522,0,,41556
3,34532140,34532315,del,NA20815,0,,175
3,99380348,99385636,del,NA18553,0,,5288
3,59125219,59125546,del,HG01124,0,,327
3,110792686,110796319,del,HG01465,0,,3633
3,126276728,126282723,del,NA19311,0,,5995
3,66515178,66529659,del,HG00699,0,,14481
3,95782487,95785312,del,NA11918,0,,2825
3,1936509,1945214,del,NA19437,0,,8705
3,181354393,181354529,del,HG00375,0,,136
3,57525399,57526828,del,NA19060,0,,1429
3,131989091,131995050,del,NA19066,0,,5959
3,101357565,101359747,del,NA19002,0,,2182
3,195348535,195476556,del,NA18538,0,,128021
3,195494406,195494619,del,NA19116,0,,213
3,227966,234272,del,NA19723,0,,6306
3,192998857,193009448,del,NA18558,0,,10591
3,14729813,14731283,del,NA19347,0,,1470
3,48942686,48946075,del,NA19704,0,,3389
3,112763765,112766057,del,HG01149,0,,2292
3,195977615,195978192,del,HG00663,0,,577
3,190478458,190478634,del,NA19732,0,,176
3,176224131,176233297,del,NA18631,0,,9166
3,77809733,77813757,del,NA19469,0,,4024
3,125446070,125468648,del,HG00151,0,,22578
3,35934531,35938598,del,HG00117,0,,4067
3,196172541,196175669,del,HG00437,0,,3128
3,155120530,155124776,del,HG00556,0,,4246
3,27639047,27652510,del,NA19384,0,,13463
3,14178180,14178856,del,NA19197,0,,676
3,20919491,20919766,del,NA20798,0,,275
3,195683848,195684244,del,HG01183,0,,396
3,178106416,178106822,del,HG00589,0,,406
3,191064685,191071675,del,NA20757,0,,6990
3,6620516,6620700,del,HG01048,0,,184
3,152744709,152748742,del,NA19661,0,,4033
3,146415378,146417875,del,NA19360,0,,2497
3,191897217,191897965,del,NA18517,0,,748
3,26966612,26983823,del,NA18632,0,,17211
3,98140870,98151619,del,NA18565,0,,10749
3,159017955,159019009,del,NA20512,0,,1054
3,180262784,180263245,del,HG01140,0,,461
3,59954046,59958054,del,HG00619,0,,4008
3,1032867,1039428,del,NA19107,0,,6561
3,60778526,60779796,del,NA18870,0,,1270
3,178878613,178883883,del,HG00537,0,,5270
3,44383866,44386672,del,HG00628,0,,2806
3,95465764,95470763,del,NA12273,0,,4999
3,151621973,151622989,del,HG00428,0,,1016
3,107997420,107998043,del,NA19116,0,,623
3,168607362,168607905,del,NA19383,0,,543
3,55972105,55972379,del,NA18507,0,,274
3,127527884,127529131,del,NA12890,0,,1247
3,228416,234622,del,HG00672,0,,6206
3,42327629,42344920,del,NA19726,0,,17291
3,192744353,192744893,del,HG00663,0,,540
3,37272013,37272706,del,NA18553,0,,693
3,72875146,72878627,del,HG00247,0,,3481
3,107192802,107203756,del,HG00449,0,,10954
3,30067461,30071110,del,NA18871,0,,3649
3,182239994,182240599,del,NA20516,0,,605
3,196342178,196343282,del,NA19819,0,,1104
3,70943315,70943649,del,HG00108,0,,334
3,194555650,194556284,del,NA20828,0,,634
3,100521629,100522507,del,NA12044,0,,878
3,49986143,49993114,del,NA19082,0,,6971
3,29558397,29569558,del,HG01133,0,,11161
3,46705741,46709325,del,HG00334,0,,3584
3,28392084,28393315,del,NA18510,0,,1231
3,28669758,28671664,del,NA19399,0,,1906
3,36439906,36440063,del,HG01108,0,,157
3,20653871,20654260,del,NA18499,0,,389
3,148963370,148969708,del,HG01173,0,,6338
3,25849834,25855455,del,NA19138,0,,5621
3,185100852,185109209,del,NA19077,0,,8357
3,81554686,81561400,del,NA19393,0,,6714
3,51320073,51321381,del,NA07048,0,,1308
3,48173231,48175418,del,HG00736,0,,2187
3,161605029,161605238,del,HG01168,0,,209
3,9359850,9369125,del,HG00313,0,,9275
3,165988777,165990251,del,NA19908,0,,1474
3,72000681,72002841,del,NA19430,0,,2160
3,5414199,5421348,del,NA19394,0,,7149
3,33022764,33023101,del,NA18636,0,,337
3,56630460,56640977,del,NA19713,0,,10517
3,173209816,173215922,del,NA19471,0,,6106
3,33553189,33554075,del,NA19779,0,,886
3,158171029,158174195,del,NA19395,0,,3166
3,128329875,128330110,del,NA19350,0,,235
3,153465032,153470194,del,NA19468,0,,5162
3,194786054,194787474,del,NA19063,0,,1420
3,84849438,84876130,del,HG00372,0,,26692
3,22279172,22286404,del,NA19473,0,,7232
3,16450071,16450370,del,HG00108,0,,299
3,11410124,11414741,del,NA20516,0,,4617
3,171250140,171251390,del,HG00250,0,,1250
3,174158716,174158822,del,NA12043,0,,106
3,145518176,145520164,del,NA07048,0,,1988
3,189737344,189740524,del,NA18871,0,,3180
3,187832913,187849629,del,HG00463,0,,16716
3,133016123,133027436,del,NA19371,0,,11313
3,114656866,114668422,del,NA19713,0,,11556
3,40753749,40754437,del,NA20532,0,,688
3,197050480,197057052,del,HG01052,0,,6572
3,185594359,185597847,del,NA19334,0,,3488
3,98943803,98949515,del,HG01465,0,,5712
3,99393417,99395642,del,HG01462,0,,2225
3,23685755,23686211,del,NA18537,0,,456
3,195762184,195764408,del,NA19431,0,,2224
3,53495989,53500155,del,HG00180,0,,4166
3,176994730,176995026,del,HG01465,0,,296
3,181247749,181252785,del,NA11843,0,,5036
3,89486317,89490538,del,NA19676,0,,4221
3,168738454,168738835,del,NA11932,0,,381
3,134673902,134674555,del,HG01465,0,,653
3,46795504,46851172,del,NA19346,0,,55668
3,104645498,104645537,del,NA18950,0,,39
3,12259204,12260986,del,HG01136,0,,1782
3,90442351,90444892,del,HG00593,0,,2541
3,58233032,58234045,del,NA19360,0,,1013
3,185628780,185709257,del,HG00342,0,,80477
3,123969648,123971195,del,NA20519,0,,1547
3,186585596,186585885,del,NA19102,0,,289
3,75127655,75128297,del,NA18599,0,,642
3,148827571,148830820,del,NA19777,0,,3249
3,196188883,196189175,del,NA18910,0,,292
3,36711791,36719342,del,NA18909,0,,7551
3,196130884,196132241,del,HG00566,0,,1357
3,47985052,47987989,del,HG00189,0,,2937
3,30909958,30913431,del,NA19130,0,,3473
3,32940758,32940854,del,NA18582,0,,96
3,82931766,82933202,del,NA18986,0,,1436
3,67175548,67178437,del,NA12717,0,,2889
3,2320435,2320889,del,NA19312,0,,454
3,103870222,103870814,del,HG00698,0,,592
3,159917776,159918227,del,NA18517,0,,451
3,117534750,117536723,del,NA19663,0,,1973
3,76488509,76488503,del,HG01052,0,,-6
3,122107117,122112094,del,NA19431,0,,4977
3,135512530,135513443,del,NA11930,0,,913
3,129657308,129657872,del,HG00635,0,,564
3,108630850,108632695,del,NA19921,0,,1845
3,57005586,57007037,del,NA19920,0,,1451
3,9371272,9373685,del,NA19075,0,,2413
3,132718604,132723921,del,NA20341,0,,5317
3,53069269,53069254,del,NA19403,0,,-15
3,138612278,138615601,del,NA18619,0,,3323
3,195487453,195487583,del,HG00698,0,,130
3,96875735,96882000,del,HG00131,0,,6265
3,19006073,19006354,del,NA19401,0,,281
3,26701520,26709405,del,HG00315,0,,7885
3,119655170,119656863,del,NA19238,0,,1693
3,156874481,156893187,del,NA19054,0,,18706
3,179765841,179792445,del,HG00584,0,,26604
3,67562194,67563618,del,NA19102,0,,1424
3,111038737,111039151,del,NA18858,0,,414
3,178081819,178136530,del,NA19373,0,,54711
3,3051549,3055366,del,HG00281,0,,3817
3,23124079,23127366,del,NA19443,0,,3287
3,126521299,126523298,del,NA19311,0,,1999
3,26449616,26452172,del,NA19057,0,,2556
3,165654325,165655577,del,NA18909,0,,1252
3,15314075,15314203,del,HG00702,0,,128
3,63104382,63107183,del,NA19434,0,,2801
3,197635153,197635559,del,NA19225,0,,406
3,183358416,183364606,del,HG00500,0,,6190
3,59493061,59493181,del,HG00119,0,,120
3,185843897,185844087,del,HG00684,0,,190
3,47524322,47533208,del,NA19346,0,,8886
3,87447672,87456524,del,NA19428,0,,8852
3,192966367,192968485,del,HG00334,0,,2118
3,110494040,110496120,del,HG00692,0,,2080
3,7711553,7711754,del,NA18487,0,,201
3,87701740,87703220,del,NA19401,0,,1480
3,75798910,75803023,del,NA19469,0,,4113
3,4218384,4224304,del,HG00656,0,,5920
3,6700870,6701253,del,HG00353,0,,383
3,143150481,143151627,del,NA18599,0,,1146
3,46223515,46223795,del,HG01075,0,,280
3,41598768,41601023,del,NA18595,0,,2255
3,145068251,145072905,del,NA20753,0,,4654
3,10034023,10035071,del,NA18597,0,,1048
3,76171451,76185484,del,HG00329,0,,14033
3,32029552,32032427,del,NA20757,0,,2875
3,41156011,41161433,del,NA19390,0,,5422
3,125442934,125465511,del,NA19318,0,,22577
3,133503766,133505082,del,HG00418,0,,1316
3,106835395,106835839,del,NA18636,0,,444
3,135014891,135015813,del,NA19313,0,,922
3,10226171,10228944,del,NA18867,0,,2773
3,128430301,128432779,del,HG00327,0,,2478
3,168263356,168264375,del,NA19703,0,,1019
3,109489074,109489330,del,NA18991,0,,256
3,33003535,33003743,del,HG01082,0,,208
3,190943652,190948400,del,NA18487,0,,4748
3,19802986,19806308,del,NA19703,0,,3322
3,131988716,131993772,del,HG00157,0,,5056
3,170565666,170565917,del,HG00437,0,,251
3,74685633,74685970,del,HG00319,0,,337
3,142610367,142612763,del,NA19238,0,,2396
3,20830253,20835354,del,NA19055,0,,5101
3,11699698,11700106,del,NA19985,0,,408
3,186437347,186438943,del,HG01188,0,,1596
3,143219586,143221216,del,NA18498,0,,1630
3,12402389,12411677,del,NA19445,0,,9288
3,194614723,194615039,del,NA12751,0,,316
3,87424152,87426331,del,HG01383,0,,2179
3,5535216,5538622,del,NA19758,0,,3406
3,131546149,131547007,del,NA19456,0,,858
3,44075601,44075777,del,NA19372,0,,176
3,197580931,197581988,del,NA11829,0,,1057
3,133810420,133811963,del,HG00650,0,,1543
3,65441160,65454387,del,NA12342,0,,13227
3,51053173,51058781,del,NA19256,0,,5608
3,48350591,48355647,del,HG00278,0,,5056
3,11955662,12913212,del,NA18538,0,,957550
3,1730721,1735064,del,HG00565,0,,4343
3,184759856,184765225,del,NA18560,0,,5369
3,104278446,104278583,del,NA20774,0,,137
3,99785350,99785656,del,NA18965,0,,306
3,110256972,110257256,del,NA19398,0,,284
3,10273549,10281131,del,HG00513,0,,7582
3,141080991,141084198,del,NA19467,0,,3207
3,193135464,193142943,del,NA18944,0,,7479
3,102807688,102810418,del,HG01124,0,,2730
3,56055392,56061914,del,HG00701,0,,6522
3,195155654,195156047,del,NA19383,0,,393
3,135451018,135456665,del,NA18576,0,,5647
3,184169329,184170653,del,NA19057,0,,1324
3,170356052,170358391,del,HG00590,0,,2339
3,70058390,70067335,del,HG01070,0,,8945
3,196761164,196761765,del,NA19712,0,,601
3,20374322,20376980,del,NA19403,0,,2658
3,330015,330863,del,NA19700,0,,848
3,144693110,144693236,del,NA20524,0,,126
3,61475048,61475371,del,NA19676,0,,323
3,197781684,197783588,del,NA19397,0,,1904
3,88081625,88083976,del,NA19334,0,,2351
3,155973519,155988621,del,HG00628,0,,15102
3,8721250,8722772,del,HG00277,0,,1522
3,60833012,60843246,del,NA19350,0,,10234
3,190114171,190151461,del,NA19446,0,,37290
3,103547912,103548231,del,HG00285,0,,319
3,25718758,25724488,del,NA18602,0,,5730
3,94395229,94409814,del,NA12045,0,,14585
3,192544907,192546660,del,NA19471,0,,1753
3,189091987,189100073,del,NA18605,0,,8086
3,155269197,155270395,del,NA19066,0,,1198
3,151965065,151969924,del,NA20819,0,,4859
3,7347024,7347322,del,NA19985,0,,298
3,77909055,77910189,del,NA19916,0,,1134
3,189737316,189741622,del,HG00247,0,,4306
3,77338867,77345197,del,HG01052,0,,6330
3,54881320,54882574,del,HG00531,0,,1254
3,85211853,85213293,del,NA19129,0,,1440
3,75567716,75581322,del,HG00534,0,,13606
3,14296179,14296727,del,HG00278,0,,548
3,1164141,1165208,del,NA19835,0,,1067
3,88468198,88479929,del,HG00537,0,,11731
3,902322,902621,del,NA18510,0,,299
3,4644508,4652138,del,HG00274,0,,7630
3,185581951,185584937,del,NA19707,0,,2986
3,195926603,195928382,del,NA20799,0,,1779
3,60800033,60809474,del,HG01342,0,,9441
3,130132024,130132904,del,HG00267,0,,880
3,136021013,136026199,del,NA18967,0,,5186
3,10190068,10190866,del,NA19445,0,,798
3,120567138,120572390,del,NA20799,0,,5252
3,27713557,27718270,del,HG00476,0,,4713
3,20988433,20996177,del,NA18596,0,,7744
3,58534778,58537324,del,NA19701,0,,2546
3,54732849,54735614,del,NA18940,0,,2765
3,76062793,76063515,del,NA18557,0,,722
3,163077693,163079747,del,NA19313,0,,2054
3,32838707,32839066,del,NA18562,0,,359
3,3611354,3616764,del,NA19663,0,,5410
3,195818689,195819188,del,NA19428,0,,499
3,84699570,84702929,del,NA18982,0,,3359
3,72735680,72736787,del,HG00704,0,,1107
3,62610617,62612048,del,NA19376,0,,1431
3,22279322,22286417,del,NA19082,0,,7095
3,197456462,197457948,del,HG01136,0,,1486
3,162213705,162235596,del,NA18553,0,,21891
3,112704872,112705006,del,NA19469,0,,134
3,15012781,15013333,del,NA18956,0,,552
3,173210216,173215922,del,NA19908,0,,5706
3,28809969,28817808,del,HG01354,0,,7839
3,278372,278577,del,NA19190,0,,205
3,101251520,101253875,del,NA19371,0,,2355
3,181501709,181507059,del,NA19435,0,,5350
3,4083617,4130553,del,HG00254,0,,46936
3,29620282,29620604,del,NA18986,0,,322
3,11782246,11784276,del,NA19116,0,,2030
3,1927225,1950792,del,NA18613,0,,23567
3,94989317,94991138,del,HG00271,0,,1821
3,75433742,75434525,del,NA18508,0,,783
3,176486855,176487303,del,NA19457,0,,448
3,24780898,24785627,del,NA20346,0,,4729
3,107858475,107859308,del,NA20765,0,,833
3,165472012,165472171,del,NA19707,0,,159
3,69179662,69181541,del,HG00595,0,,1879
3,97868969,97916790,del,NA19397,0,,47821
3,106595392,106619779,del,NA19908,0,,24387
3,95583255,95587368,del,HG01051,0,,4113
3,168296021,168296409,del,NA20126,0,,388
3,40132766,40132801,del,NA18530,0,,35
3,118579015,118580098,del,NA19350,0,,1083
3,123609038,123610784,del,HG00334,0,,1746
3,99600473,99604256,del,NA18999,0,,3783
3,115247990,115249807,del,NA19313,0,,1817
3,125672466,125677372,del,NA19397,0,,4906
3,65988769,65992597,del,NA19463,0,,3828
3,39367267,39367571,del,NA19350,0,,304
3,195348536,195476540,del,NA12058,0,,128004
3,150553865,150555781,del,NA18511,0,,1916
3,17638284,17650012,del,NA19908,0,,11728
3,87305600,87306641,del,NA18498,0,,1041
3,192776859,192782598,del,HG00311,0,,5739
3,50300704,50301416,del,NA19463,0,,712
3,138837229,138837668,del,HG00613,0,,439
3,144281524,144292584,del,NA18856,0,,11060
3,112222692,112225531,del,HG00419,0,,2839
3,89394023,89419406,del,HG01390,0,,25383
3,30865778,30866269,del,NA19398,0,,491
3,134686733,134688661,del,NA19435,0,,1928
3,67832613,67832943,del,NA12156,0,,330
3,156092163,156093691,del,HG00111,0,,1528
3,72180031,72180520,del,HG01079,0,,489
3,46437714,46438737,del,NA20281,0,,1023
3,2615841,2617136,del,NA19451,0,,1295
3,97887843,97916351,del,NA19444,0,,28508
3,5929596,5930565,del,NA19726,0,,969
3,169641467,169642154,del,NA18637,0,,687
3,140522489,140523645,del,NA18592,0,,1156
3,146966602,146970041,del,NA19448,0,,3439
3,82691338,82691531,del,HG00501,0,,193
3,129048131,129048745,del,NA18933,0,,614
3,54241168,54241556,del,HG00651,0,,388
3,127529690,127530122,del,NA19347,0,,432
3,148281434,148285419,del,HG00124,0,,3985
3,99046837,99056003,del,HG00139,0,,9166
3,183817370,183819213,del,NA18543,0,,1843
3,76477248,76482575,del,HG01366,0,,5327
3,175733412,176166461,del,NA19713,0,,433049
3,18839878,18840013,del,HG00608,0,,135
3,195773912,195774975,del,HG00662,0,,1063
3,89573271,89573491,del,NA19102,0,,220
3,103922989,103925193,del,HG01067,0,,2204
3,189839762,189841159,del,NA19395,0,,1397
3,121272628,121273440,del,NA18526,0,,812
3,1782293,1788530,del,HG01080,0,,6237
3,86459356,86460041,del,NA19701,0,,685
3,90323992,90399327,del,HG01171,0,,75335
3,109103300,109104946,del,NA18947,0,,1646
3,19915903,19915967,del,NA19372,0,,64
3,188135644,188136830,del,NA18526,0,,1186
3,7400636,7402118,del,NA19437,0,,1482
3,935499,1284639,del,NA19070,0,,349140
3,131947936,131950641,del,NA19374,0,,2705
3,75105305,75111176,del,NA18552,0,,5871
3,185899987,185902205,del,NA18582,0,,2218
3,171251926,171254036,del,NA07051,0,,2110
3,27530194,27530572,del,NA19916,0,,378
3,36057074,36057559,del,HG01082,0,,485
3,104291896,104300456,del,NA18486,0,,8560
3,190822919,190824154,del,HG00613,0,,1235
3,114113342,114114518,del,NA18534,0,,1176
3,63802539,63803850,del,NA19393,0,,1311
3,159428985,159429184,del,NA18532,0,,199
3,32958004,32964127,del,HG00281,0,,6123
3,13706276,13710394,del,NA18853,0,,4118
3,174615604,174615934,del,NA18861,0,,330
3,990694,996744,del,NA19376,0,,6050
3,166844616,166847122,del,NA19189,0,,2506
3,129633004,129634937,del,NA19982,0,,1933
3,194121164,194121921,del,HG01066,0,,757
3,8721581,8723400,del,HG00277,0,,1819
3,177780143,177781388,del,NA18505,0,,1245
3,192389879,192392031,del,NA20502,0,,2152
3,77812812,77818829,del,NA12717,0,,6017
3,195687963,195688413,del,HG01134,0,,450
3,106242243,106246640,del,NA19375,0,,4397
3,853578,860792,del,HG00637,0,,7214
3,191064685,191071667,del,NA12546,0,,6982
3,86848237,86855275,del,NA19707,0,,7038
3,105075666,105077991,del,HG00151,0,,2325
3,195212727,195216122,del,NA18963,0,,3395
3,141565565,141566762,del,NA18617,0,,1197
3,37440542,37441965,del,NA19431,0,,1423
3,49976200,49976972,del,NA19382,0,,772
3,196759405,196759783,del,HG01188,0,,378
3,191326547,191335506,del,HG01108,0,,8959
3,10207759,10208562,del,NA19257,0,,803
3,177753630,177757120,del,NA18508,0,,3490
3,28950215,28950765,del,NA18502,0,,550
3,149585265,149588892,del,HG01107,0,,3627
3,45543293,45552058,del,NA20786,0,,8765
3,128410644,128415400,del,HG00442,0,,4756
3,49073569,49075758,del,NA19788,0,,2189
3,147155013,147156944,del,HG00143,0,,1931
3,187461316,187464822,del,NA19385,0,,3506
3,47524284,47533168,del,NA19346,0,,8884
3,28508737,28509002,del,NA18868,0,,265
3,79960808,79961262,del,NA18567,0,,454
3,153534937,153535291,del,NA19700,0,,354
3,1460523,1461301,del,HG00177,0,,778
3,59348557,59352031,del,NA19473,0,,3474
3,75078076,75085859,del,NA18550,0,,7783
3,38128786,38128915,del,HG00337,0,,129
3,99243262,99244870,del,NA19190,0,,1608
3,76125912,76130580,del,NA19443,0,,4668
3,67571959,67573425,del,NA19375,0,,1466
3,3014481,3015546,del,NA19332,0,,1065
3,168755203,168756523,del,NA19374,0,,1320
3,5535397,5539280,del,NA12414,0,,3883
3,81905285,81913645,del,NA18530,0,,8360
3,160661874,160667202,del,HG01069,0,,5328
3,178106039,178107105,del,NA18623,0,,1066
3,179119317,179121521,del,NA19663,0,,2204
3,108758634,108760831,del,NA18558,0,,2197
3,197825813,197826761,del,NA19390,0,,948
3,57954097,57977712,del,NA19009,0,,23615
3,22092347,22097795,del,NA19777,0,,5448
3,26931736,26932715,del,HG00656,0,,979
3,39761235,39778837,del,NA20537,0,,17602
3,104505309,104507393,del,NA19448,0,,2084
3,173621452,173623533,del,HG00478,0,,2081
3,21756533,21757644,del,NA18570,0,,1111
3,113118268,113118406,del,HG00263,0,,138
3,60824616,60909508,del,NA11992,0,,84892
3,50340916,50348422,del,NA19384,0,,7506
3,158171085,158174186,del,NA19901,0,,3101
3,36764172,36766102,del,NA19678,0,,1930
3,86466091,86467243,del,NA18617,0,,1152
3,5281136,5281325,del,HG00740,0,,189
3,98410678,98414783,del,NA18985,0,,4105
3,161818066,161818251,del,HG01488,0,,185
3,164097652,164113662,del,HG00590,0,,16010
3,80361303,80362779,del,NA18912,0,,1476
3,166844629,166849282,del,NA19054,0,,4653
3,130070666,130075582,del,NA19437,0,,4916
3,88348624,88460502,del,NA12878,0,,111878
3,16652681,16658741,del,NA19435,0,,6060
3,144556512,144556804,del,NA19455,0,,292
3,83859885,83863637,del,NA19471,0,,3752
3,68634770,68640253,del,NA18636,0,,5483
3,89006360,89006495,del,NA18532,0,,135
3,41564249,41667402,del,NA18631,0,,103153
3,196934573,196939255,del,NA18543,0,,4682
3,90464972,90467022,del,NA19713,0,,2050
3,119655170,119656860,del,NA19462,0,,1690
3,55382825,55385860,del,HG01342,0,,3035
3,106846837,106847997,del,HG00524,0,,1160
3,185789472,185789882,del,NA11894,0,,410
3,145479210,145479716,del,HG01080,0,,506
3,26585488,26588744,del,HG00120,0,,3256
3,102087250,102102924,del,NA18948,0,,15674
3,135972312,135973460,del,HG00310,0,,1148
3,124936295,124937163,del,HG00267,0,,868
3,194717256,194720382,del,NA19818,0,,3126
3,44382095,44386843,del,HG00448,0,,4748
3,196319156,196321999,del,NA19472,0,,2843
3,193232225,193232464,del,NA18544,0,,239
3,4212334,4255310,del,NA19780,0,,42976
3,147627184,147628104,del,NA07357,0,,920
3,82868835,82872876,del,HG01494,0,,4041
3,101521207,101521766,del,NA19982,0,,559
3,74147585,74154797,del,NA19102,0,,7212
3,152563239,152564622,del,HG00479,0,,1383
3,196172039,196172578,del,HG01171,0,,539
3,9921126,9930037,del,HG00536,0,,8911
3,114656952,114668601,del,NA19390,0,,11649
3,67247661,67255179,del,HG01136,0,,7518
3,146427477,146428283,del,NA18532,0,,806
3,58533966,58537172,del,NA19920,0,,3206
3,97033880,97043302,del,HG01188,0,,9422
3,30869597,30877941,del,HG00543,0,,8344
3,126668325,126668436,del,HG00705,0,,111
3,57003270,57003433,del,NA07000,0,,163
3,82088566,82090778,del,NA19652,0,,2212
3,95465768,95468116,del,HG00320,0,,2348
3,14620642,14622360,del,NA18539,0,,1718
3,191788552,191789037,del,HG00629,0,,485
3,194993505,194993669,del,HG00533,0,,164
3,41818060,41821493,del,HG00369,0,,3433
3,116098925,116110184,del,NA18508,0,,11259
3,176194800,176197952,del,HG00261,0,,3152
3,132597634,132598731,del,NA18908,0,,1097
3,1917809,1923213,del,NA19701,0,,5404
3,180937633,180948250,del,HG00478,0,,10617
3,164526039,164553450,del,HG00543,0,,27411
3,164528396,164555675,del,HG00543,0,,27279
3,140760336,140765196,del,NA18510,0,,4860
3,59690156,59692784,del,NA19652,0,,2628
3,191504725,191509019,del,NA19391,0,,4294
3,119797493,119797864,del,HG00533,0,,371
3,195457318,195471074,del,HG00464,0,,13756
3,63779974,63780276,del,NA18530,0,,302
3,108629366,108632572,del,NA19921,0,,3206
3,60106348,60109653,del,NA19701,0,,3305
3,176051574,176052728,del,HG00108,0,,1154
3,103593827,103603285,del,NA18868,0,,9458
3,175078666,175084522,del,NA19648,0,,5856
3,32838582,32839074,del,NA19058,0,,492
3,66049244,66049558,del,HG00231,0,,314
3,96050705,96051803,del,NA18907,0,,1098
3,95543522,95548320,del,NA19707,0,,4798
3,34134785,34140514,del,HG00513,0,,5729
3,175887200,175914896,del,NA20787,0,,27696
3,49518016,49518349,del,HG00233,0,,333
3,126454725,126456703,del,NA18637,0,,1978
3,135430327,135435660,del,NA19711,0,,5333
3,184125372,184125568,del,NA20760,0,,196
3,193742897,193742994,del,HG00672,0,,97
3,181613363,181613996,del,NA19461,0,,633
3,54008314,54035615,del,NA12283,0,,27301
3,157339195,157342961,del,NA19189,0,,3766
3,90464942,90466974,del,HG01188,0,,2032
3,9895487,9896808,del,HG01137,0,,1321
3,31346785,31351678,del,HG00641,0,,4893
3,56886364,56896152,del,HG00237,0,,9788
3,26966726,26983836,del,NA18632,0,,17110
3,24107157,24114582,del,NA18953,0,,7425
3,178404680,178405233,del,HG00319,0,,553
3,192264689,192268288,del,NA18526,0,,3599
3,179883279,179883429,del,HG01390,0,,150
3,10172962,10177494,del,NA19359,0,,4532
3,108599163,108600015,del,NA20342,0,,852
3,99491303,99495366,del,NA11920,0,,4063
3,106735977,106736232,del,NA11930,0,,255
3,194355453,194356576,del,NA19379,0,,1123
3,227666,234622,del,NA19430,0,,6956
3,143950931,143954420,del,NA19463,0,,3489
3,194786365,194787406,del,HG00693,0,,1041
3,32201774,32202000,del,NA18603,0,,226
3,41194149,41194851,del,NA19660,0,,702
3,101493567,101495010,del,NA19437,0,,1443
3,117770300,117776169,del,NA19467,0,,5869
3,137902678,137903128,del,NA18550,0,,450
3,125416297,125438530,del,NA19713,0,,22233
3,197843722,197850400,del,NA19779,0,,6678
3,130837111,130843937,del,NA19347,0,,6826
3,14809659,14811053,del,NA19440,0,,1394
3,89066925,89076127,del,HG00583,0,,9202
3,179581060,179586770,del,HG01437,0,,5710
3,5534668,5539159,del,NA18952,0,,4491
3,61127189,61128193,del,NA11892,0,,1004
3,183078434,183083780,del,NA18602,0,,5346
3,197576354,197583054,del,NA20513,0,,6700
3,72559901,72567225,del,HG00501,0,,7324
3,143608516,143608698,del,NA19449,0,,182
3,21822221,21823303,del,NA18908,0,,1082
3,113030297,113032581,del,NA18908,0,,2284
3,72738522,72739573,del,NA19079,0,,1051
3,172586702,172594202,del,NA20808,0,,7500
3,74765412,74765735,del,NA18971,0,,323
3,87426558,87429025,del,HG01383,0,,2467
3,68069330,68073805,del,HG01171,0,,4475
3,6897201,6900012,del,HG01191,0,,2811
3,81250,1080871,del,HG01048,0,,999621
3,97854433,97890455,del,NA19713,0,,36022
3,61855708,61856832,del,NA19451,0,,1124
3,165654366,165655490,del,NA19138,0,,1124
3,89245621,89245822,del,NA20342,0,,201
3,10766457,10775091,del,HG01390,0,,8634
3,190237896,190240448,del,HG00119,0,,2552
3,2028401,2029243,del,NA19463,0,,842
3,156012607,156019610,del,HG00271,0,,7003
3,8490969,8496919,del,HG00626,0,,5950
3,35287103,35289054,del,NA19437,0,,1951
3,87915729,87916769,del,HG00318,0,,1040
3,126253732,126254270,del,NA19676,0,,538
3,142641926,142643443,del,NA19819,0,,1517
3,195185920,195187397,del,NA19725,0,,1477
3,73063077,73063554,del,NA19448,0,,477
3,148410850,148413235,del,NA19661,0,,2385
3,151764930,151765370,del,NA18873,0,,440
3,151799144,151799901,del,NA18574,0,,757
3,3997288,4012089,del,NA18486,0,,14801
3,129046197,129047356,del,HG00277,0,,1159
3,69317045,69318648,del,NA19403,0,,1603
3,102595403,102595828,del,NA18980,0,,425
3,162717306,162723554,del,HG01455,0,,6248
3,94427486,94429645,del,NA18574,0,,2159
3,82823703,82824097,del,HG00554,0,,394
3,178797117,178798374,del,HG00253,0,,1257
3,123315423,123316946,del,NA19190,0,,1523
3,183078372,183084155,del,NA18602,0,,5783
3,168369751,168384460,del,NA19904,0,,14709
3,196188369,196188536,del,HG01353,0,,167
3,50997178,51033815,del,HG01353,0,,36637
3,194710826,194714314,del,NA11920,0,,3488
3,249969,250225,del,NA19385,0,,256
3,118281604,118281828,del,HG01440,0,,224
3,191011210,191013665,del,NA19380,0,,2455
3,150543455,150544813,del,HG01168,0,,1358
3,189737466,189740772,del,NA19375,0,,3306
3,24802904,24804498,del,NA19384,0,,1594
3,145644968,145649190,del,NA12342,0,,4222
3,129763916,129799322,del,HG01456,0,,35406
3,99065555,99069475,del,NA19397,0,,3920
3,195654390,195655363,del,NA18526,0,,973
3,4270671,4272207,del,HG00584,0,,1536
3,27695876,27698032,del,NA18964,0,,2156
3,56467072,56468235,del,NA20772,0,,1163
3,57877578,57878796,del,NA18526,0,,1218
3,111524433,111524641,del,HG00656,0,,208
3,189224507,189225371,del,NA12890,0,,864
3,36495119,36495286,del,HG00326,0,,167
3,128173061,128173159,del,NA18636,0,,98
3,77825641,77845486,del,NA18950,0,,19845
3,138612769,138616323,del,NA18619,0,,3554
3,125607908,125608106,del,NA19819,0,,198
3,114991641,114992436,del,NA20805,0,,795
3,185565497,185567700,del,NA19440,0,,2203
3,853746,860996,del,HG01060,0,,7250
3,80062866,80064469,del,HG00326,0,,1603
3,131879115,131879169,del,NA18498,0,,54
3,157419732,157421908,del,HG00654,0,,2176
3,152723024,152724146,del,NA19834,0,,1122
3,22362142,22369424,del,HG00534,0,,7282
3,99628782,99629631,del,NA19138,0,,849
3,76017910,76018109,del,HG01066,0,,199
3,67958402,67960094,del,NA19066,0,,1692
3,184356416,184363931,del,NA19081,0,,7515
3,81676488,81692732,del,HG00595,0,,16244
3,160310645,160319476,del,NA12342,0,,8831
3,140193794,140194014,del,HG00689,0,,220
3,188555362,188557838,del,HG00250,0,,2476
3,195949334,195951245,del,HG00159,0,,1911
3,34119742,34120332,del,NA19239,0,,590
3,29695039,29700924,del,HG00266,0,,5885
3,180173589,180173839,del,HG00313,0,,250
3,187731416,187734572,del,NA18611,0,,3156
3,6650160,6654637,del,HG01107,0,,4477
3,55891737,55898530,del,NA19070,0,,6793
3,169868483,169871389,del,NA19717,0,,2906
3,50123748,50124813,del,HG00190,0,,1065
3,100669297,100670857,del,HG01095,0,,1560
3,28720195,28722154,del,NA19655,0,,1959
3,21775158,21786048,del,HG00258,0,,10890
3,46795338,46851008,del,NA18924,0,,55670
3,197434063,197437189,del,HG01137,0,,3126
3,108400577,108402200,del,NA19360,0,,1623
3,132805125,132807157,del,NA19350,0,,2032
3,12365551,12366427,del,NA19099,0,,876
3,41024585,41027102,del,HG00318,0,,2517
3,87458154,87460258,del,HG00476,0,,2104
3,164302128,164311802,del,NA19469,0,,9674
3,159461351,159463464,del,NA12892,0,,2113
3,194744060,194744311,del,HG00111,0,,251
3,26432216,26444422,del,NA11881,0,,12206
3,197206954,197213939,del,NA19428,0,,6985
3,23514004,23518665,del,NA18511,0,,4661
3,111243916,111249422,del,HG01197,0,,5506
3,90463048,90476753,del,HG00619,0,,13705
3,132330358,132332807,del,NA19704,0,,2449
3,116204455,116218321,del,NA19819,0,,13866
3,121103917,121108397,del,NA19381,0,,4480
3,103181888,103183048,del,NA20342,0,,1160
3,145146469,145146971,del,NA19359,0,,502
3,135697033,135701143,del,NA19711,0,,4110
3,9560968,9563298,del,NA19138,0,,2330
3,195340211,195340345,del,NA19391,0,,134
3,195115649,195115891,del,NA19147,0,,242
3,125445239,125467836,del,NA18856,0,,22597
3,108804380,108810166,del,NA19448,0,,5786
3,119419913,119420343,del,NA18623,0,,430
3,133235074,133235528,del,NA18522,0,,454
3,144455796,144457187,del,NA19452,0,,1391
3,21004493,21006409,del,NA19396,0,,1916
3,228699,234355,del,NA18576,0,,5656
3,90403814,90409602,del,HG00693,0,,5788
3,17720062,17725029,del,NA18504,0,,4967
3,141683962,141685841,del,NA19138,0,,1879
3,188170097,188170446,del,NA18555,0,,349
3,19605133,19692194,del,NA19070,0,,87061
3,109580711,109580811,del,HG00542,0,,100
3,120161644,120164951,del,NA18489,0,,3307
3,1606611,1609372,del,NA19429,0,,2761
3,90235083,90237206,del,HG00732,0,,2123
3,134366428,134370126,del,NA19982,0,,3698
3,150121943,150122159,del,NA18951,0,,216
3,108964373,108966599,del,NA19469,0,,2226
3,186452726,186453380,del,NA18536,0,,654
3,38154940,38155075,del,HG00464,0,,135
3,41336680,41337229,del,HG01375,0,,549
3,98394400,98395161,del,NA19437,0,,761
3,147836947,147839935,del,NA20281,0,,2988
3,20875154,20876512,del,HG00596,0,,1358
3,53029016,53038722,del,NA19750,0,,9706
3,2877410,2879695,del,NA18606,0,,2285
3,177780249,177782694,del,NA18941,0,,2445
3,15566474,15566841,del,HG00584,0,,367
3,165987485,165987821,del,NA19664,0,,336
3,71460555,71461931,del,HG00662,0,,1376
3,177381315,177385413,del,NA20771,0,,4098
3,165289054,165321687,del,NA19007,0,,32633
3,2469332,2469692,del,NA18516,0,,360
3,105305993,105311028,del,NA19652,0,,5035
3,88453730,88454008,del,HG01066,0,,278
3,23088845,23092100,del,NA19914,0,,3255
3,186094743,186096803,del,NA19092,0,,2060
3,18729953,18730778,del,HG00533,0,,825
3,15845170,15846736,del,NA12414,0,,1566
3,173787480,173792673,del,NA20517,0,,5193
3,121256618,121258216,del,HG00247,0,,1598
3,130578516,130578792,del,NA18593,0,,276
3,6650160,6654708,del,HG00637,0,,4548
3,7400040,7400447,del,NA19397,0,,407
3,45496872,45497770,del,NA19678,0,,898
3,5048889,5050433,del,NA20534,0,,1544
3,195756567,195761584,del,HG01488,0,,5017
3,104987289,104989475,del,HG00732,0,,2186
3,1144200,1144577,del,HG00152,0,,377
3,51772896,51772877,del,NA19391,0,,-19
3,35400146,35414294,del,NA19440,0,,14148
3,110647162,110647813,del,HG00353,0,,651
3,68289299,68294944,del,NA18549,0,,5645
3,8722690,8723109,del,HG00335,0,,419
3,27195705,27198342,del,NA19474,0,,2637
3,162010402,162026229,del,NA06984,0,,15827
3,524816,525622,del,HG00278,0,,806
3,49566869,49567993,del,NA19346,0,,1124
3,196557447,196561504,del,NA18622,0,,4057
3,65117793,65119665,del,HG01366,0,,1872
3,45806062,45806573,del,NA19393,0,,511
3,14385053,14392165,del,NA19248,0,,7112
3,101825083,101833893,del,HG00237,0,,8810
3,149345587,149345885,del,HG00584,0,,298
3,129763380,129806745,del,HG00372,0,,43365
3,59205448,59207227,del,NA19652,0,,1779
3,67492432,67496847,del,NA18623,0,,4415
3,175080088,175085081,del,NA19470,0,,4993
3,108467116,108474422,del,HG00536,0,,7306
3,171747172,171749081,del,NA19350,0,,1909
3,66972462,66977892,del,HG00663,0,,5430
3,76083729,76096041,del,NA19248,0,,12312
3,107357006,107359507,del,HG00245,0,,2501
3,147444566,147447172,del,HG01182,0,,2606
3,190669797,190670120,del,NA18517,0,,323
3,197648071,197648493,del,NA18523,0,,422
3,37452874,37455583,del,NA19099,0,,2709
3,97887583,97916041,del,NA19444,0,,28458
3,10060296,10060730,del,HG01080,0,,434
3,184335106,184335410,del,NA12154,0,,304
3,99698780,99700913,del,HG00589,0,,2133
3,26461528,26463057,del,NA19371,0,,1529
3,115886850,115902051,del,NA20799,0,,15201
3,165175064,165176655,del,HG00419,0,,1591
3,12259154,12261401,del,HG01136,0,,2247
3,5609124,5609647,del,NA19707,0,,523
3,195457248,195471004,del,HG00731,0,,13756
3,195375114,195375895,del,NA19468,0,,781
3,180091669,180092914,del,HG01187,0,,1245
3,21991558,21993634,del,NA19347,0,,2076
3,56794692,56800843,del,HG00318,0,,6151
3,185512051,185512277,del,NA20278,0,,226
3,181810733,181840754,del,HG00284,0,,30021
3,148197160,148197293,del,HG01052,0,,133
3,49517830,49522297,del,HG00590,0,,4467
3,95699091,95714768,del,NA19625,0,,15677
3,96307543,96327159,del,HG00320,0,,19616
3,82314460,82320238,del,HG00613,0,,5778
3,30994735,30999827,del,NA18510,0,,5092
3,141572149,141572876,del,NA18612,0,,727
3,175973926,175987366,del,NA19470,0,,13440
3,177905167,177908752,del,NA19070,0,,3585
3,15314091,15314223,del,NA19375,0,,132
3,1919216,1922922,del,NA19707,0,,3706
3,52669559,52670874,del,HG01441,0,,1315
3,157765172,157767717,del,NA20543,0,,2545
3,86622740,86624072,del,NA19446,0,,1332
3,83339284,83342723,del,NA19917,0,,3439
3,44538251,44539765,del,HG00329,0,,1514
3,81223148,81223958,del,HG01073,0,,810
3,49469418,49473383,del,NA19435,0,,3965
3,60846049,60846931,del,NA11843,0,,882
3,16067649,16076211,del,NA19788,0,,8562
3,30253247,30253790,del,NA19398,0,,543
3,21287067,21288709,del,NA19703,0,,1642
3,197673625,197674814,del,NA20826,0,,1189
3,145012467,145024652,del,NA19470,0,,12185
3,14784381,14786296,del,NA19909,0,,1915
3,119350588,119354097,del,NA20543,0,,3509
3,40452753,40462147,del,NA19472,0,,9394
3,116523388,116526830,del,NA19130,0,,3442
3,56604699,56604955,del,NA19747,0,,256
3,45768351,45768676,del,NA12878,0,,325
3,82909210,82911361,del,NA19469,0,,2151
3,76722083,76725455,del,NA20542,0,,3372
3,147967448,147968975,del,HG00640,0,,1527
3,99741506,99756744,del,HG01055,0,,15238
3,122239347,122239493,del,HG00106,0,,146
3,135661070,135665572,del,NA19436,0,,4502
3,73736390,73737100,del,HG00309,0,,710
3,188555427,188557874,del,HG00250,0,,2447
3,75769016,75785822,del,HG01492,0,,16806
3,70818024,70818306,del,NA18949,0,,282
3,191712653,191720458,del,HG01197,0,,7805
3,109414838,109416139,del,NA19474,0,,1301
3,169610192,169614107,del,NA06989,0,,3915
3,162155064,162155150,del,NA18948,0,,86
3,146966602,146970020,del,NA19448,0,,3418
3,108583616,108587822,del,NA19917,0,,4206
3,137072361,137073446,del,NA19900,0,,1085
3,156702507,156703650,del,HG00513,0,,1143
3,141403042,141404495,del,NA19835,0,,1453
3,183876815,183877403,del,NA18574,0,,588
3,85880653,85925443,del,NA19068,0,,44790
3,192304876,192312814,del,HG01187,0,,7938
3,5196625,5197793,del,NA20525,0,,1168
3,164523797,164551568,del,NA19904,0,,27771
3,195221700,195223046,del,NA19397,0,,1346
3,83017227,83020242,del,NA19311,0,,3015
3,5945602,5949092,del,NA18502,0,,3490
3,115247923,115249611,del,NA19248,0,,1688
3,194290283,194290528,del,HG01250,0,,245
3,89531431,89547075,del,NA18595,0,,15644
3,19808934,19823056,del,NA12282,0,,14122
3,163658868,163665172,del,HG00375,0,,6304
3,50342929,50347952,del,NA18873,0,,5023
3,114288590,114290962,del,HG00143,0,,2372
3,1987334,1988126,del,HG00578,0,,792
3,227516,234272,del,NA18953,0,,6756
3,148841179,148855916,del,NA20799,0,,14737
3,89740854,89747878,del,HG01390,0,,7024
3,160355877,160366189,del,NA19007,0,,10312
3,81704975,81705684,del,NA18561,0,,709
3,60479642,60480335,del,HG00690,0,,693
3,67971210,67972904,del,HG01133,0,,1694
3,131308135,131313405,del,NA18948,0,,5270
3,195569216,195569932,del,NA19747,0,,716
3,150380651,150382239,del,HG00232,0,,1588
3,61610632,61615843,del,NA12003,0,,5211
3,161635511,161635691,del,HG00404,0,,180
3,34949360,35271062,del,HG00607,0,,321702
3,26036806,26170484,del,HG01048,0,,133678
3,2305514,2312433,del,NA20765,0,,6919
3,30067461,30071115,del,NA19701,0,,3654
3,41407770,41512898,del,NA18947,0,,105128
3,15580861,15584501,del,NA18489,0,,3640
3,183266574,183266992,del,NA19347,0,,418
3,26450969,26452298,del,HG00418,0,,1329
3,160680271,160686008,del,NA07000,0,,5737
3,28227601,28228438,del,HG00702,0,,837
3,154648358,154648679,del,HG00236,0,,321
3,171560263,171564042,del,NA19651,0,,3779
3,99922679,99924935,del,NA19448,0,,2256
3,151511530,151551062,del,NA20783,0,,39532
3,158287519,158288331,del,HG00251,0,,812
3,53046608,53047833,del,NA19449,0,,1225
3,115354587,115356619,del,NA19398,0,,2032
3,125409054,125409340,del,HG01101,0,,286
3,31109437,31109758,del,NA18619,0,,321
3,103974703,103974892,del,HG00702,0,,189
3,196122940,196123166,del,HG01083,0,,226
3,65123004,65123504,del,HG00271,0,,500
3,7905946,7906150,del,HG00187,0,,204
3,122288993,122294184,del,NA20589,0,,5191
3,39579888,39596223,del,NA18910,0,,16335
3,105828852,105831619,del,HG00182,0,,2767
3,107703066,107705122,del,HG01462,0,,2056
3,44226819,44229027,del,NA18870,0,,2208
3,190787077,190787941,del,NA19430,0,,864
3,174964944,174965854,del,NA18544,0,,910
3,126763400,126765562,del,NA20790,0,,2162
3,152550597,152550920,del,NA19240,0,,323
3,182058164,182067985,del,NA18965,0,,9821
3,73939032,73939378,del,HG00357,0,,346
3,4191909,4201186,del,HG01390,0,,9277
3,75025766,75028472,del,NA18908,0,,2706
3,195825740,195826490,del,HG00149,0,,750
3,108583361,108587261,del,NA19315,0,,3900
3,34264090,34265527,del,NA18861,0,,1437
3,114984986,114987832,del,NA18989,0,,2846
3,28167456,28167782,del,NA20754,0,,326
3,116970,119376,del,NA19401,0,,2406
3,129774130,129780906,del,HG00443,0,,6776
3,112556550,112557091,del,NA19428,0,,541
3,9750341,9751071,del,HG00284,0,,730
3,60820126,60824497,del,HG01375,0,,4371
3,78371389,78371997,del,NA19350,0,,608
3,99165468,99166292,del,HG00635,0,,824
3,104226984,104230237,del,HG00513,0,,3253
3,53527816,53529622,del,NA19756,0,,1806
3,61794773,61796593,del,HG00100,0,,1820
3,192116329,192124255,del,NA18999,0,,7926
3,88457370,88465360,del,NA19372,0,,7990
3,33300939,33301247,del,HG00699,0,,308
3,6651416,6654322,del,NA12717,0,,2906
3,50171930,50173622,del,NA19012,0,,1692
3,133134066,133134540,del,NA18916,0,,474
3,125489616,125489522,del,NA18557,0,,-94
3,19133768,19138866,del,HG00578,0,,5098
3,194754912,194755536,del,NA18909,0,,624
3,138612630,138616629,del,HG00427,0,,3999
3,192875329,192885405,del,NA07056,0,,10076
3,37798424,37800178,del,NA19920,0,,1754
3,145068212,145073052,del,NA20753,0,,4840
3,195222777,195232497,del,HG00173,0,,9720
3,32946067,32954955,del,NA18553,0,,8888
3,152346866,152355914,del,NA11992,0,,9048
3,141155452,141156866,del,NA20582,0,,1414
3,107313297,107314749,del,HG01378,0,,1452
3,101699469,101704696,del,NA20768,0,,5227
3,22274231,22275478,del,NA19054,0,,1247
3,194393488,194403475,del,NA19395,0,,9987
3,3481045,3483340,del,HG00619,0,,2295
3,76246341,76246519,del,HG00263,0,,178
3,195494526,195494649,del,NA19213,0,,123
3,59699486,59700436,del,NA18909,0,,950
3,95146932,95149582,del,NA19818,0,,2650
3,22251962,22254567,del,NA18593,0,,2605
3,1913183,1925940,del,NA19359,0,,12757
3,165040941,165083362,del,NA20790,0,,42421
3,5670341,5671038,del,NA19373,0,,697
3,191789272,191789856,del,HG01067,0,,584
3,19172933,19173222,del,NA18498,0,,289
3,192122768,192123462,del,NA19438,0,,694
3,174157559,174161579,del,NA20503,0,,4020
3,179264614,179268003,del,NA18977,0,,3389
3,124659893,124664502,del,NA07051,0,,4609
3,176068636,176069451,del,NA20582,0,,815
3,57481038,57481723,del,NA19834,0,,685
3,1781984,1782293,del,HG00366,0,,309
3,178567652,178568343,del,NA12046,0,,691
3,197370065,197372395,del,HG01060,0,,2330
3,197366796,197367627,del,HG00266,0,,831
3,167113250,167116868,del,HG00260,0,,3618
3,150948587,150952711,del,NA20508,0,,4124
3,82020561,82023898,del,NA18613,0,,3337
3,5039447,5040799,del,NA12777,0,,1352
3,172244028,172244881,del,HG01188,0,,853
3,174416395,174416668,del,NA19678,0,,273
3,153097992,153099056,del,NA19082,0,,1064
3,141848531,141855895,del,HG00275,0,,7364
3,6074221,6101005,del,NA18486,0,,26784
3,75146608,75174475,del,HG00501,0,,27867
3,186182018,186183113,del,NA18489,0,,1095
3,153599208,153614000,del,NA18565,0,,14792
3,98899060,98902389,del,HG01168,0,,3329
3,164167866,164188441,del,NA19147,0,,20575
3,66054576,66055513,del,NA19701,0,,937
3,41156020,41161420,del,NA19390,0,,5400
3,93954970,93958476,del,NA19355,0,,3506
3,90462726,90476764,del,HG00619,0,,14038
3,26945653,26945968,del,NA11930,0,,315
3,196172760,196175881,del,NA19009,0,,3121
3,151700446,151702609,del,NA20810,0,,2163
3,41613988,41636420,del,NA18947,0,,22432
3,86213403,86213720,del,HG00592,0,,317
3,192358895,192359193,del,NA18596,0,,298
3,5275795,5275965,del,HG00590,0,,170
3,23620839,23621154,del,HG00635,0,,315
3,155135511,155140317,del,HG00613,0,,4806
3,113660717,113661012,del,NA18523,0,,295
3,88804336,88806865,del,NA19711,0,,2529
3,75301672,75304331,del,HG00557,0,,2659
3,18804150,18804297,del,NA18572,0,,147
3,55862002,55863115,del,HG00607,0,,1113
3,86390994,86396405,del,HG00536,0,,5411
3,149268471,149270146,del,HG00662,0,,1675
3,154494013,154496200,del,NA19429,0,,2187
3,20311331,20317741,del,HG01465,0,,6410
3,52999437,52999906,del,NA19072,0,,469
3,160502253,160502525,del,NA19108,0,,272
3,33296582,33296908,del,HG01390,0,,326
3,133295682,133297084,del,NA19900,0,,1402
3,28538957,28545953,del,NA19712,0,,6996
3,10218704,10222650,del,NA18611,0,,3946
3,11975532,11976169,del,NA19835,0,,637
3,84104942,84107384,del,NA20510,0,,2442
3,7046621,7049676,del,NA18610,0,,3055
3,27832097,27832431,del,HG00334,0,,334
3,104416308,104416445,del,NA12546,0,,137
3,190114180,190151452,del,NA19446,0,,37272
3,169268600,169268879,del,NA18596,0,,279
3,159518430,159518733,del,NA20808,0,,303
3,165362701,165363146,del,HG01378,0,,445
3,128314271,128315073,del,NA19114,0,,802
3,110134828,110135000,del,NA19431,0,,172
3,192597988,192609949,del,NA19440,0,,11961
3,187732824,187734762,del,HG00366,0,,1938
3,26503889,26507473,del,HG00404,0,,3584
3,147606663,147607240,del,NA19379,0,,577
3,81595569,81599665,del,NA07056,0,,4096
3,28735083,28744125,del,NA18571,0,,9042
3,166054794,166056161,del,NA19317,0,,1367
3,1626701,1627266,del,NA18557,0,,565
3,94842730,94842977,del,NA19917,0,,247
3,197186748,197187022,del,HG00186,0,,274
3,148729872,148730104,del,HG00123,0,,232
3,53027148,53038898,del,NA19908,0,,11750
3,124901722,124903064,del,NA19085,0,,1342
3,100324144,100329558,del,NA18552,0,,5414
3,62664398,62695672,del,NA19711,0,,31274
3,132273213,132280192,del,HG00324,0,,6979
3,108919316,108924922,del,HG00475,0,,5606
3,191889949,191891312,del,NA18982,0,,1363
3,125563076,125567717,del,NA18873,0,,4641
3,98140878,98151593,del,NA18565,0,,10715
3,120888856,120892166,del,NA19380,0,,3310
3,103078972,103097006,del,NA18567,0,,18034
3,194442040,194444327,del,NA19334,0,,2287
3,9454390,9459155,del,HG00346,0,,4765
3,180918063,180918791,del,NA12892,0,,728
3,178811426,178811626,del,NA18907,0,,200
3,116204834,116205178,del,HG00136,0,,344
3,146385188,146394861,del,HG01198,0,,9673
3,127269325,127273274,del,NA18487,0,,3949
3,95683292,95690423,del,HG00464,0,,7131
3,195494378,195494685,del,NA19383,0,,307
3,175079621,175084613,del,HG00525,0,,4992
3,70415105,70415440,del,NA19239,0,,335
3,196934466,196938022,del,NA18557,0,,3556
3,49234512,49238485,del,HG01107,0,,3973
3,161236390,161237207,del,HG01124,0,,817
3,39026381,39027869,del,NA19461,0,,1488
3,174161554,174161835,del,NA20520,0,,281
3,427481,923437,del,HG00708,0,,495956
3,29138836,29139231,del,NA20522,0,,395
3,8667492,8667859,del,NA19685,0,,367
3,139698439,139699950,del,HG00131,0,,1511
3,131988666,131996272,del,HG01350,0,,7606
3,21009517,21013503,del,NA20798,0,,3986
3,3908729,3923417,del,NA19712,0,,14688
3,152617192,152617381,del,HG00334,0,,189
3,37207087,37207625,del,HG00123,0,,538
3,194948454,194948596,del,HG01101,0,,142
3,16995337,17018898,del,HG01465,0,,23561
3,84087897,84091164,del,NA19445,0,,3267
3,77342743,77343584,del,HG01365,0,,841
3,128270058,128271130,del,HG01073,0,,1072
3,149231049,149231976,del,NA19904,0,,927
3,194715558,194720526,del,NA19818,0,,4968
3,44316330,44317534,del,NA19982,0,,1204
3,48648138,48649268,del,NA19080,0,,1130
3,45045101,45051109,del,NA19057,0,,6008
3,69405297,69411779,del,HG00119,0,,6482
3,5479650,5480884,del,NA19074,0,,1234
3,131708253,131713384,del,NA18563,0,,5131
3,135371928,135373410,del,NA18508,0,,1482
3,193192230,193196449,del,NA18868,0,,4219
3,184085723,184085826,del,NA18632,0,,103
3,165263856,165296604,del,NA19376,0,,32748
3,139870482,139873251,del,NA20796,0,,2769
3,37978417,37986927,del,HG00473,0,,8510
3,57065848,57066923,del,NA18617,0,,1075
3,115024235,115024576,del,NA18909,0,,341
3,74807809,74812955,del,NA19394,0,,5146
3,196811380,196811829,del,HG00589,0,,449
3,110863850,110865251,del,NA18950,0,,1401
3,160234059,160235656,del,NA19722,0,,1597
3,8720316,8723872,del,NA20804,0,,3556
3,128465570,128466808,del,NA19350,0,,1238
3,61416022,61416805,del,NA20809,0,,783
3,164075287,164087766,del,HG01108,0,,12479
3,104400189,104401629,del,NA18910,0,,1440
3,4141129,4184413,del,NA20542,0,,43284
3,144059244,144064243,del,NA18980,0,,4999
3,11503251,11508213,del,HG00464,0,,4962
3,8734262,8737655,del,NA18522,0,,3393
3,5326268,5327831,del,HG00707,0,,1563
3,109194070,109194409,del,NA19394,0,,339
3,76198690,76198821,del,HG01095,0,,131
3,87948583,88006095,del,HG01389,0,,57512
3,62711229,62715869,del,HG01378,0,,4640
3,117605302,117617430,del,NA19313,0,,12128
3,21803397,21812037,del,NA18538,0,,8640
3,130004654,130005659,del,NA18576,0,,1005
3,101491402,101492599,del,HG00418,0,,1197
3,136515151,136517711,del,NA19247,0,,2560
3,17025577,17031183,del,HG01168,0,,5606
3,32338938,32339830,del,HG00736,0,,892
3,197843926,197850166,del,NA19785,0,,6240
3,137314454,137316442,del,HG00448,0,,1988
3,60984727,61063471,del,NA18632,0,,78744
3,169377016,169380722,del,HG00328,0,,3706
3,195825763,195826516,del,HG01489,0,,753
3,18755817,18756126,del,NA18912,0,,309
3,151771003,151776036,del,NA19451,0,,5033
3,228771,234404,del,HG00138,0,,5633
3,179827896,179833341,del,HG00584,0,,5445
3,174778734,174784519,del,NA18987,0,,5785
3,195812125,195812668,del,NA18516,0,,543
3,141238419,141245692,del,HG00530,0,,7273
3,191667979,191668337,del,NA12286,0,,358
3,103073903,103087404,del,NA18999,0,,13501
3,179654339,179654804,del,NA12287,0,,465
3,47905929,47907574,del,HG00183,0,,1645
3,84866556,84871774,del,HG00331,0,,5218
3,165906834,165907864,del,NA18948,0,,1030
3,149665433,149668480,del,NA12045,0,,3047
3,159895447,159899869,del,NA19452,0,,4422
3,87446616,87446782,del,NA18870,0,,166
3,28639494,28644436,del,NA19189,0,,4942
3,47524236,47533064,del,NA19346,0,,8828
3,97846798,97921521,del,HG00271,0,,74723
3,90427182,90444924,del,NA20806,0,,17742
3,134842534,134844306,del,NA19338,0,,1772
3,97220187,97221623,del,NA18499,0,,1436
3,133322503,133324249,del,NA20504,0,,1746
3,80188806,80189303,del,HG00321,0,,497
3,20338602,20339709,del,NA19457,0,,1107
3,196203125,196205494,del,NA18988,0,,2369
3,145626262,145662495,del,NA19190,0,,36233
3,59951731,59954929,del,NA18624,0,,3198
3,182199668,182200030,del,NA12716,0,,362
3,67080031,67080345,del,NA19920,0,,314
3,24289398,24289999,del,NA18499,0,,601
3,63736355,63738343,del,NA18909,0,,1988
3,63134856,63135309,del,HG00437,0,,453
3,78342672,78343169,del,NA19704,0,,497
3,6897192,6900031,del,HG01191,0,,2839
3,10821757,10821920,del,HG00262,0,,163
3,122082124,122082721,del,NA19914,0,,597
3,76730609,76733915,del,HG01357,0,,3306
3,84106016,84107172,del,HG00329,0,,1156
3,131460362,131500650,del,HG01047,0,,40288
3,112763806,112766089,del,HG01149,0,,2283
3,72738522,72739601,del,NA19078,0,,1079
3,98111596,98123899,del,HG01048,0,,12303
3,22907579,22910849,del,NA19654,0,,3270
3,47490667,47493440,del,HG01191,0,,2773
3,169586912,169591141,del,NA20581,0,,4229
3,196759378,196759636,del,HG00315,0,,258
3,196061665,196062017,del,NA19225,0,,352
3,197551208,197551716,del,NA19385,0,,508
3,71242337,71242638,del,NA18856,0,,301
3,2426907,2427986,del,NA18988,0,,1079
3,110258828,110275796,del,NA18867,0,,16968
3,41416829,41418421,del,NA19107,0,,1592
3,101188369,101188692,del,HG01251,0,,323
3,13332567,13339368,del,HG00705,0,,6801
3,84700316,84702872,del,NA12283,0,,2556
3,12900603,12902697,del,NA18909,0,,2094
3,76941162,76941452,del,NA19311,0,,290
3,195669692,195729088,del,HG00419,0,,59396
3,190696628,190696937,del,HG00179,0,,309
3,50942074,50956060,del,NA19916,0,,13986
3,190290629,190290936,del,HG01188,0,,307
3,153558163,153565546,del,NA19625,0,,7383
3,131988253,131995104,del,NA19679,0,,6851
3,121959730,121963194,del,NA19835,0,,3464
3,11955948,12913512,del,NA18999,0,,957564
3,4240183,4282054,del,NA18988,0,,41871
3,11530521,11906082,del,NA12341,0,,375561
3,185843610,185844157,del,HG00325,0,,547
3,184303565,184305263,del,NA07051,0,,1698
3,35845272,35846033,del,NA18950,0,,761
3,11108284,11111883,del,NA19189,0,,3599
3,1770992,1780589,del,NA19390,0,,9597
3,170062604,170063770,del,NA19834,0,,1166
3,153217464,153218587,del,NA18618,0,,1123
3,106457039,106457232,del,NA12003,0,,193
3,74565352,74566004,del,NA19437,0,,652
3,32838572,32839065,del,NA18963,0,,493
3,125398990,125399888,del,HG01342,0,,898
3,7771715,7771848,del,HG00443,0,,133
3,173848317,173850555,del,HG01351,0,,2238
3,146646002,146658562,del,HG00137,0,,12560
3,27701901,27702656,del,NA18984,0,,755
3,106436889,106437085,del,HG01073,0,,196
3,29344082,29361346,del,HG01133,0,,17264
3,176242961,176246209,del,NA19247,0,,3248
3,189363420,189370899,del,NA19002,0,,7479
3,97874511,97931214,del,HG01052,0,,56703
3,125864191,125865654,del,HG01174,0,,1463
3,194413260,194440183,del,HG01488,0,,26923
3,25849819,25855339,del,NA18868,0,,5520
3,173208766,173215922,del,NA18596,0,,7156
3,3369273,3369435,del,HG00326,0,,162
3,158351135,158351399,del,HG00513,0,,264
3,151477634,151480040,del,NA18577,0,,2406
3,160972711,160973463,del,NA19129,0,,752
3,162448965,162449835,del,NA20534,0,,870
3,93802353,93805407,del,NA20771,0,,3054
3,110694255,110699081,del,NA19462,0,,4826
3,98394468,98395320,del,NA19437,0,,852
3,122709320,122710217,del,NA18577,0,,897
3,141070097,141075566,del,HG00734,0,,5469
3,103766851,103769443,del,NA19713,0,,2592
3,178669083,178669839,del,NA19445,0,,756
3,159180575,159183443,del,NA10847,0,,2868
3,36508165,36509386,del,NA19130,0,,1221
3,195199070,195222578,del,NA20792,0,,23508
3,965671,966524,del,HG01125,0,,853
3,42640011,42640668,del,NA18871,0,,657
3,78589731,78591555,del,NA19431,0,,1824
3,173240803,173241747,del,HG00252,0,,944
3,104832141,104833754,del,NA19469,0,,1613
3,161712543,161715345,del,NA18530,0,,2802
3,183673507,183673979,del,HG00336,0,,472
3,76063372,76063493,del,HG00327,0,,121
3,144100816,144118025,del,NA19436,0,,17209
3,68892502,68904049,del,HG00330,0,,11547
3,71656600,71663062,del,NA18616,0,,6462
3,97882183,97921521,del,NA19318,0,,39338
3,89509752,89515766,del,HG00448,0,,6014
3,36308129,36315164,del,NA18944,0,,7035
3,144548528,144553003,del,NA19473,0,,4475
3,26439494,26445536,del,NA19130,0,,6042
3,87656725,87665247,del,NA19471,0,,8522
3,160402352,160402533,del,HG00320,0,,181
3,177294509,177297473,del,NA20530,0,,2964
3,13141433,13142582,del,NA20814,0,,1149
3,14132678,14133652,del,NA18487,0,,974
3,55005972,55006400,del,NA19058,0,,428
3,109335398,109337939,del,NA19347,0,,2541
3,110678747,110679093,del,NA18861,0,,346
3,162126916,162143922,del,HG01359,0,,17006
3,191240490,191246750,del,NA19835,0,,6260
3,1044161,1046211,del,NA18909,0,,2050
3,195500240,195500560,del,HG00335,0,,320
3,128434771,128435741,del,HG00578,0,,970
3,51409229,51409952,del,HG00634,0,,723
3,95220400,95220532,del,HG01351,0,,132
3,104922904,104934417,del,NA19448,0,,11513
3,171041833,171043494,del,HG00117,0,,1661
3,77449921,77450802,del,HG00152,0,,881
3,191264189,191266138,del,HG01133,0,,1949
3,107702495,107704954,del,NA19652,0,,2459
3,39792950,39795251,del,NA19375,0,,2301
3,94301564,94304344,del,HG00160,0,,2780
3,125444094,125466689,del,NA20334,0,,22595
3,50443369,50444820,del,HG00565,0,,1451
3,56607727,56621584,del,HG01124,0,,13857
3,27837448,27843499,del,NA19383,0,,6051
3,196550503,196552281,del,NA19056,0,,1778
3,78332,361355,dup,HG01880,0,,283023
3,81877,119932,dup,HG02238,0,,38055
3,107539,193241,dup,HG01880,0,,85702
3,165096,190016,dup,HG01880,0,,24920
3,228934,234185,dup,HG00096,0,,5251
3,251770,305383,dup,HG02238,0,,53613
3,252271,303605,dup,HG02238,0,,51334
3,284497,421324,dup,HG02238,0,,136827
3,339022,415140,dup,HG02238,0,,76118
3,370434,582463,dup,HG02238,0,,212029
3,476085,584047,dup,HG00708,0,,107962
3,553686,579861,dup,HG02238,0,,26175
3,611944,624493,dup,HG00708,0,,12549
3,656296,712780,dup,HG00708,0,,56484
3,726885,841517,dup,HG00708,0,,114632
3,827848,1000113,dup,HG02238,0,,172265
3,896257,985012,dup,HG02238,0,,88755
3,952207,1087187,dup,HG00264,0,,134980
3,1006852,1088172,dup,HG00264,0,,81320
3,1079190,1273843,dup,HG00632,0,,194653
3,1086732,1143043,dup,HG00264,0,,56311
3,1153307,1261390,dup,HG00632,0,,108083
3,1268663,1320838,dup,HG00264,0,,52175
3,1318557,1474188,dup,NA20289,0,,155631
3,1416184,1480708,dup,HG00264,0,,64524
3,1473521,1647193,dup,HG00264,0,,173672
3,1486945,1668935,dup,HG00264,0,,181990
3,1666973,1685640,dup,HG03652,0,,18667
3,1668105,1752619,dup,HG02221,0,,84514
3,1770891,1780563,dup,HG02107,0,,9672
3,1782925,1799067,dup,HG01464,0,,16142
3,1805143,1892032,dup,NA18745,0,,86889
3,1885786,1917512,dup,NA12058,0,,31726
3,1913299,1926283,dup,HG02009,0,,12984
3,1928584,1935348,dup,NA12058,0,,6764
3,1936599,1946496,dup,HG01990,0,,9897
3,1948065,1960303,dup,NA12058,0,,12238
3,1964829,1977602,dup,HG00559,0,,12773
3,1980716,1999716,dup,HG03009,0,,19000
3,1999717,2008797,dup,HG03009,0,,9080
3,2019702,2138924,dup,NA12058,0,,119222
3,2055044,2096108,dup,NA12058,0,,41064
3,2164378,2224070,dup,NA12058,0,,59692
3,2212534,2266600,dup,HG04059,0,,54066
3,2237939,2645267,dup,NA12058,0,,407328
3,2275275,2581888,dup,NA12058,0,,306613
3,2352226,2406475,dup,NA12058,0,,54249
3,2504407,2528226,dup,HG04211,0,,23819
3,2576082,2645279,dup,NA12058,0,,69197
3,3052939,3068471,dup,HG01072,0,,15532
3,3285064,3301525,dup,NA19025,0,,16461
3,3660199,3675613,dup,HG01920,0,,15414
3,3948984,4121952,dup,NA07037,0,,172968
3,4087319,4124605,dup,HG01305,0,,37286
3,4126030,4259632,dup,HG00728,0,,133602
3,4601944,4619592,dup,NA20804,0,,17648
3,5441266,5492135,dup,HG01092,0,,50869
3,5577129,5708227,dup,NA19334,0,,131098
3,5896350,5916048,dup,HG03989,0,,19698
3,6317452,6337199,dup,HG00117,0,,19747
3,6777662,6801698,dup,HG03894,0,,24036
3,7352553,7368201,dup,HG02690,0,,15648
3,7549428,7670730,dup,HG01798,0,,121302
3,7550753,7794490,dup,HG01798,0,,243737
3,7672407,7802108,dup,HG01798,0,,129701
3,7800716,7823266,dup,NA19080,0,,22550
3,8652765,8729690,dup,HG01149,0,,76925
3,8671229,8757634,dup,NA19213,0,,86405
3,8821630,8861459,dup,HG00102,0,,39829
3,8822076,8863849,dup,HG00102,0,,41773
3,9854658,9863149,dup,NA18618,0,,8491
3,9908557,9921173,dup,NA18618,0,,12616
3,10203347,10213141,dup,HG01956,0,,9794
3,11686177,11707032,dup,HG01254,0,,20855
3,11686404,11702449,dup,HG01254,0,,16045
3,12403489,12479580,dup,NA12046,0,,76091
3,12404604,12452277,dup,NA12046,0,,47673
3,12629235,12809177,dup,HG01205,0,,179942
3,12629405,12650851,dup,HG01069,0,,21446
3,12630534,12808480,dup,HG01069,0,,177946
3,12740134,12803122,dup,HG01069,0,,62988
3,13040558,13049186,dup,HG01779,0,,8628
3,13221491,13247850,dup,HG00632,0,,26359
3,13618608,13719059,dup,HG03490,0,,100451
3,13619129,13721051,dup,HG03490,0,,101922
3,13622566,13668921,dup,HG03490,0,,46355
3,13742795,13755294,dup,HG00185,0,,12499
3,14589716,14611338,dup,HG00595,0,,21622
3,14589839,14611332,dup,HG01342,0,,21493
3,14954267,15036060,dup,NA12760,0,,81793
3,19316595,19319648,dup,HG03432,0,,3053
3,19604967,19703115,dup,NA19070,0,,98148
3,20389893,20472618,dup,HG03790,0,,82725
3,20392676,20556156,dup,HG03790,0,,163480
3,20921809,20927430,dup,HG00881,0,,5621
3,21251394,21351796,dup,HG01311,0,,100402
3,21252988,21339227,dup,HG01311,0,,86239
3,21333182,21345967,dup,HG01311,0,,12785
3,21570471,21581941,dup,HG02604,0,,11470
3,21828353,21865814,dup,NA20809,0,,37461
3,21885391,21910508,dup,HG03744,0,,25117
3,22060791,22107653,dup,NA18538,0,,46862
3,22196354,22208755,dup,NA21099,0,,12401
3,22635923,22724703,dup,HG02334,0,,88780
3,24678564,24690903,dup,NA18565,0,,12339
3,24745567,24826314,dup,NA18620,0,,80747
3,25885281,25892560,dup,HG02589,0,,7279
3,25976924,26050546,dup,NA21114,0,,73622
3,26043277,26058241,dup,HG01048,0,,14964
3,26043277,26091766,dup,HG01048,0,,48489
3,26043277,26156955,dup,HG01048,0,,113678
3,26067870,26117091,dup,HG01048,0,,49221
3,26432727,26439290,dup,HG00096,0,,6563
3,27025181,27214596,dup,HG03369,0,,189415
3,27025369,27285480,dup,HG03369,0,,260111
3,27217588,27421081,dup,HG03369,0,,203493
3,27293402,27319866,dup,HG01885,0,,26464
3,27323198,27400689,dup,HG03369,0,,77491
3,28538879,28545650,dup,HG01064,0,,6771
3,29354357,29358191,dup,HG00160,0,,3834
3,30267064,30288065,dup,HG00956,0,,21001
3,30268503,30347140,dup,HG00581,0,,78637
3,32838698,32849249,dup,HG03559,0,,10551
3,34153232,34160065,dup,HG02485,0,,6833
3,34454287,34469556,dup,HG01486,0,,15269
3,34461249,34618198,dup,HG01344,0,,156949
3,34463767,34577000,dup,HG01486,0,,113233
3,34481113,34631234,dup,HG01486,0,,150121
3,34616997,34761577,dup,HG02262,0,,144580
3,35098249,35109034,dup,HG02651,0,,10785
3,35804418,35941820,dup,HG01259,0,,137402
3,36000083,36008929,dup,NA18541,0,,8846
3,36253131,36345286,dup,NA18549,0,,92155
3,36255608,36312574,dup,NA18549,0,,56966
3,36371382,36448953,dup,HG04155,0,,77571
3,36371608,36394338,dup,HG04155,0,,22730
3,36396350,36417612,dup,HG01257,0,,21262
3,36417051,36446000,dup,HG04155,0,,28949
3,36588476,36600252,dup,HG03774,0,,11776
3,36719354,36751998,dup,HG03461,0,,32644
3,36725454,36744576,dup,HG03461,0,,19122
3,37125178,37173050,dup,HG01305,0,,47872
3,37150060,37173008,dup,HG01305,0,,22948
3,37189491,37201313,dup,HG01305,0,,11822
3,37358053,37497355,dup,HG02595,0,,139302
3,37358299,37570384,dup,HG02595,0,,212085
3,37360780,37919496,dup,HG02595,0,,558716
3,37709974,37918448,dup,HG02595,0,,208474
3,38880877,38894108,dup,NA19649,0,,13231
3,38949431,38972338,dup,HG02081,0,,22907
3,39574313,39600983,dup,HG02923,0,,26670
3,39914443,39926490,dup,HG03928,0,,12047
3,40002610,40019589,dup,HG02406,0,,16979
3,40383634,40486177,dup,HG02784,0,,102543
3,41564041,41672352,dup,NA18627,0,,108311
3,41614960,41638911,dup,HG00598,0,,23951
3,41914946,42171186,dup,NA19327,0,,256240
3,43344502,43399399,dup,HG03697,0,,54897
3,43487600,43493199,dup,HG03874,0,,5599
3,43705457,43718544,dup,NA19025,0,,13087
3,44701692,44746656,dup,HG03490,0,,44964
3,44703065,44730153,dup,HG03490,0,,27088
3,44952501,44957758,dup,HG04202,0,,5257
3,46667900,46756660,dup,HG03696,0,,88760
3,46803577,46851159,dup,HG00102,0,,47582
3,47233536,47256865,dup,HG00132,0,,23329
3,47527049,47571299,dup,HG01612,0,,44250
3,47558197,47565162,dup,HG01612,0,,6965
3,48016358,48029335,dup,HG03313,0,,12977
3,49920426,49925031,dup,NA20527,0,,4605
3,52562307,52574660,dup,HG02144,0,,12353
3,52866574,52884844,dup,HG02595,0,,18270
3,53218269,53248323,dup,HG03796,0,,30054
3,54004919,54034874,dup,HG01198,0,,29955
3,54551852,54569865,dup,HG00458,0,,18013
3,56381091,56402665,dup,HG02309,0,,21574
3,56743592,56755925,dup,HG03788,0,,12333
3,57206493,57221352,dup,HG01845,0,,14859
3,58607406,58663548,dup,HG03696,0,,56142
3,59263938,59306232,dup,HG03294,0,,42294
3,59372458,59376910,dup,HG01600,0,,4452
3,59606514,59615187,dup,HG01798,0,,8673
3,59873181,60020722,dup,HG03667,0,,147541
3,60020723,60146677,dup,HG03667,0,,125954
3,60318908,60356216,dup,HG02613,0,,37308
3,60375385,60400595,dup,HG01920,0,,25210
3,60535765,60556202,dup,NA19197,0,,20437
3,60564779,60590429,dup,NA19197,0,,25650
3,60608490,60664397,dup,NA19197,0,,55907
3,60826517,60918647,dup,NA11992,0,,92130
3,61062905,61094240,dup,HG01256,0,,31335
3,61072945,61114230,dup,HG00595,0,,41285
3,61136304,61187579,dup,HG02756,0,,51275
3,61368832,61418619,dup,HG03673,0,,49787
3,61383984,61419389,dup,HG03673,0,,35405
3,61570402,61634113,dup,NA19079,0,,63711
3,61577690,61631062,dup,NA18969,0,,53372
3,61580641,61627548,dup,NA18957,0,,46907
3,61789241,61891972,dup,HG02127,0,,102731
3,61790396,61828071,dup,HG02127,0,,37675
3,61798176,61892665,dup,HG02277,0,,94489
3,61819406,61856293,dup,HG02277,0,,36887
3,61881082,61941204,dup,HG02019,0,,60122
3,61941907,61965702,dup,HG02811,0,,23795
3,62941958,63077128,dup,HG03096,0,,135170
3,62959750,62999530,dup,HG00180,0,,39780
3,62988224,63196657,dup,HG03096,0,,208433
3,63532617,63568092,dup,NA19773,0,,35475
3,64361507,64373876,dup,HG03774,0,,12369
3,64592460,64635589,dup,HG04141,0,,43129
3,64595652,64609395,dup,HG04141,0,,13743
3,65044571,65063822,dup,HG03774,0,,19251
3,65479202,65513282,dup,HG03685,0,,34080
3,65770370,65774202,dup,HG01795,0,,3832
3,65819361,65842746,dup,HG01459,0,,23385
3,65909933,65935933,dup,HG01254,0,,26000
3,66132867,66295025,dup,NA19027,0,,162158
3,66134850,66160123,dup,HG01521,0,,25273
3,67084958,67141792,dup,HG00524,0,,56834
3,67093853,67134258,dup,NA20822,0,,40405
3,67195852,67336734,dup,HG01069,0,,140882
3,67207129,67257882,dup,HG04017,0,,50753
3,67499945,67515264,dup,HG02464,0,,15319
3,67518532,67533436,dup,HG02464,0,,14904
3,67547757,67573553,dup,HG02464,0,,25796
3,67580039,67642246,dup,HG02464,0,,62207
3,67811367,67828732,dup,HG00524,0,,17365
3,68379127,68384244,dup,HG00536,0,,5117
3,68614526,68635111,dup,HG01704,0,,20585
3,69153117,69168909,dup,HG01111,0,,15792
3,70194826,70199500,dup,HG03886,0,,4674
3,72760868,72767619,dup,NA19020,0,,6751
3,72780075,72785604,dup,HG00138,0,,5529
3,74136397,74195836,dup,HG03693,0,,59439
3,74962277,74971252,dup,HG02922,0,,8975
3,75147574,75179603,dup,HG01847,0,,32029
3,75423550,75458952,dup,HG00096,0,,35402
3,75495797,75527865,dup,HG00096,0,,32068
3,75532164,75569195,dup,HG00096,0,,37031
3,75597940,75615947,dup,HG00096,0,,18007
3,75992843,76004583,dup,NA18966,0,,11740
3,76029536,76161033,dup,NA19038,0,,131497
3,76034064,76050649,dup,NA19038,0,,16585
3,76067847,76242056,dup,NA19038,0,,174209
3,76078310,76096546,dup,HG01885,0,,18236
3,76187088,76578831,dup,NA19038,0,,391743
3,76384336,76395400,dup,HG00368,0,,11064
3,76599006,76722926,dup,NA19038,0,,123920
3,76727866,76808198,dup,HG03240,0,,80332
3,76805305,76816554,dup,NA19038,0,,11249
3,77177603,77181436,dup,HG00533,0,,3833
3,77842783,77849724,dup,HG00409,0,,6941
3,78157817,78176668,dup,NA20885,0,,18851
3,78321363,78466946,dup,HG01893,0,,145583
3,78460236,78475124,dup,HG01893,0,,14888
3,78588063,78591389,dup,HG01054,0,,3326
3,79744451,79802674,dup,HG00277,0,,58223
3,79805810,79817854,dup,HG00277,0,,12044
3,80228167,80237096,dup,HG03446,0,,8929
3,80400588,80489144,dup,HG01161,0,,88556
3,80401427,80539664,dup,HG01161,0,,138237
3,80493928,80562034,dup,HG01161,0,,68106
3,80580653,80651400,dup,HG00245,0,,70747
3,80647219,80670154,dup,HG03830,0,,22935
3,80651792,80673448,dup,HG03830,0,,21656
3,80694073,80816867,dup,HG00245,0,,122794
3,80720026,80898209,dup,HG01161,0,,178183
3,80924064,81056581,dup,HG01161,0,,132517
3,81156239,81221039,dup,HG01845,0,,64800
3,81160624,81225498,dup,HG00245,0,,64874
3,81229513,81254343,dup,HG00245,0,,24830
3,81908897,81923843,dup,NA18944,0,,14946
3,82044283,82058970,dup,HG01596,0,,14687
3,83734212,83795831,dup,HG03446,0,,61619
3,84112306,84121852,dup,NA11881,0,,9546
3,84699412,84702921,dup,HG00106,0,,3509
3,85199644,85293570,dup,NA20869,0,,93926
3,85350840,85363484,dup,NA20346,0,,12644
3,85387473,85406373,dup,HG02095,0,,18900
3,85389748,85479958,dup,HG02095,0,,90210
3,85883229,85926163,dup,HG00592,0,,42934
3,86699657,86798376,dup,NA20287,0,,98719
3,86700932,86767466,dup,NA20287,0,,66534
3,86880836,86886016,dup,NA20888,0,,5180
3,87251627,87276074,dup,HG00641,0,,24447
3,87253247,87277306,dup,HG00641,0,,24059
3,87852610,87948537,dup,HG03624,0,,95927
3,87860442,87889624,dup,HG03624,0,,29182
3,87954655,88008731,dup,HG01432,0,,54076
3,88155373,88246243,dup,HG02236,0,,90870
3,88157088,88198509,dup,HG02236,0,,41421
3,88205018,88217359,dup,HG02236,0,,12341
3,88227636,88245302,dup,HG02236,0,,17666
3,88643553,88689896,dup,HG01048,0,,46343
3,89026196,89029976,dup,HG02549,0,,3780
3,89187749,89299417,dup,HG02882,0,,111668
3,89192932,89386791,dup,HG02882,0,,193859
3,89303941,89359415,dup,HG02882,0,,55474
3,89367725,89461234,dup,HG02882,0,,93509
3,89384520,89391292,dup,HG02882,0,,6772
3,89394090,89418661,dup,HG00140,0,,24571
3,89451337,89521761,dup,HG02882,0,,70424
3,89505620,89602539,dup,HG02882,0,,96919
3,89531426,89547172,dup,HG00176,0,,15746
3,89539815,89797083,dup,HG02882,0,,257268
3,89641955,89772785,dup,HG02882,0,,130830
3,89775659,89831836,dup,HG02882,0,,56177
3,89813212,89828234,dup,HG01801,0,,15022
3,89850276,90177384,dup,HG02882,0,,327108
3,89855177,89940853,dup,HG02882,0,,85676
3,89944873,90089377,dup,HG02882,0,,144504
3,90181672,90194452,dup,HG02882,0,,12780
3,90196766,90277866,dup,HG02882,0,,81100
3,90281704,90362994,dup,HG02882,0,,81290
3,93536053,93539625,dup,HG01507,0,,3572
3,94066401,94070204,dup,HG00131,0,,3803
3,94294061,94298329,dup,HG01392,0,,4268
3,94366496,94383194,dup,HG01312,0,,16698
3,94509893,94515275,dup,HG00110,0,,5382
3,94998359,95045355,dup,HG02151,0,,46996
3,96336389,96346895,dup,HG03397,0,,10506
3,96648671,96658893,dup,HG04209,0,,10222
3,97030158,97045648,dup,HG01188,0,,15490
3,97952903,97970802,dup,HG03718,0,,17899
3,98141363,98149124,dup,NA18565,0,,7761
3,98770344,98813828,dup,HG02790,0,,43484
3,98770881,98899020,dup,HG03680,0,,128139
3,98794793,98943333,dup,HG01389,0,,148540
3,98949547,99006841,dup,HG01389,0,,57294
3,98975498,99117263,dup,HG01432,0,,141765
3,99194230,99216383,dup,HG00419,0,,22153
3,99215074,99292308,dup,HG01389,0,,77234
3,99235499,99409702,dup,HG01432,0,,174203
3,99779807,99817754,dup,HG03940,0,,37947
3,100322934,100437339,dup,HG00258,0,,114405
3,100334511,100449048,dup,HG00258,0,,114537
3,100334871,100446150,dup,HG00258,0,,111279
3,101681344,101779560,dup,HG00406,0,,98216
3,101971187,102028030,dup,HG03082,0,,56843
3,102945190,102953097,dup,HG01438,0,,7907
3,102992794,102999069,dup,HG01312,0,,6275
3,103841656,103928744,dup,HG04006,0,,87088
3,103934669,104062725,dup,HG04006,0,,128056
3,104103807,104256605,dup,NA18966,0,,152798
3,104260806,104450133,dup,NA18966,0,,189327
3,104452024,104475450,dup,NA18966,0,,23426
3,104491436,104594985,dup,NA18966,0,,103549
3,104629858,104697473,dup,NA18966,0,,67615
3,104729824,104790016,dup,NA18966,0,,60192
3,105898859,105907963,dup,HG03016,0,,9104
3,106295363,106310628,dup,HG00251,0,,15265
3,106349736,106355828,dup,HG02891,0,,6092
3,106669099,106694159,dup,HG02784,0,,25060
3,108478641,108652152,dup,HG03388,0,,173511
3,108481510,108582424,dup,HG03388,0,,100914
3,108588122,108605178,dup,HG02180,0,,17056
3,108610507,108650228,dup,HG03388,0,,39721
3,108879060,108934605,dup,HG03388,0,,55545
3,109143697,109166876,dup,HG02895,0,,23179
3,110117463,110137984,dup,HG02364,0,,20521
3,110305906,110360990,dup,HG04202,0,,55084
3,110792496,110796273,dup,HG01104,0,,3777
3,111778514,111820941,dup,HG02058,0,,42427
3,111778785,111820815,dup,HG02058,0,,42030
3,111778994,111821267,dup,HG02131,0,,42273
3,112089182,112223877,dup,NA19785,0,,134695
3,112219426,112239916,dup,HG02013,0,,20490
3,112526359,112623801,dup,HG04202,0,,97442
3,112537548,112581905,dup,HG04202,0,,44357
3,112599949,112619429,dup,HG04202,0,,19480
3,112857449,112868617,dup,HG01102,0,,11168
3,112876677,112893544,dup,HG00121,0,,16867
3,113975056,114016567,dup,HG03600,0,,41511
3,113976944,114015516,dup,HG00628,0,,38572
3,115838877,116085721,dup,HG01953,0,,246844
3,115888198,115902631,dup,HG01953,0,,14433
3,116703798,116802860,dup,NA21097,0,,99062
3,116707167,116828318,dup,NA19439,0,,121151
3,116832789,116845641,dup,HG03132,0,,12852
3,116833527,116845634,dup,HG00256,0,,12107
3,116866775,116957178,dup,NA21097,0,,90403
3,117020733,117157964,dup,NA21097,0,,137231
3,117166590,117625159,dup,HG01308,0,,458569
3,117628173,117652362,dup,NA21097,0,,24189
3,117633755,117710341,dup,NA21097,0,,76586
3,117687907,117773733,dup,NA21097,0,,85826
3,117717064,117799433,dup,NA21097,0,,82369
3,118714124,118774374,dup,HG01515,0,,60250
3,118718361,118863770,dup,HG01607,0,,145409
3,118776929,118819240,dup,HG03027,0,,42311
3,118811889,118833060,dup,HG01515,0,,21171
3,118863771,119010293,dup,NA12489,0,,146522
3,119224630,119227849,dup,HG02660,0,,3219
3,120288735,120300552,dup,NA19452,0,,11817
3,120636989,120640823,dup,HG02317,0,,3834
3,120686253,120694346,dup,HG04018,0,,8093
3,120705527,121356606,dup,HG02079,0,,651079
3,121214301,121362411,dup,HG02079,0,,148110
3,122112524,122126342,dup,NA21109,0,,13818
3,122650485,122659564,dup,HG03871,0,,9079
3,123261620,123269542,dup,HG00308,0,,7922
3,123468444,123529656,dup,NA20585,0,,61212
3,123469084,123600102,dup,NA20585,0,,131018
3,123532070,123671181,dup,NA20585,0,,139111
3,123676213,123735520,dup,HG01970,0,,59307
3,125438089,125461101,dup,HG00180,0,,23012
3,128380015,128393555,dup,HG00102,0,,13540
3,128389934,128403385,dup,HG00102,0,,13451
3,128402126,128412435,dup,HG01767,0,,10309
3,128705058,128806357,dup,HG04211,0,,101299
3,128708849,128742183,dup,HG04211,0,,33334
3,128772631,128791989,dup,HG04211,0,,19358
3,129492296,129505058,dup,HG02260,0,,12762
3,130176203,130253538,dup,HG03986,0,,77335
3,130584646,130593857,dup,HG02780,0,,9211
3,130991200,131191202,dup,HG03172,0,,200002
3,130995751,131075295,dup,HG03172,0,,79544
3,131069714,131133893,dup,HG03172,0,,64179
3,131080338,131101806,dup,HG02968,0,,21468
3,131130964,131167387,dup,HG03172,0,,36423
3,131314751,131355093,dup,NA18632,0,,40342
3,131315540,131354718,dup,NA18632,0,,39178
3,131384759,131389057,dup,HG01537,0,,4298
3,131460345,131501452,dup,HG01047,0,,41107
3,131945469,131989390,dup,NA19019,0,,43921
3,131950161,132007899,dup,NA19019,0,,57738
3,131989128,131994876,dup,HG00096,0,,5748
3,132447608,132452507,dup,HG03112,0,,4899
3,133199594,133214519,dup,HG01286,0,,14925
3,133628971,133640725,dup,HG03977,0,,11754
3,133833957,133844334,dup,NA18541,0,,10377
3,134704984,134798389,dup,NA18520,0,,93405
3,134722645,134747967,dup,HG02737,0,,25322
3,134725226,134749354,dup,HG02737,0,,24128
3,134760149,134793714,dup,NA18520,0,,33565
3,134807736,134854298,dup,NA18520,0,,46562
3,134858617,135090769,dup,NA18520,0,,232152
3,134970696,134996707,dup,HG01342,0,,26011
3,135098536,135171795,dup,HG00553,0,,73259
3,135559405,135718304,dup,NA18520,0,,158899
3,135942810,135958645,dup,HG03515,0,,15835
3,136699452,136766522,dup,HG03890,0,,67070
3,136700329,136828652,dup,HG03890,0,,128323
3,137023555,137181456,dup,HG03890,0,,157901
3,137583452,137597634,dup,HG01807,0,,14182
3,137849632,137938911,dup,NA19923,0,,89279
3,137852232,137866420,dup,NA19923,0,,14188
3,137879945,137932411,dup,NA19923,0,,52466
3,138197280,138357426,dup,HG01766,0,,160146
3,138508793,138513502,dup,HG00179,0,,4709
3,138606780,138620917,dup,NA19916,0,,14137
3,138924899,138956746,dup,HG03945,0,,31847
3,138926776,138945695,dup,HG03882,0,,18919
3,139709365,139723242,dup,NA20291,0,,13877
3,139929955,139987025,dup,HG03120,0,,57070
3,139930166,140550192,dup,HG00266,0,,620026
3,139974316,140092431,dup,HG03120,0,,118115
3,140014229,140189522,dup,HG03120,0,,175293
3,140159910,140275142,dup,HG03120,0,,115232
3,140406713,140550063,dup,HG03120,0,,143350
3,140491294,140544332,dup,HG03120,0,,53038
3,141030655,141049957,dup,NA20812,0,,19302
3,141415850,141419749,dup,HG00608,0,,3899
3,141818266,141891569,dup,NA12144,0,,73303
3,141818647,142030660,dup,NA12144,0,,212013
3,141895976,142090046,dup,NA12144,0,,194070
3,142765016,142809951,dup,NA20543,0,,44935
3,142766024,142777038,dup,NA20543,0,,11014
3,142795329,142801564,dup,NA20543,0,,6235
3,143319000,143334999,dup,HG03458,0,,15999
3,144082072,144091723,dup,HG01188,0,,9651
3,144100800,144122679,dup,NA19030,0,,21879
3,144810610,144895574,dup,HG02317,0,,84964
3,145222066,145268797,dup,HG01432,0,,46731
3,147484677,147606493,dup,HG00151,0,,121816
3,147846469,147851714,dup,HG00476,0,,5245
3,150143029,150147017,dup,HG01303,0,,3988
3,151311566,151371388,dup,HG02763,0,,59822
3,151311578,151412954,dup,HG02763,0,,101376
3,151395580,151419127,dup,HG02141,0,,23547
3,152404742,152491868,dup,NA18579,0,,87126
3,152461974,152494136,dup,HG03888,0,,32162
3,152487232,152508331,dup,HG03163,0,,21099
3,152997312,153011414,dup,NA19314,0,,14102
3,153021922,153056364,dup,NA19314,0,,34442
3,153228171,153239096,dup,HG01860,0,,10925
3,153580797,153614543,dup,HG00674,0,,33746
3,153894566,153914188,dup,HG04056,0,,19622
3,154242503,154394772,dup,HG01956,0,,152269
3,154434529,154448149,dup,HG01956,0,,13620
3,154493159,154510329,dup,NA21088,0,,17170
3,154532249,154691099,dup,HG00406,0,,158850
3,154691694,154914007,dup,NA19661,0,,222313
3,154914008,155032914,dup,NA21088,0,,118906
3,155037216,155052753,dup,NA21088,0,,15537
3,155056950,155103036,dup,NA21088,0,,46086
3,155109570,155182378,dup,NA21088,0,,72808
3,155200756,155409638,dup,NA21088,0,,208882
3,155410053,155455652,dup,HG01551,0,,45599
3,155476856,155587204,dup,HG01551,0,,110348
3,155478166,155498646,dup,NA21088,0,,20480
3,155615367,155699633,dup,NA21088,0,,84266
3,155709094,155771663,dup,NA21088,0,,62569
3,157371534,157375134,dup,HG02715,0,,3600
3,157603529,157624061,dup,HG02513,0,,20532
3,158028832,158049260,dup,NA18642,0,,20428
3,158225113,158238187,dup,HG01816,0,,13074
3,158549548,158785269,dup,HG03919,0,,235721
3,158735800,158772380,dup,HG02298,0,,36580
3,158790256,158866958,dup,HG03919,0,,76702
3,158865258,158886627,dup,HG03919,0,,21369
3,158870152,158948387,dup,HG03919,0,,78235
3,159895430,159899770,dup,HG02471,0,,4340
3,160484874,160575688,dup,HG03808,0,,90814
3,161012324,161051729,dup,HG00560,0,,39405
3,161085104,161252371,dup,HG04222,0,,167267
3,161093837,161143377,dup,HG04222,0,,49540
3,161408161,161550814,dup,HG01491,0,,142653
3,161814423,161846308,dup,HG03836,0,,31885
3,161874468,161951534,dup,HG00140,0,,77066
3,161881337,161958081,dup,HG01305,0,,76744
3,162514471,162625647,dup,HG00096,0,,111176
3,163057352,163210659,dup,HG02666,0,,153307
3,163158528,163410210,dup,HG03867,0,,251682
3,163658745,163665145,dup,HG00318,0,,6400
3,163674430,163698659,dup,NA18961,0,,24229
3,163727426,163732388,dup,HG01512,0,,4962
3,164268290,164292481,dup,HG01846,0,,24191
3,165002138,165006455,dup,HG02715,0,,4317
3,165448429,165530078,dup,HG00258,0,,81649
3,165538538,165662715,dup,HG00157,0,,124177
3,165568241,165603028,dup,HG00157,0,,34787
3,165570026,165634863,dup,HG00157,0,,64837
3,165607625,165702406,dup,HG00157,0,,94781
3,166520597,166537403,dup,HG00290,0,,16806
3,169423245,169433954,dup,HG02151,0,,10709
3,169460711,169475355,dup,HG02649,0,,14644
3,169581297,169636431,dup,HG03061,0,,55134
3,169597873,169612137,dup,HG03745,0,,14264
3,169621158,169634692,dup,HG03745,0,,13534
3,169920978,169930585,dup,HG01632,0,,9607
3,169948221,169958626,dup,NA12234,0,,10405
3,169956927,169984556,dup,NA18986,0,,27629
3,170369092,170381504,dup,NA21113,0,,12412
3,170391275,170536703,dup,HG03061,0,,145428
3,171801298,171805325,dup,HG00559,0,,4027
3,172329802,172399463,dup,HG03061,0,,69661
3,173225428,173319118,dup,HG01513,0,,93690
3,173231085,173290491,dup,HG00109,0,,59406
3,173292974,173316358,dup,HG04214,0,,23384
3,173472757,173506153,dup,NA21086,0,,33396
3,173475280,173504013,dup,NA19075,0,,28733
3,173570294,173578648,dup,HG02891,0,,8354
3,173788385,173792284,dup,NA20517,0,,3899
3,175211967,175225346,dup,NA20797,0,,13379
3,175894038,175953798,dup,HG01134,0,,59760
3,175911559,175945687,dup,HG02013,0,,34128
3,176521107,176593083,dup,NA19740,0,,71976
3,176529947,176710561,dup,NA19740,0,,180614
3,176694289,176706733,dup,HG02558,0,,12444
3,176702268,176793600,dup,NA19740,0,,91332
3,176730303,176876813,dup,NA19740,0,,146510
3,176975754,176979023,dup,NA19430,0,,3269
3,177013981,177592769,dup,HG03061,0,,578788
3,177113997,177117925,dup,HG03352,0,,3928
3,177924789,177932679,dup,NA18536,0,,7890
3,179765681,179813685,dup,HG00584,0,,48004
3,180502409,180655013,dup,HG04194,0,,152604
3,180503533,180547497,dup,HG04194,0,,43964
3,180645103,180652362,dup,HG02090,0,,7259
3,180719442,180727719,dup,HG02323,0,,8277
3,180745438,180762854,dup,HG01497,0,,17416
3,181353302,181367837,dup,HG01816,0,,14535
3,182851884,182923962,dup,NA19390,0,,72078
3,182852468,182923423,dup,HG03061,0,,70955
3,182856780,182922738,dup,NA19390,0,,65958
3,183186625,183410607,dup,HG03061,0,,223982
3,183336533,183350593,dup,HG01790,0,,14060
3,183598488,183607740,dup,HG01596,0,,9252
3,183634883,183708982,dup,HG00186,0,,74099
3,183641874,183665674,dup,NA18757,0,,23800
3,183691715,183709485,dup,NA18757,0,,17770
3,183833161,183839967,dup,NA19319,0,,6806
3,184004716,184024622,dup,HG00255,0,,19906
3,184004830,184022442,dup,HG00255,0,,17612
3,184168765,184615355,dup,HG03061,0,,446590
3,184557888,184599238,dup,NA20770,0,,41350
3,184642432,184823812,dup,NA20770,0,,181380
3,184878007,184897970,dup,NA18610,0,,19963
3,184903260,184915618,dup,HG02032,0,,12358
3,184991473,185071943,dup,HG00560,0,,80470
3,185496175,185501781,dup,HG03410,0,,5606
3,185628724,185709200,dup,HG03061,0,,80476
3,185896571,185973730,dup,HG03061,0,,77159
3,186386247,186435240,dup,HG01305,0,,48993
3,186567837,186577729,dup,HG00683,0,,9892
3,187580980,187613477,dup,HG00404,0,,32497
3,187934178,187986491,dup,HG00403,0,,52313
3,187935614,187984597,dup,HG00409,0,,48983
3,188073806,188088110,dup,HG00437,0,,14304
3,188074683,188094101,dup,HG00437,0,,19418
3,188716998,188732191,dup,HG02757,0,,15193
3,189380075,189385345,dup,HG03428,0,,5270
3,189937065,189942380,dup,HG00554,0,,5315
3,190724667,190785655,dup,HG01920,0,,60988
3,190790857,190829121,dup,HG01920,0,,38264
3,190837733,190877037,dup,HG01920,0,,39304
3,190892655,190995076,dup,HG01920,0,,102421
3,190906347,190974017,dup,HG01920,0,,67670
3,190969418,191271226,dup,HG01920,0,,301808
3,190981304,190998191,dup,HG01920,0,,16887
3,191022481,191053130,dup,HG01920,0,,30649
3,191270483,191349261,dup,HG00371,0,,78778
3,191352387,191430506,dup,HG00371,0,,78119
3,191504649,191508888,dup,HG02052,0,,4239
3,191936240,191988116,dup,HG03755,0,,51876
3,191988492,191997177,dup,HG00190,0,,8685
3,192650075,192700292,dup,HG01522,0,,50217
3,192776825,192782561,dup,HG00097,0,,5736
3,193173178,193178725,dup,HG02151,0,,5547
3,194153427,194304953,dup,HG02371,0,,151526
3,194236078,194272048,dup,HG01845,0,,35970
3,194313045,194519814,dup,HG02371,0,,206769
3,194625331,194739786,dup,NA18909,0,,114455
3,194708030,195237488,dup,HG03061,0,,529458
3,195452012,195457240,dup,HG00096,0,,5228
3,195457141,195468593,dup,HG01626,0,,11452
3,195558908,195566710,dup,HG00629,0,,7802
3,195667478,195677673,dup,HG00419,0,,10195
3,195680898,195693668,dup,HG00096,0,,12770
3,195723687,195740195,dup,HG03680,0,,16508
3,195954431,196022808,dup,HG00180,0,,68377
3,195956418,195976047,dup,HG03624,0,,19629
3,195993659,196009540,dup,HG00276,0,,15881
3,196168505,196190516,dup,HG02079,0,,22011
3,196391639,196394722,dup,HG01851,0,,3083
3,196485971,197171084,dup,HG03061,0,,685113
3,197018504,197027004,dup,HG01864,0,,8500
3,197110416,197132351,dup,HG00185,0,,21935
3,197120826,197311075,dup,HG02574,0,,190249
3,197123813,197172608,dup,HG02574,0,,48795
3,197212968,197289515,dup,HG01503,0,,76547
3,197288459,197453117,dup,HG02407,0,,164658
3,197295139,197346990,dup,HG02407,0,,51851
3,197391943,197451283,dup,HG02407,0,,59340
3,197394524,197638445,dup,NA18510,0,,243921
3,197475447,197532424,dup,NA18510,0,,56977
3,197564510,197606099,dup,HG00410,0,,41589
3,197564532,197722956,dup,HG00410,0,,158424
3,197613818,197635874,dup,HG00410,0,,22056
3,197669754,197687686,dup,HG00410,0,,17932
3,197680415,197711019,dup,HG00410,0,,30604
3,197720556,197737529,dup,HG00179,0,,16973
3,197752530,197779738,dup,HG00179,0,,27208
3,197771775,197804436,dup,HG00179,0,,32661
3,197814632,197832761,dup,HG00179,0,,18129
3,197843878,197850008,dup,HG00099,0,,6130
4,129914869,129921460,del,HG00699,0,,6591
4,136653014,136666270,del,HG00580,0,,13256
4,165380042,165380035,del,HG01366,0,,-7
4,61175109,61177405,del,NA19004,0,,2296
4,1391225,1392395,del,NA19453,0,,1170
4,25220184,25233696,del,NA18636,0,,13512
4,42360457,42361289,del,NA18553,0,,832
4,40882844,40882948,del,HG00232,0,,104
4,163566892,163569882,del,NA19474,0,,2990
4,22502064,22502162,del,NA11919,0,,98
4,186158955,186160374,del,NA20341,0,,1419
4,144748472,144979326,del,NA19102,0,,230854
4,30151486,30152564,del,NA19682,0,,1078
4,7387964,7388139,del,NA18987,0,,175
4,37462590,37463780,del,NA19461,0,,1190
4,152891447,152893680,del,HG00236,0,,2233
4,38426814,38431522,del,NA12249,0,,4708
4,121976651,121976803,del,NA18570,0,,152
4,144718876,144849454,del,HG00113,0,,130578
4,166750049,166751650,del,NA18535,0,,1601
4,60288732,60296320,del,NA18870,0,,7588
4,107405064,107408163,del,NA20340,0,,3099
4,44018290,44027205,del,NA19256,0,,8915
4,70124516,70230422,del,HG00139,0,,105906
4,13953489,13957210,del,NA18950,0,,3721
4,1618716,1618975,del,NA19360,0,,259
4,22390905,22393487,del,HG00259,0,,2582
4,172374411,172379425,del,NA20582,0,,5014
4,6624513,6626558,del,HG01048,0,,2045
4,83630073,83633147,del,NA18634,0,,3074
4,185977875,185978393,del,HG00656,0,,518
4,144036856,144039514,del,HG01137,0,,2658
4,116311789,116315573,del,NA19346,0,,3784
4,186441635,186444073,del,NA12763,0,,2438
4,53338307,53344290,del,NA18619,0,,5983
4,64694328,64714391,del,NA19722,0,,20063
4,136900158,136906303,del,NA19005,0,,6145
4,122282249,122289951,del,HG00637,0,,7702
4,49125531,49139910,del,HG01188,0,,14379
4,109804144,109810814,del,NA18534,0,,6670
4,6618109,6621776,del,NA07048,0,,3667
4,58884552,58886626,del,NA19213,0,,2074
4,76663346,76669164,del,NA18963,0,,5818
4,42706127,42709437,del,NA19360,0,,3310
4,21494714,21495104,del,HG00554,0,,390
4,115511096,115513864,del,HG01052,0,,2768
4,3492002,3492486,del,NA19114,0,,484
4,89522908,89523223,del,NA19248,0,,315
4,102267116,102269022,del,HG00353,0,,1906
4,189094253,189104124,del,HG00337,0,,9871
4,188959366,188959488,del,HG01102,0,,122
4,166597498,166599896,del,HG00512,0,,2398
4,11489508,11519554,del,HG01188,0,,30046
4,93553522,93555871,del,HG00437,0,,2349
4,161879029,161884943,del,NA18909,0,,5914
4,133790463,133790796,del,HG00689,0,,333
4,125768652,125768756,del,HG00318,0,,104
4,69372416,69490922,del,NA19338,0,,118506
4,157878280,157880485,del,HG00328,0,,2205
4,69373216,69490922,del,HG00281,0,,117706
4,123821360,123821513,del,HG01107,0,,153
4,34215765,34350779,del,HG00629,0,,135014
4,185788309,185793094,del,NA12829,0,,4785
4,21160416,21166872,del,NA07346,0,,6456
4,9576977,9577448,del,NA19074,0,,471
4,58173901,58174190,del,NA18486,0,,289
4,163394003,163396420,del,HG01389,0,,2417
4,71227553,71249800,del,NA18565,0,,22247
4,7791207,7791303,del,NA19380,0,,96
4,46774667,46776421,del,NA19257,0,,1754
4,117654807,117657736,del,NA19355,0,,2929
4,103213614,103217821,del,NA19009,0,,4207
4,98354290,98359213,del,NA12763,0,,4923
4,5355025,5355189,del,NA19129,0,,164
4,133445431,133445701,del,NA12716,0,,270
4,78267930,78268471,del,NA19116,0,,541
4,97897194,97897530,del,NA18965,0,,336
4,92472834,92478307,del,NA19455,0,,5473
4,78269322,78269725,del,HG00273,0,,403
4,57382935,57391709,del,HG00180,0,,8774
4,189425439,189428704,del,NA19070,0,,3265
4,162053250,162053660,del,HG01080,0,,410
4,19330922,19333569,del,NA19711,0,,2647
4,159218936,159219449,del,HG00258,0,,513
4,104201727,104248854,del,NA19921,0,,47127
4,55219497,55220355,del,NA19461,0,,858
4,14391016,14391622,del,HG00654,0,,606
4,147920590,147920903,del,NA18934,0,,313
4,117354450,117356386,del,NA19474,0,,1936
4,10392430,10402193,del,NA19663,0,,9763
4,40010627,40010943,del,NA19153,0,,316
4,66660090,66661146,del,NA18487,0,,1056
4,82052323,82052496,del,NA18511,0,,173
4,17036172,17040075,del,NA19102,0,,3903
4,184385346,184385598,del,HG00463,0,,252
4,28960136,28964284,del,NA18635,0,,4148
4,14881377,14885879,del,NA19448,0,,4502
4,49516722,49516835,del,HG00274,0,,113
4,139062861,139063392,del,NA19114,0,,531
4,189744940,189745099,del,NA20322,0,,159
4,169718311,169719118,del,NA19474,0,,807
4,146515147,146520007,del,NA18636,0,,4860
4,41969871,41977771,del,HG00473,0,,7900
4,94559439,94565490,del,NA19456,0,,6051
4,184514251,184515134,del,HG00449,0,,883
4,88775635,88775952,del,NA18874,0,,317
4,70123821,70232371,del,HG00284,0,,108550
4,168371940,168373136,del,NA12006,0,,1196
4,26254929,26256477,del,NA19713,0,,1548
4,128292970,128295865,del,NA18984,0,,2895
4,74265917,74269827,del,HG00324,0,,3910
4,95637740,95638661,del,NA19982,0,,921
4,63669426,63676126,del,NA18573,0,,6700
4,107604296,107609253,del,NA06986,0,,4957
4,101100436,101101930,del,NA18633,0,,1494
4,69380516,69491022,del,NA20810,0,,110506
4,105017021,105025439,del,NA18910,0,,8418
4,120027244,120027580,del,NA19256,0,,336
4,110498740,110499065,del,NA19374,0,,325
4,92073874,92081239,del,HG00270,0,,7365
4,146901828,146904352,del,NA19236,0,,2524
4,4122016,4152822,del,NA12890,0,,30806
4,153907884,153910381,del,HG00524,0,,2497
4,106707322,106717088,del,NA18505,0,,9766
4,190057998,190064272,del,HG01198,0,,6274
4,137110687,137111723,del,NA12546,0,,1036
4,32321467,32324017,del,NA19236,0,,2550
4,104615366,104615560,del,NA18912,0,,194
4,68265059,68266744,del,HG00237,0,,1685
4,40312180,40313554,del,NA20528,0,,1374
4,179345704,179347680,del,NA20322,0,,1976
4,70467458,70472802,del,HG01342,0,,5344
4,49133811,49135427,del,HG01125,0,,1616
4,36020524,36021277,del,NA19321,0,,753
4,8212386,8214051,del,NA19711,0,,1665
4,39574595,39575954,del,NA19777,0,,1359
4,151754373,151755007,del,NA19444,0,,634
4,180088111,180090064,del,HG01351,0,,1953
4,112422857,112426240,del,NA18622,0,,3383
4,31463510,31469541,del,HG00537,0,,6031
4,175625166,175626970,del,NA18950,0,,1804
4,42905165,42905853,del,NA19084,0,,688
4,126591249,126597760,del,HG00442,0,,6511
4,134173598,134176686,del,NA19338,0,,3088
4,161013816,161018372,del,HG00403,0,,4556
4,83984425,83984956,del,NA18510,0,,531
4,56486416,56491522,del,HG00500,0,,5106
4,162449316,162453472,del,HG00323,0,,4156
4,156673803,156678842,del,NA19257,0,,5039
4,177673226,177679993,del,HG00500,0,,6767
4,155267663,155270455,del,NA18868,0,,2792
4,21081123,21086548,del,NA18908,0,,5425
4,181466562,181473103,del,NA18532,0,,6541
4,32137725,32138931,del,NA19355,0,,1206
4,189893416,189896722,del,HG00266,0,,3306
4,88948473,88949634,del,NA19190,0,,1161
4,7635511,7635852,del,NA18949,0,,341
4,117420629,117420908,del,NA12004,0,,279
4,98197816,98202472,del,NA20792,0,,4656
4,163322012,163327008,del,HG00277,0,,4996
4,24966453,24967132,del,NA19213,0,,679
4,23376422,23376564,del,NA18861,0,,142
4,145487475,145516819,del,NA20276,0,,29344
4,7182373,7187467,del,HG01190,0,,5094
4,133621053,133624529,del,NA19440,0,,3476
4,187547134,187548131,del,HG01389,0,,997
4,144771064,144892039,del,HG00313,0,,120975
4,57720015,57722609,del,NA18616,0,,2594
4,100205160,100265625,del,NA12842,0,,60465
4,87646391,87651943,del,HG00326,0,,5552
4,185158103,185169090,del,NA10851,0,,10987
4,184581969,184582629,del,HG01389,0,,660
4,150952857,150953363,del,HG01375,0,,506
4,67659521,67661710,del,NA19190,0,,2189
4,34531616,34531950,del,NA19445,0,,334
4,164125003,164125431,del,NA18545,0,,428
4,33473404,33473743,del,NA12414,0,,339
4,57540060,57544660,del,NA18489,0,,4600
4,107185794,107190141,del,NA19377,0,,4347
4,8135057,8136052,del,HG01365,0,,995
4,93854166,93861422,del,HG01061,0,,7256
4,152790164,152794721,del,NA20795,0,,4557
4,118841169,118842233,del,HG01462,0,,1064
4,33849683,33852642,del,NA19240,0,,2959
4,35495331,35496895,del,NA19437,0,,1564
4,61500231,61502103,del,HG00250,0,,1872
4,148495019,148501496,del,HG00272,0,,6477
4,123973309,123976078,del,NA18982,0,,2769
4,135515011,135517957,del,HG00543,0,,2946
4,11041506,11042659,del,NA18934,0,,1153
4,60483657,60483912,del,NA11994,0,,255
4,93579941,93580271,del,NA20808,0,,330
4,40568435,40575531,del,NA07056,0,,7096
4,69373977,69491271,del,NA18627,0,,117294
4,628786,629268,del,HG00261,0,,482
4,43898173,43902468,del,HG01070,0,,4295
4,186481934,186482104,del,HG00536,0,,170
4,81531219,81535941,del,NA18517,0,,4722
4,114135092,114135577,del,NA18943,0,,485
4,190598025,190598108,del,NA18977,0,,83
4,9376343,9378692,del,HG00353,0,,2349
4,4568025,4568623,del,NA19920,0,,598
4,82929300,82931391,del,HG00142,0,,2091
4,138180087,138191464,del,HG00353,0,,11377
4,120131505,120132989,del,NA18630,0,,1484
4,69790855,69791175,del,NA18570,0,,320
4,187353504,187357170,del,NA19130,0,,3666
4,157557363,157557839,del,NA19238,0,,476
4,91545094,91548800,del,NA19655,0,,3706
4,120552848,120556132,del,NA19469,0,,3284
4,8958519,8960729,del,NA19360,0,,2210
4,22075999,22077575,del,NA12399,0,,1576
4,131487335,131490241,del,NA18623,0,,2906
4,49125412,49150089,del,NA19782,0,,24677
4,70140316,70232122,del,NA19711,0,,91806
4,64091087,64091241,del,HG00501,0,,154
4,96528423,96529685,del,NA18501,0,,1262
4,111966652,111968351,del,HG00536,0,,1699
4,115396745,115431467,del,NA18608,0,,34722
4,127468200,127473255,del,NA20528,0,,5055
4,71544883,71547205,del,HG00464,0,,2322
4,143694983,143696473,del,NA19373,0,,1490
4,62284129,62285278,del,NA19835,0,,1149
4,53614233,53616024,del,NA19057,0,,1791
4,19480363,19508621,del,HG00654,0,,28258
4,25617343,25621657,del,HG01197,0,,4314
4,42763716,42769272,del,HG00366,0,,5556
4,64134308,64154536,del,HG01051,0,,20228
4,92756916,92761722,del,NA19399,0,,4806
4,115886021,115887645,del,HG01083,0,,1624
4,108333271,108333697,del,NA18620,0,,426
4,93899430,93909821,del,HG00592,0,,10391
4,59167258,59182145,del,NA20508,0,,14887
4,189155577,189156136,del,HG00436,0,,559
4,6897463,6900381,del,NA19159,0,,2918
4,6172481,6172584,del,HG00346,0,,103
4,109346938,109348668,del,NA19236,0,,1730
4,161014616,161018872,del,NA18942,0,,4256
4,76948811,76949075,del,NA19712,0,,264
4,24189774,24191869,del,NA19982,0,,2095
4,15760385,15768830,del,NA19901,0,,8445
4,10325840,10338583,del,NA19332,0,,12743
4,177851105,177852251,del,NA18504,0,,1146
4,189744559,189745798,del,NA19247,0,,1239
4,54565852,54567782,del,HG00183,0,,1930
4,68453575,68454225,del,NA18597,0,,650
4,90548291,90548614,del,NA18953,0,,323
4,48334700,48336362,del,NA19334,0,,1662
4,171362766,171362572,del,HG00427,0,,-194
4,47612082,47616510,del,HG00699,0,,4428
4,142399494,142401167,del,HG01051,0,,1673
4,16444255,16460724,del,NA18582,0,,16469
4,189049714,189050236,del,HG00684,0,,522
4,20082559,20088902,del,NA19374,0,,6343
4,190329529,190329645,del,NA19391,0,,116
4,44971996,44972168,del,NA18943,0,,172
4,40622140,40629437,del,NA18635,0,,7297
4,77071332,77071441,del,NA18622,0,,109
4,29226569,29233962,del,NA19239,0,,7393
4,70973779,70984226,del,NA19107,0,,10447
4,121856666,121860472,del,NA18950,0,,3806
4,86462284,86462605,del,NA18923,0,,321
4,12326795,12328079,del,NA18487,0,,1284
4,36908108,36908572,del,NA19313,0,,464
4,158728425,158731911,del,NA19201,0,,3486
4,46226339,46235234,del,NA18982,0,,8895
4,161669755,161671434,del,NA19681,0,,1679
4,168107266,168115322,del,HG00595,0,,8056
4,81298836,81305966,del,HG01070,0,,7130
4,168610724,168615011,del,HG00559,0,,4287
4,160311067,160312714,del,NA19063,0,,1647
4,116266024,116276616,del,NA19248,0,,10592
4,162274465,162277320,del,NA18616,0,,2855
4,730302,730463,del,HG01052,0,,161
4,39704509,39713780,del,HG00273,0,,9271
4,69685186,69686154,del,HG01133,0,,968
4,176595470,176606085,del,HG01133,0,,10615
4,123411443,123412423,del,NA20809,0,,980
4,56266366,56269522,del,NA19470,0,,3156
4,9015891,9547324,del,HG01107,0,,531433
4,83316518,83317728,del,NA18504,0,,1210
4,187093716,187098022,del,NA19684,0,,4306
4,126485969,127069479,del,NA19062,0,,583510
4,96382454,96382660,del,NA19093,0,,206
4,13636382,13636615,del,NA11933,0,,233
4,102079826,102081848,del,HG01198,0,,2022
4,152161344,152163132,del,NA19313,0,,1788
4,70123802,70232423,del,HG00608,0,,108621
4,65819739,65841187,del,NA18501,0,,21448
4,89681616,89682172,del,HG01168,0,,556
4,8920576,8920794,del,NA19076,0,,218
4,157128857,157139573,del,HG00583,0,,10716
4,106237908,106238180,del,NA19072,0,,272
4,80666447,80667206,del,NA18595,0,,759
4,91931556,91935836,del,NA20771,0,,4280
4,179190554,179195762,del,NA19982,0,,5208
4,4245870,4251034,del,NA11933,0,,5164
4,9754555,9757546,del,NA19003,0,,2991
4,3601128,3601462,del,HG00380,0,,334
4,184454684,184455842,del,NA19664,0,,1158
4,94971380,94975701,del,NA18539,0,,4321
4,2843410,2843583,del,NA19397,0,,173
4,120780798,120781067,del,HG00112,0,,269
4,31906160,31918752,del,NA19914,0,,12592
4,1526060,1526153,del,HG00137,0,,93
4,154396341,154404623,del,NA18633,0,,8282
4,79088490,79094201,del,HG00180,0,,5711
4,85082768,85089799,del,HG01374,0,,7031
4,170362846,170366346,del,HG01191,0,,3500
4,172835082,172862890,del,HG01101,0,,27808
4,170920552,170922875,del,NA19723,0,,2323
4,16675657,16677241,del,HG00275,0,,1584
4,77166241,77179128,del,NA19469,0,,12887
4,147240766,147246025,del,NA18603,0,,5259
4,97622602,97627274,del,HG00566,0,,4672
4,138667026,138667827,del,NA18560,0,,801
4,163183945,163186780,del,NA20765,0,,2835
4,184147510,184151560,del,NA18511,0,,4050
4,172988639,172992931,del,HG00177,0,,4292
4,35848012,35856593,del,NA19452,0,,8581
4,112238716,112244172,del,NA20757,0,,5456
4,60287604,60295831,del,HG00628,0,,8227
4,190767258,190768159,del,NA19398,0,,901
4,14376129,14377205,del,NA19394,0,,1076
4,107440323,107442391,del,HG00334,0,,2068
4,7496635,7499711,del,NA19240,0,,3076
4,58339536,58345615,del,HG00118,0,,6079
4,63920759,64052541,del,NA12043,0,,131782
4,56311272,56311443,del,HG01389,0,,171
4,107974329,107974487,del,NA12892,0,,158
4,58811885,58818432,del,NA12004,0,,6547
4,115507821,115513864,del,NA18933,0,,6043
4,53275542,53275677,del,HG00309,0,,135
4,158033493,158037689,del,HG01101,0,,4196
4,117686514,117692169,del,NA19700,0,,5655
4,161034239,161034523,del,NA19394,0,,284
4,101599656,101601604,del,NA19189,0,,1948
4,122282716,122290022,del,HG00613,0,,7306
4,189744846,189745076,del,NA19381,0,,230
4,172774634,172777575,del,HG00253,0,,2941
4,189132089,189132512,del,NA19444,0,,423
4,40028348,40029087,del,NA18526,0,,739
4,166468011,166468313,del,HG00339,0,,302
4,11640175,11642133,del,HG00325,0,,1958
4,20013276,20013582,del,HG01051,0,,306
4,49133874,49135507,del,NA12546,0,,1633
4,188684255,188688856,del,NA18579,0,,4601
4,120263683,120264654,del,HG00525,0,,971
4,3018223,3018391,del,NA11894,0,,168
4,11455911,11614776,del,HG01107,0,,158865
4,65719085,65719560,del,NA18624,0,,475
4,57536996,57538538,del,NA19396,0,,1542
4,20407538,20408527,del,NA18558,0,,989
4,19735136,19739633,del,NA18873,0,,4497
4,96401065,96401460,del,NA19396,0,,395
4,783738,783853,del,HG00343,0,,115
4,182968146,182970583,del,NA18941,0,,2437
4,141633307,141633603,del,HG01198,0,,296
4,81523353,81831976,del,NA12878,0,,308623
4,40504885,40568392,del,NA19783,0,,63507
4,92545295,92548183,del,HG00635,0,,2888
4,137073369,137076042,del,NA18526,0,,2673
4,69275404,69277459,del,NA19066,0,,2055
4,165448087,165448700,del,NA19355,0,,613
4,35146797,35152238,del,HG00280,0,,5441
4,112297318,112309613,del,NA19701,0,,12295
4,185732517,185741422,del,NA20796,0,,8905
4,105313712,105314561,del,NA18548,0,,849
4,3445892,3450070,del,HG01497,0,,4178
4,111157448,111160654,del,HG00464,0,,3206
4,3007085,3009212,del,HG01204,0,,2127
4,187880502,187889752,del,NA18501,0,,9250
4,74747650,74747812,del,NA19190,0,,162
4,25241049,25241190,del,NA18572,0,,141
4,26955951,26957451,del,NA19248,0,,1500
4,119243713,119247077,del,HG00345,0,,3364
4,9487030,9516197,del,HG00580,0,,29167
4,73482352,73483370,del,NA18545,0,,1018
4,169116813,169118417,del,NA19257,0,,1604
4,186049526,186050700,del,HG00689,0,,1174
4,30127759,30128075,del,HG00625,0,,316
4,139384003,139384172,del,NA18522,0,,169
4,119125411,119130199,del,HG00187,0,,4788
4,6651589,6652910,del,HG00403,0,,1321
4,101117717,101118337,del,NA07357,0,,620
4,146447715,146449069,del,HG00704,0,,1354
4,163271506,163278932,del,NA19213,0,,7426
4,163933211,163935005,del,NA19401,0,,1794
4,93855527,93861565,del,HG00176,0,,6038
4,144734650,144860770,del,HG01170,0,,126120
4,45860154,45862748,del,NA20504,0,,2594
4,144897551,145000749,del,HG01462,0,,103198
4,147322260,147331037,del,NA19076,0,,8777
4,141025909,141027057,del,HG00620,0,,1148
4,70123806,70232423,del,NA18522,0,,108617
4,117525305,117537823,del,NA19350,0,,12518
4,73729983,73735787,del,NA19346,0,,5804
4,76931816,76934353,del,NA18982,0,,2537
4,41960514,41961003,del,NA19434,0,,489
4,184484187,184488031,del,NA19440,0,,3844
4,2436588,2446289,del,HG00343,0,,9701
4,185893759,185908164,del,NA19648,0,,14405
4,178514244,178514563,del,NA12154,0,,319
4,18613278,18614346,del,NA19712,0,,1068
4,48414328,48414549,del,NA18577,0,,221
4,75052798,75056466,del,NA19382,0,,3668
4,163346512,163348953,del,HG00737,0,,2441
4,168808527,168993049,del,NA12043,0,,184522
4,83636006,83641268,del,NA19313,0,,5262
4,42762677,42769542,del,NA18520,0,,6865
4,70139615,70248599,del,HG00663,0,,108984
4,64339093,64387656,del,NA20588,0,,48563
4,44018720,44018993,del,HG01108,0,,273
4,85459806,85463515,del,NA12155,0,,3709
4,208160,333280,del,NA19379,0,,125120
4,4893935,4895596,del,HG00610,0,,1661
4,154232470,154235015,del,NA19129,0,,2545
4,73916892,73918800,del,NA19394,0,,1908
4,31448002,31450485,del,NA11893,0,,2483
4,106497062,106502493,del,NA19920,0,,5431
4,72946557,72946606,del,HG01108,0,,49
4,188161893,188162588,del,NA19346,0,,695
4,93412552,93419472,del,NA18612,0,,6920
4,83914030,83919404,del,NA20544,0,,5374
4,102156498,102158364,del,NA19083,0,,1866
4,182200693,182202051,del,HG00257,0,,1358
4,18671069,18675293,del,NA18599,0,,4224
4,151693495,151697465,del,NA19474,0,,3970
4,25969283,25970734,del,HG00732,0,,1451
4,32251055,32251803,del,HG00672,0,,748
4,88074896,88079205,del,HG00318,0,,4309
4,139039525,139040688,del,NA18611,0,,1163
4,112239166,112241272,del,HG01365,0,,2106
4,156959338,156973988,del,HG01124,0,,14650
4,171696705,171700153,del,HG01390,0,,3448
4,5411273,5413754,del,NA19085,0,,2481
4,21180090,21180287,del,NA19384,0,,197
4,100918585,100919317,del,HG00124,0,,732
4,90840633,90844214,del,HG00136,0,,3581
4,57784106,57784411,del,NA19382,0,,305
4,184311857,184315196,del,NA19711,0,,3339
4,154939290,154940919,del,NA18623,0,,1629
4,85469877,85474277,del,HG00404,0,,4400
4,8976940,9000688,del,NA12546,0,,23748
4,176917028,176917146,del,NA19256,0,,118
4,159431178,159432011,del,NA19921,0,,833
4,1140618,1141258,del,NA18615,0,,640
4,55069880,55072045,del,HG00311,0,,2165
4,73307475,73307669,del,NA20278,0,,194
4,130068639,130068988,del,NA18507,0,,349
4,122021761,122023163,del,HG00251,0,,1402
4,19376078,19376206,del,NA19664,0,,128
4,71227913,71250308,del,HG00736,0,,22395
4,135163160,135163447,del,HG00734,0,,287
4,90306,102025,del,NA20515,0,,11719
4,151875562,151885619,del,HG01082,0,,10057
4,186397881,186420809,del,NA12399,0,,22928
4,10392766,10401122,del,NA20537,0,,8356
4,663136,663536,del,NA19093,0,,400
4,75203188,75203605,del,NA18507,0,,417
4,65097099,65097833,del,NA18622,0,,734
4,138091816,138100322,del,HG01356,0,,8506
4,162381498,162381664,del,NA19771,0,,166
4,14757116,14762922,del,HG00556,0,,5806
4,169898299,169900156,del,NA19318,0,,1857
4,96949201,96955832,del,HG00253,0,,6631
4,87872878,87873937,del,NA20786,0,,1059
4,118579966,118591119,del,NA19472,0,,11153
4,174533059,174535911,del,NA18615,0,,2852
4,107814639,107816894,del,HG00117,0,,2255
4,47991690,47992069,del,NA18868,0,,379
4,175504936,175505359,del,HG01384,0,,423
4,164501940,164502253,del,NA18501,0,,313
4,11965426,11978281,del,NA19390,0,,12855
4,8958432,9492456,del,HG00111,0,,534024
4,138092000,138100631,del,HG01066,0,,8631
4,89115649,89121109,del,NA19383,0,,5460
4,155982173,155983746,del,NA19711,0,,1573
4,67122068,67123491,del,NA19444,0,,1423
4,180097877,180098515,del,NA18567,0,,638
4,125754115,125754141,del,NA19397,0,,26
4,161013814,161019649,del,HG00689,0,,5835
4,70397690,70398283,del,NA19780,0,,593
4,130954383,130955825,del,NA19701,0,,1442
4,117095262,117095394,del,NA20588,0,,132
4,80637583,80678623,del,HG01350,0,,41040
4,116166907,116177180,del,NA19371,0,,10273
4,75283016,75322822,del,HG00650,0,,39806
4,54069338,54081957,del,NA18874,0,,12619
4,144711862,144952749,del,HG01113,0,,240887
4,14681667,14683646,del,HG01441,0,,1979
4,171070806,171073252,del,NA20799,0,,2446
4,29034052,29040402,del,NA19332,0,,6350
4,115507819,115511040,del,NA18603,0,,3221
4,80261805,80265827,del,NA19355,0,,4022
4,2750337,2750473,del,HG00236,0,,136
4,189835661,189840747,del,NA19248,0,,5086
4,19057471,19057969,del,HG00120,0,,498
4,63669316,63676022,del,NA18950,0,,6706
4,6172457,6172553,del,HG00377,0,,96
4,134177693,134182890,del,NA19703,0,,5197
4,109961922,109965608,del,HG00151,0,,3686
4,101306526,101312108,del,HG00478,0,,5582
4,22288110,22288414,del,NA19138,0,,304
4,108276696,108279504,del,NA20540,0,,2808
4,58805645,58808739,del,NA19675,0,,3094
4,59607589,59607943,del,HG00111,0,,354
4,158399627,158405396,del,HG00281,0,,5769
4,108476535,108478122,del,NA19247,0,,1587
4,172867944,172868658,del,NA19788,0,,714
4,115743887,115744132,del,NA11893,0,,245
4,144763524,144884565,del,NA19056,0,,121041
4,117499792,117502961,del,NA19678,0,,3169
4,57706348,57710280,del,HG00140,0,,3932
4,57705387,57706327,del,NA19380,0,,940
4,77445992,77453394,del,NA19102,0,,7402
4,172342712,172343150,del,HG00693,0,,438
4,16944237,16950743,del,NA19137,0,,6506
4,162802503,162804540,del,HG01072,0,,2037
4,187552441,187552833,del,NA19213,0,,392
4,177926626,177932247,del,NA18538,0,,5621
4,190191678,190200279,del,HG00418,0,,8601
4,178206819,178216525,del,NA18990,0,,9706
4,22700786,22777116,del,NA18984,0,,76330
4,49177189,49249875,del,HG01136,0,,72686
4,187559916,187560195,del,NA19394,0,,279
4,24341055,24343788,del,HG00237,0,,2733
4,49125489,49144682,del,HG00323,0,,19193
4,31914966,31915922,del,HG00707,0,,956
4,164077204,164077427,del,HG00699,0,,223
4,109347165,109348705,del,NA19236,0,,1540
4,43266844,43274518,del,NA18638,0,,7674
4,89809956,89814624,del,NA18599,0,,4668
4,167677036,167683071,del,HG00153,0,,6035
4,16336507,16376237,del,NA20522,0,,39730
4,165966967,165967741,del,NA18519,0,,774
4,92280245,92285214,del,NA11893,0,,4969
4,10555133,10580235,del,NA19663,0,,25102
4,60422271,60427238,del,NA19471,0,,4967
4,27412122,27414516,del,HG00323,0,,2394
4,69376916,69490972,del,NA11992,0,,114056
4,11446616,11447122,del,HG01375,0,,506
4,183438516,183438835,del,NA18626,0,,319
4,120013808,120014133,del,NA11920,0,,325
4,86564385,86564716,del,NA19819,0,,331
4,77124330,77126206,del,NA18628,0,,1876
4,206488,331693,del,NA19713,0,,125205
4,37766282,37766610,del,NA11831,0,,328
4,8165334,8174104,del,NA18622,0,,8770
4,90427886,90428672,del,NA18984,0,,786
4,32540600,32540915,del,NA11992,0,,315
4,2523851,2524471,del,NA19074,0,,620
4,44291993,44369286,del,HG00512,0,,77293
4,13380620,13382170,del,NA20808,0,,1550
4,164804912,164820086,del,NA18505,0,,15174
4,187093674,187098015,del,HG01052,0,,4341
4,24503111,24504237,del,HG01168,0,,1126
4,708839,710071,del,NA18616,0,,1232
4,8794005,8794210,del,HG00421,0,,205
4,263957,264238,del,NA19159,0,,281
4,67349881,67350944,del,NA19093,0,,1063
4,12712480,12713969,del,NA19723,0,,1489
4,88858360,89074700,del,HG00589,0,,216340
4,3492082,3492740,del,NA19375,0,,658
4,174497908,174498126,del,NA19257,0,,218
4,66011056,66011157,del,NA20818,0,,101
4,176539317,176540258,del,NA19707,0,,941
4,70124016,70230622,del,NA18520,0,,106606
4,167108944,167113978,del,HG00336,0,,5034
4,106148650,106148758,del,NA18867,0,,108
4,152252541,152254129,del,NA19074,0,,1588
4,120333102,120352023,del,NA19009,0,,18921
4,101074164,101088527,del,NA18965,0,,14363
4,111004060,111005040,del,NA19462,0,,980
4,88268243,88274298,del,HG00553,0,,6055
4,157305269,157306936,del,HG00337,0,,1667
4,103779741,103782958,del,NA11843,0,,3217
4,114129190,114131076,del,NA18874,0,,1886
4,97784781,97790276,del,NA20756,0,,5495
4,189937995,190007509,del,NA18638,0,,69514
4,179532969,179534845,del,NA18934,0,,1876
4,4122416,4152522,del,HG01102,0,,30106
4,184416947,184418074,del,HG00112,0,,1127
4,138536790,138540559,del,HG00106,0,,3769
4,39423486,39425794,del,NA19117,0,,2308
4,62028311,62028594,del,NA19467,0,,283
4,190847076,190865781,del,NA20582,0,,18705
4,190393179,190397928,del,NA18923,0,,4749
4,64030857,64031025,del,HG01125,0,,168
4,96854836,96918723,del,NA18553,0,,63887
4,135433002,135435701,del,NA19761,0,,2699
4,189553911,189556111,del,NA18959,0,,2200
4,70140316,70237922,del,NA19376,0,,97606
4,25471198,25472536,del,NA19239,0,,1338
4,1557640,1557830,del,NA19756,0,,190
4,164658298,164659132,del,HG00334,0,,834
4,104610566,104621072,del,NA19067,0,,10506
4,33669778,33680825,del,NA19076,0,,11047
4,34118500,34125979,del,HG00437,0,,7479
4,121087087,121087292,del,NA19726,0,,205
4,35240255,35244436,del,NA19716,0,,4181
4,34779980,34829038,del,NA11894,0,,49058
4,183999280,184000503,del,NA18534,0,,1223
4,121407647,121407970,del,NA12717,0,,323
4,121201740,121202341,del,NA19701,0,,601
4,49135115,49141438,del,HG00705,0,,6323
4,162263757,162263843,del,HG00268,0,,86
4,180540205,180545307,del,HG00583,0,,5102
4,12365741,12385714,del,NA19175,0,,19973
4,49128761,49145189,del,NA19087,0,,16428
4,79121948,79128695,del,NA19917,0,,6747
4,3637843,3637983,del,NA19391,0,,140
4,162449275,162451666,del,NA18539,0,,2391
4,149099296,149101620,del,HG00372,0,,2324
4,168109163,168115697,del,NA19067,0,,6534
4,1419766,1420872,del,NA19471,0,,1106
4,31688662,31689870,del,NA20808,0,,1208
4,155952933,155956062,del,HG00442,0,,3129
4,46797000,46799138,del,NA19160,0,,2138
4,31035183,31035823,del,NA18595,0,,640
4,93573754,93574171,del,NA11894,0,,417
4,181735796,181740978,del,NA10851,0,,5182
4,161752431,161752598,del,NA20815,0,,167
4,170286863,170288384,del,HG01204,0,,1521
4,176429308,176433146,del,NA19463,0,,3838
4,28421590,28421940,del,NA20589,0,,350
4,69763331,69764344,del,NA19376,0,,1013
4,183467717,183470006,del,NA18486,0,,2289
4,55998554,55998888,del,NA18605,0,,334
4,107319836,107322694,del,NA19920,0,,2858
4,132490408,132493633,del,HG01350,0,,3225
4,61621927,61622050,del,HG00321,0,,123
4,189402854,189404338,del,NA20828,0,,1484
4,39658466,39658572,del,NA19651,0,,106
4,49125553,49147445,del,HG01048,0,,21892
4,113225313,113232174,del,HG00542,0,,6861
4,130477696,130481939,del,NA19452,0,,4243
4,149990578,149992577,del,HG01491,0,,1999
4,116255565,116255658,del,NA18638,0,,93
4,71194609,71200088,del,HG00131,0,,5479
4,35822757,35841849,del,HG00133,0,,19092
4,104211897,104214374,del,NA18498,0,,2477
4,56662763,56668629,del,HG00437,0,,5866
4,49133907,49138375,del,NA19384,0,,4468
4,182628152,182643929,del,NA18612,0,,15777
4,154290796,154293589,del,HG00329,0,,2793
4,70434803,70436190,del,NA19248,0,,1387
4,39495527,39498072,del,HG00123,0,,2545
4,15861201,15861867,del,HG01188,0,,666
4,152088240,152090087,del,NA20515,0,,1847
4,184474073,184474679,del,NA19707,0,,606
4,66961521,66970995,del,NA19917,0,,9474
4,36671760,36673775,del,NA18871,0,,2015
4,120579967,120580878,del,NA18502,0,,911
4,134430824,134456690,del,HG00251,0,,25866
4,172736226,172737993,del,NA19719,0,,1767
4,707010,707135,del,HG00319,0,,125
4,169619456,169621228,del,HG00443,0,,1772
4,17593015,17595346,del,HG00476,0,,2331
4,152898624,152900985,del,NA19093,0,,2361
4,39707371,39707533,del,NA18543,0,,162
4,169614254,169614370,del,HG00608,0,,116
4,94239134,94241915,del,NA19074,0,,2781
4,24992962,24995280,del,NA18539,0,,2318
4,10211260,10234567,del,HG01455,0,,23307
4,143794228,143801000,del,NA18858,0,,6772
4,137359076,137364841,del,NA18908,0,,5765
4,39971202,39972814,del,NA19247,0,,1612
4,7167081,7167234,del,NA19384,0,,153
4,172804903,172806260,del,NA20816,0,,1357
4,98172511,98187404,del,NA18560,0,,14893
4,63478313,63478488,del,NA19381,0,,175
4,74555320,74557028,del,NA18870,0,,1708
4,63972170,63982472,del,NA19068,0,,10302
4,95870448,95870766,del,HG01072,0,,318
4,112677167,112681393,del,NA19439,0,,4226
4,55007515,55012928,del,NA19393,0,,5413
4,56266767,56269120,del,NA19395,0,,2353
4,178375043,178386599,del,NA19239,0,,11556
4,110385507,110389761,del,HG00693,0,,4254
4,3079431,3091237,del,NA20786,0,,11806
4,92866184,92869464,del,NA19004,0,,3280
4,163370268,163372670,del,NA19129,0,,2402
4,41406255,41407842,del,NA18498,0,,1587
4,106387433,106389137,del,NA19056,0,,1704
4,161160103,161166784,del,NA19311,0,,6681
4,101654528,101657781,del,NA19676,0,,3253
4,9615516,9632922,del,HG00436,0,,17406
4,186955112,186955930,del,NA19468,0,,818
4,26290562,26295353,del,HG01334,0,,4791
4,22495708,22497412,del,NA19909,0,,1704
4,120244558,120244903,del,NA18968,0,,345
4,8956090,9465728,del,HG01350,0,,509638
4,176671604,176679855,del,NA19719,0,,8251
4,187378707,187378780,del,NA12750,0,,73
4,189744705,189745780,del,NA19835,0,,1075
4,9573062,9573170,del,NA20533,0,,108
4,151551667,151569121,del,HG00250,0,,17454
4,190769817,190770480,del,HG01107,0,,663
4,188288161,188316562,del,NA20761,0,,28401
4,138966211,138967218,del,NA12843,0,,1007
4,88185732,88228380,del,NA19470,0,,42648
4,70559128,70559839,del,HG00149,0,,711
4,46202795,46205026,del,HG00640,0,,2231
4,189364361,189364505,del,NA18593,0,,144
4,147730173,147731090,del,NA19717,0,,917
4,64694516,64715872,del,NA19747,0,,21356
4,126841069,126843028,del,HG00419,0,,1959
4,103120740,103120985,del,NA11830,0,,245
4,156138422,156140948,del,HG01351,0,,2526
4,122208146,122209498,del,NA19213,0,,1352
4,42654904,42655053,del,NA18602,0,,149
4,185628020,185628531,del,NA19359,0,,511
4,73420262,73425914,del,NA19355,0,,5652
4,130066335,130068201,del,HG00513,0,,1866
4,74265655,74269774,del,HG00324,0,,4119
4,34645541,34665603,del,HG01066,0,,20062
4,84589439,84591836,del,NA19347,0,,2397
4,124917332,124920502,del,NA19347,0,,3170
4,84221708,84221993,del,NA20527,0,,285
4,47423118,47424238,del,NA20535,0,,1120
4,122283466,122289722,del,NA18633,0,,6256
4,155807957,155808330,del,NA18499,0,,373
4,9007008,9538429,del,NA18566,0,,531421
4,119125116,119130872,del,HG00310,0,,5756
4,152990311,152993946,del,NA18543,0,,3635
4,1366556,1366628,del,HG00427,0,,72
4,1277003,1277114,del,HG00256,0,,111
4,144780556,145004633,del,HG00108,0,,224077
4,83895280,83897778,del,NA19471,0,,2498
4,7338253,7338351,del,NA11830,0,,98
4,44376058,44377422,del,NA19070,0,,1364
4,32517266,32518972,del,HG01073,0,,1706
4,144809325,144927610,del,HG00565,0,,118285
4,65127097,65127994,del,NA12045,0,,897
4,90799904,90803916,del,HG01356,0,,4012
4,22663108,22666224,del,NA19311,0,,3116
4,68147919,68151635,del,NA19346,0,,3716
4,183570248,183571986,del,HG00403,0,,1738
4,100875852,100876810,del,NA18577,0,,958
4,93856916,93861422,del,HG01492,0,,4506
4,59985387,59985494,del,HG00284,0,,107
4,21292928,21293047,del,HG01073,0,,119
4,76825850,76831724,del,NA18940,0,,5874
4,7938070,7938310,del,NA19720,0,,240
4,27552184,27566699,del,NA20760,0,,14515
4,3600578,3601583,del,NA18989,0,,1005
4,33065198,33073293,del,NA19247,0,,8095
4,71372491,71373119,del,NA19453,0,,628
4,79298994,79300615,del,NA18523,0,,1621
4,138090716,138100322,del,HG00160,0,,9606
4,77781743,77790705,del,NA20346,0,,8962
4,171276609,171277758,del,NA18550,0,,1149
4,5292289,5297209,del,HG00187,0,,4920
4,165823217,165823329,del,HG00662,0,,112
4,53599794,53600785,del,NA19334,0,,991
4,93360757,93361509,del,HG01354,0,,752
4,158395722,158421469,del,NA19005,0,,25747
4,140231344,140238513,del,HG01441,0,,7169
4,179772405,179773729,del,NA19471,0,,1324
4,186048546,186048956,del,NA12275,0,,410
4,58252067,58262326,del,NA19685,0,,10259
4,141242773,141247283,del,HG00629,0,,4510
4,81509005,81509904,del,NA19914,0,,899
4,110339341,110339491,del,NA19428,0,,150
4,12159339,12162879,del,NA20828,0,,3540
4,43855814,43856412,del,NA19782,0,,598
4,92648728,92716697,del,HG01342,0,,67969
4,4354422,4356293,del,NA19685,0,,1871
4,9104603,9127006,del,HG01498,0,,22403
4,91931645,91933437,del,HG00478,0,,1792
4,187843677,187850406,del,NA19399,0,,6729
4,190433475,190434427,del,NA19062,0,,952
4,183285662,183296087,del,NA19448,0,,10425
4,9158154,9232046,del,HG00641,0,,73892
4,33706796,33713931,del,NA07051,0,,7135
4,209406,209857,del,NA12763,0,,451
4,40635760,40637291,del,NA19248,0,,1531
4,110260900,110267538,del,HG00584,0,,6638
4,31013947,31014972,del,NA18615,0,,1025
4,88998917,89002211,del,HG00309,0,,3294
4,12153848,12157174,del,NA12763,0,,3326
4,117646995,117649844,del,NA19457,0,,2849
4,56433490,56434539,del,HG00159,0,,1049
4,118385066,118396129,del,NA19332,0,,11063
4,49139959,49140187,del,NA19355,0,,228
4,77749616,77751772,del,NA18566,0,,2156
4,9863696,9865963,del,NA19467,0,,2267
4,184008177,184009736,del,HG00684,0,,1559
4,16942716,16951322,del,HG00512,0,,8606
4,72289672,72293362,del,NA12842,0,,3690
4,162802561,162804137,del,HG01072,0,,1576
4,78491901,78497409,del,NA19701,0,,5508
4,66169567,66179419,del,HG01070,0,,9852
4,69429351,69531766,del,NA18539,0,,102415
4,10272117,10274262,del,NA20504,0,,2145
4,24341235,24343588,del,HG00237,0,,2353
4,12649926,12650531,del,NA18502,0,,605
4,189437076,189438906,del,HG00328,0,,1830
4,178052167,178058149,del,NA19380,0,,5982
4,39994805,39997733,del,NA19130,0,,2928
4,39716151,39718010,del,NA19470,0,,1859
4,157732722,157735119,del,NA20790,0,,2397
4,179841737,179846371,del,HG00734,0,,4634
4,176262863,176264849,del,NA20341,0,,1986
4,151192690,151192706,del,NA19428,0,,16
4,130280830,130282936,del,NA18517,0,,2106
4,119278031,119310160,del,NA19461,0,,32129
4,159529937,159531328,del,NA11933,0,,1391
4,35884483,35884955,del,HG01171,0,,472
4,122691015,122692800,del,NA20513,0,,1785
4,162238036,162240613,del,NA19436,0,,2577
4,172009384,172013764,del,NA19338,0,,4380
4,93584176,93585733,del,HG01342,0,,1557
4,164362984,164364863,del,NA19379,0,,1879
4,58921589,58934407,del,NA20539,0,,12818
4,185883507,185883588,del,HG01069,0,,81
4,2338880,2339108,del,NA11829,0,,228
4,63301184,63301680,del,NA19716,0,,496
4,14356575,14356853,del,NA19257,0,,278
4,21521142,21521260,del,HG00418,0,,118
4,131694838,131695089,del,HG01198,0,,251
4,7146148,7149747,del,NA18522,0,,3599
4,25682939,25684326,del,NA19716,0,,1387
4,68380898,68383314,del,NA19334,0,,2416
4,21370716,21375372,del,HG00593,0,,4656
4,44018792,44018993,del,HG00702,0,,201
4,145333578,145354669,del,HG00620,0,,21091
4,170681026,170683852,del,HG00614,0,,2826
4,144095497,144100212,del,NA19443,0,,4715
4,190191615,190200453,del,NA11918,0,,8838
4,168795275,168818163,del,NA19213,0,,22888
4,91933858,91936101,del,HG00185,0,,2243
4,107056578,107063362,del,NA19334,0,,6784
4,70123405,70231996,del,HG00240,0,,108591
4,116165416,116177422,del,NA19332,0,,12006
4,4122566,4154122,del,HG01462,0,,31556
4,66755375,66755655,del,NA19201,0,,280
4,117700197,117701108,del,HG00608,0,,911
4,65015429,65025808,del,NA18609,0,,10379
4,89786132,89789710,del,NA19664,0,,3578
4,128752672,128753243,del,NA18989,0,,571
4,187971257,187972694,del,NA19761,0,,1437
4,144573287,144573614,del,NA19007,0,,327
4,103822750,103825541,del,NA18983,0,,2791
4,119322762,119322885,del,HG01365,0,,123
4,3491765,3492737,del,HG00137,0,,972
4,70022829,70189210,del,NA18487,0,,166381
4,111005704,111008632,del,NA19701,0,,2928
4,167211916,167212172,del,HG01390,0,,256
4,19088477,19126159,del,NA18597,0,,37682
4,4109716,4158822,del,HG00578,0,,49106
4,73552249,73561108,del,NA11829,0,,8859
4,76565426,76569227,del,HG00421,0,,3801
4,117367795,117368488,del,NA18549,0,,693
4,101390634,101390812,del,HG01377,0,,178
4,177691570,177691825,del,NA19093,0,,255
4,63516192,63517942,del,NA19247,0,,1750
4,752269,753746,del,HG00308,0,,1477
4,2810316,2811072,del,HG01440,0,,756
4,168479428,168480617,del,HG00266,0,,1189
4,63669516,63674822,del,NA18616,0,,5306
4,54219942,54220101,del,NA18517,0,,159
4,14075989,14077743,del,NA12155,0,,1754
4,187614516,187614844,del,NA19072,0,,328
4,145000520,145009824,del,HG01354,0,,9304
4,112238766,112242022,del,HG00331,0,,3256
4,104353045,104357327,del,HG01437,0,,4282
4,23679841,23681062,del,HG00641,0,,1221
4,163278361,163281537,del,HG00463,0,,3176
4,35105633,35111226,del,HG00245,0,,5593
4,157407286,157412432,del,NA19380,0,,5146
4,136377814,136380192,del,NA18626,0,,2378
4,99680786,99682772,del,NA19920,0,,1986
4,16153468,16154229,del,NA18907,0,,761
4,64919089,64919784,del,NA19377,0,,695
4,21085973,21086619,del,NA19190,0,,646
4,143857917,143858597,del,NA19446,0,,680
4,187408174,187408528,del,HG00513,0,,354
4,162802494,162804552,del,HG01072,0,,2058
4,156249274,156249675,del,HG01047,0,,401
4,128775997,128778509,del,NA18534,0,,2512
4,86571297,86572910,del,NA19920,0,,1613
4,180739264,180741242,del,NA19835,0,,1978
4,4109716,4152522,del,NA19663,0,,42806
4,151874666,151885522,del,NA19982,0,,10856
4,31492863,31493299,del,NA12750,0,,436
4,180312204,180312340,del,NA11830,0,,136
4,129844346,129849732,del,NA19438,0,,5386
4,137520471,137541422,del,HG00251,0,,20951
4,121047256,121051583,del,NA18557,0,,4327
4,105751867,105752055,del,HG01174,0,,188
4,91885557,91899739,del,NA19116,0,,14182
4,174466653,174476677,del,NA19395,0,,10024
4,86967178,86967682,del,HG00662,0,,504
4,43269123,43269883,del,HG00313,0,,760
4,187160121,187160651,del,NA18620,0,,530
4,134346775,134346898,del,NA19355,0,,123
4,130062132,130068888,del,NA20819,0,,6756
4,187231073,187234086,del,NA19247,0,,3013
4,78236274,78236540,del,NA19346,0,,266
4,152342721,152343437,del,HG00262,0,,716
4,68184402,68187588,del,NA19396,0,,3186
4,155952684,155956075,del,HG00442,0,,3391
4,43882674,43885100,del,HG00537,0,,2426
4,42551540,42552683,del,HG00683,0,,1143
4,138324116,138333377,del,NA19403,0,,9261
4,61035480,61035808,del,NA19068,0,,328
4,36671901,36673779,del,NA19700,0,,1878
4,186314338,186314912,del,NA19700,0,,574
4,70880568,70880878,del,HG00346,0,,310
4,13145178,13147608,del,NA19054,0,,2430
4,136709150,136714894,del,HG00614,0,,5744
4,86310519,86310830,del,NA19074,0,,311
4,60816368,60817901,del,HG01183,0,,1533
4,165037651,165040860,del,NA18907,0,,3209
4,137437162,137446616,del,HG01462,0,,9454
4,477024,483902,del,NA18544,0,,6878
4,82469378,82506197,del,HG00513,0,,36819
4,107056578,107063364,del,NA12003,0,,6786
4,190381883,190382423,del,NA18856,0,,540
4,3648539,3648711,del,HG01334,0,,172
4,127325800,127330070,del,NA19449,0,,4270
4,186348822,186349148,del,HG00148,0,,326
4,9625216,9633372,del,NA20278,0,,8156
4,62837416,62840869,del,NA19088,0,,3453
4,74942382,74945430,del,NA12763,0,,3048
4,161828636,161829438,del,HG00262,0,,802
4,124943552,124945186,del,HG00478,0,,1634
4,162975367,162977585,del,HG01075,0,,2218
4,184106041,184106278,del,NA19093,0,,237
4,16812416,16812172,del,NA12347,0,,-244
4,77124463,77126259,del,NA18628,0,,1796
4,57053780,57054804,del,NA20510,0,,1024
4,34489283,34491661,del,NA18510,0,,2378
4,170719497,170720414,del,HG00325,0,,917
4,33378223,33386471,del,NA19917,0,,8248
4,133620868,133624468,del,NA19440,0,,3600
4,35694073,35698260,del,NA19247,0,,4187
4,34956601,34958180,del,NA18868,0,,1579
4,129699702,129699995,del,NA18999,0,,293
4,70046069,70107037,del,NA19383,0,,60968
4,121523062,121545335,del,NA19701,0,,22273
4,89830644,89831807,del,NA18548,0,,1163
4,104891030,104891264,del,NA19398,0,,234
4,32965210,32966126,del,HG01124,0,,916
4,22601328,22607073,del,NA19056,0,,5745
4,33846005,33846338,del,NA19238,0,,333
4,33299859,33304013,del,HG00736,0,,4154
4,132645195,132650153,del,HG01187,0,,4958
4,1609614,1611513,del,NA19461,0,,1899
4,139878887,139883446,del,HG01061,0,,4559
4,164516247,164516390,del,HG01136,0,,143
4,244764,248860,del,NA19448,0,,4096
4,93857116,93859722,del,NA18566,0,,2606
4,66421309,66421553,del,NA18871,0,,244
4,64513,67887,del,NA19473,0,,3374
4,73675182,73676459,del,NA19455,0,,1277
4,70388911,70390240,del,NA19007,0,,1329
4,186214768,186222480,del,HG01102,0,,7712
4,90559284,90563595,del,NA19717,0,,4311
4,7497966,7498872,del,HG00180,0,,906
4,32781895,32787669,del,HG01108,0,,5774
4,122428895,122429382,del,NA18510,0,,487
4,136408306,136412205,del,NA19789,0,,3899
4,153095666,153096265,del,HG00237,0,,599
4,88920782,88921244,del,NA18627,0,,462
4,27412024,27414522,del,HG00323,0,,2498
4,188149330,188161669,del,NA19455,0,,12339
4,39968426,39969861,del,NA19819,0,,1435
4,74555479,74556998,del,NA19213,0,,1519
4,38204554,38205701,del,NA18622,0,,1147
4,34783374,34828880,del,NA19835,0,,45506
4,44032143,44032385,del,HG01173,0,,242
4,1024660,1026264,del,NA18596,0,,1604
4,69669226,69708875,del,NA20787,0,,39649
4,49137770,49139002,del,NA19779,0,,1232
4,175625316,175627222,del,NA19716,0,,1906
4,181801696,181803468,del,HG01047,0,,1772
4,49133929,49139056,del,HG00311,0,,5127
4,38264305,38265447,del,NA18856,0,,1142
4,92899466,92905872,del,HG00418,0,,6406
4,20556633,20566023,del,NA19901,0,,9390
4,15739213,15739433,del,NA18517,0,,220
4,18992206,19000918,del,NA19430,0,,8712
4,38811009,38864362,del,NA19473,0,,53353
4,105057295,105244853,del,HG00313,0,,187558
4,26257142,26258944,del,NA18542,0,,1802
4,9457929,9482257,del,HG01384,0,,24328
4,110840738,110845736,del,NA19985,0,,4998
4,103204686,103204797,del,HG00173,0,,111
4,186625539,186625877,del,NA19920,0,,338
4,3601128,3601393,del,NA20769,0,,265
4,79255741,79258149,del,NA07048,0,,2408
4,98208685,98219593,del,NA19355,0,,10908
4,120600348,120606515,del,NA18606,0,,6167
4,40024915,40026281,del,NA19066,0,,1366
4,7376829,7378033,del,NA18535,0,,1204
4,124256361,124260018,del,NA19054,0,,3657
4,39539166,39539866,del,HG00122,0,,700
4,136508241,136511660,del,NA18853,0,,3419
4,63665212,63698140,del,HG00672,0,,32928
4,111655211,111655524,del,NA19108,0,,313
4,119126166,119130372,del,NA18948,0,,4206
4,40622592,40628833,del,NA18635,0,,6241
4,142422200,142422575,del,NA19332,0,,375
4,179043377,179044053,del,NA19404,0,,676
4,127512838,127517946,del,HG00611,0,,5108
4,73529078,73535499,del,NA19921,0,,6421
4,184985546,184989356,del,NA18522,0,,3810
4,35856313,35856595,del,NA19452,0,,282
4,162380916,162381522,del,HG01492,0,,606
4,31285626,31287300,del,NA19661,0,,1674
4,52684549,52685200,del,NA19147,0,,651
4,141926944,141927232,del,NA20770,0,,288
4,140528273,140530893,del,NA19116,0,,2620
4,73831248,73831820,del,NA20519,0,,572
4,168541284,168541887,del,NA20532,0,,603
4,103778932,103781084,del,HG00127,0,,2152
4,175477274,175507057,del,HG00566,0,,29783
4,86291341,86294600,del,NA19682,0,,3259
4,10392516,10400722,del,HG01516,0,,8206
4,24782775,24783625,del,NA18579,0,,850
4,91373,96776,del,NA19651,0,,5403
4,136458706,136459728,del,NA19099,0,,1022
4,165203039,165206215,del,HG00662,0,,3176
4,179818534,179820693,del,NA18570,0,,2159
4,46853163,46861541,del,NA19707,0,,8378
4,1557731,1557941,del,HG00336,0,,210
4,7797742,7799157,del,HG01052,0,,1415
4,28511981,28513202,del,NA19235,0,,1221
4,122234711,122234857,del,HG00313,0,,146
4,60878179,60890506,del,NA19428,0,,12327
4,183472273,183473069,del,HG01342,0,,796
4,104660559,104665303,del,HG01070,0,,4744
4,123782298,123782785,del,NA12342,0,,487
4,119124766,119130022,del,NA12275,0,,5256
4,169675779,169677144,del,HG00443,0,,1365
4,35848002,35856168,del,NA19471,0,,8166
4,3600499,3600814,del,NA19430,0,,315
4,31914228,31916307,del,NA19054,0,,2079
4,39424491,39426358,del,NA19373,0,,1867
4,70124316,70138522,del,NA19347,0,,14206
4,64694516,64716422,del,HG00372,0,,21906
4,166895278,166895589,del,NA19359,0,,311
4,64032186,64032558,del,NA20801,0,,372
4,167669317,167670545,del,NA19436,0,,1228
4,38456421,38468094,del,HG01491,0,,11673
4,168418308,168424009,del,HG00684,0,,5701
4,1559296,1559441,del,HG01351,0,,145
4,9506495,9509015,del,HG00543,0,,2520
4,146919578,146927740,del,HG00141,0,,8162
4,92756672,92760661,del,NA19381,0,,3989
4,42763516,42769722,del,NA20534,0,,6206
4,106785613,106805660,del,HG00419,0,,20047
4,49128051,49135442,del,NA18619,0,,7391
4,111296409,111301569,del,NA18907,0,,5160
4,170278460,170278881,del,NA18611,0,,421
4,163954428,163957836,del,NA19713,0,,3408
4,70331442,70334260,del,NA19712,0,,2818
4,40024958,40026571,del,HG01102,0,,1613
4,1501535,1501702,del,NA11919,0,,167
4,65819726,65841066,del,NA18501,0,,21340
4,123325836,123328276,del,HG01083,0,,2440
4,165560700,165564831,del,NA19900,0,,4131
4,120963563,120965119,del,NA19316,0,,1556
4,151049159,151053338,del,NA19921,0,,4179
4,146439016,146440422,del,NA20792,0,,1406
4,694767,695837,del,NA19920,0,,1070
4,30683246,30683435,del,HG00403,0,,189
4,108063167,108076045,del,NA20810,0,,12878
4,21369090,21376911,del,NA19398,0,,7821
4,70140075,70249115,del,NA18501,0,,109040
4,48922511,48925341,del,HG01136,0,,2830
4,40677094,40678112,del,NA18917,0,,1018
4,105146317,105146584,del,HG01251,0,,267
4,189024334,189027358,del,NA19072,0,,3024
4,123958955,124003353,del,HG00740,0,,44398
4,181755860,181756507,del,NA19383,0,,647
4,49128865,49145310,del,HG01080,0,,16445
4,264631,264763,del,NA18943,0,,132
4,90297958,90305021,del,NA18520,0,,7063
4,70260552,70279926,del,HG00275,0,,19374
4,107383065,107383198,del,NA19114,0,,133
4,67379714,67393410,del,NA18541,0,,13696
4,1059520,1059867,del,HG00141,0,,347
4,49125557,49139333,del,NA19009,0,,13776
4,165500502,165500618,del,NA19390,0,,116
4,106940467,106943265,del,NA18603,0,,2798
4,112882685,112894970,del,NA20753,0,,12285
4,45209633,45210724,del,NA18519,0,,1091
4,190386554,190388303,del,NA18856,0,,1749
4,161879216,161885422,del,NA20539,0,,6206
4,10912130,10912521,del,HG00342,0,,391
4,146438806,146440450,del,NA06986,0,,1644
4,2550430,2551369,del,HG01095,0,,939
4,163387733,163388468,del,NA19909,0,,735
4,7489686,7491586,del,HG00475,0,,1900
4,27776516,27776822,del,HG00577,0,,306
4,10392430,10402181,del,HG00326,0,,9751
4,190790381,190790523,del,NA18517,0,,142
4,170451948,170454847,del,NA18621,0,,2899
4,6513597,6513787,del,HG00584,0,,190
4,49517070,49521494,del,NA19371,0,,4424
4,131568290,131570217,del,HG00525,0,,1927
4,58887276,58888334,del,NA12005,0,,1058
4,108152710,108161946,del,NA19398,0,,9236
4,58425975,58435221,del,NA19397,0,,9246
4,115712624,115716896,del,HG00638,0,,4272
4,186469300,186470956,del,HG01079,0,,1656
4,165817773,165820888,del,NA19701,0,,3115
4,30239250,30242906,del,HG00131,0,,3656
4,136904311,136905936,del,HG00318,0,,1625
4,130170958,130171298,del,NA18545,0,,340
4,22047568,22071797,del,NA19720,0,,24229
4,148133812,148135102,del,NA19080,0,,1290
4,28780495,28785027,del,NA19681,0,,4532
4,156594200,156598303,del,NA19239,0,,4103
4,10119045,10119462,del,NA18549,0,,417
4,172867869,172868477,del,HG01140,0,,608
4,118505234,118505375,del,HG00584,0,,141
4,78627011,78631410,del,HG01080,0,,4399
4,189436666,189439072,del,NA19058,0,,2406
4,43321861,43322904,del,HG00479,0,,1043
4,162449266,162453122,del,NA19068,0,,3856
4,73627585,73631824,del,HG00732,0,,4239
4,157424018,157424904,del,NA19440,0,,886
4,127365967,127371169,del,NA19380,0,,5202
4,40010549,40010865,del,HG00557,0,,316
4,176109754,176111424,del,NA19661,0,,1670
4,146053207,146053750,del,NA18487,0,,543
4,142995926,142996582,del,HG01070,0,,656
4,138536880,138540649,del,NA19819,0,,3769
4,125016874,125020470,del,NA20542,0,,3596
4,37587070,37587195,del,HG00136,0,,125
4,59590186,59590536,del,HG00257,0,,350
4,75014350,75015211,del,NA12275,0,,861
4,178903649,178903876,del,HG00313,0,,227
4,189795545,189795987,del,HG00183,0,,442
4,18769416,18769861,del,NA18520,0,,445
4,7162833,7163072,del,NA18973,0,,239
4,60589089,60589207,del,HG01462,0,,118
4,164715900,164718252,del,NA19065,0,,2352
4,112237518,112242412,del,HG00178,0,,4894
4,190929916,190932422,del,HG01465,0,,2506
4,3565909,3566510,del,NA18635,0,,601
4,176500092,176503797,del,NA18609,0,,3705
4,189937946,190007357,del,NA18544,0,,69411
4,91350863,91353567,del,HG01136,0,,2704
4,11666561,11670693,del,NA19703,0,,4132
4,93562974,93578404,del,HG00260,0,,15430
4,108510901,108514770,del,HG00329,0,,3869
4,20195588,20196605,del,NA18973,0,,1017
4,158555755,158560456,del,NA18520,0,,4701
4,101960153,101961187,del,HG00180,0,,1034
4,63309483,63309967,del,NA19347,0,,484
4,6421990,6423508,del,NA20522,0,,1518
4,186005593,186007507,del,NA19461,0,,1914
4,96246488,96247596,del,HG00320,0,,1108
4,68352934,68353987,del,NA19334,0,,1053
4,53391065,53395404,del,HG01051,0,,4339
4,129698977,129699869,del,HG01107,0,,892
4,92339565,92346827,del,NA19355,0,,7262
4,190756979,190757344,del,NA19463,0,,365
4,126686127,126696744,del,HG00136,0,,10617
4,82584649,82585682,del,NA19383,0,,1033
4,137359057,137362892,del,NA20508,0,,3835
4,25580888,25581351,del,NA19391,0,,463
4,69373757,69491070,del,HG00651,0,,117313
4,2810316,2810822,del,HG00367,0,,506
4,163278376,163281512,del,NA18990,0,,3136
4,67537931,67538248,del,NA18563,0,,317
4,122232649,122232766,del,NA18542,0,,117
4,159800014,159801326,del,NA19444,0,,1312
4,52840968,52846915,del,NA18963,0,,5947
4,183986163,183988548,del,NA19384,0,,2385
4,49132068,49139493,del,NA19712,0,,7425
4,122387848,122388054,del,HG00584,0,,206
4,180063817,180064160,del,NA19443,0,,343
4,181135115,181138643,del,NA19147,0,,3528
4,167892551,167893740,del,NA12154,0,,1189
4,149426662,149429874,del,NA19102,0,,3212
4,8778620,8778849,del,HG00246,0,,229
4,9598481,9600878,del,NA18873,0,,2397
4,70434986,70436030,del,NA19711,0,,1044
4,152050274,152052869,del,HG00501,0,,2595
4,69597937,69598290,del,NA19359,0,,353
4,84363579,84363812,del,NA18523,0,,233
4,55433698,55434857,del,HG00662,0,,1159
4,178884820,178893154,del,NA19372,0,,8334
4,181041283,181043898,del,HG00182,0,,2615
4,90886058,90891344,del,NA19438,0,,5286
4,61999375,62001953,del,NA19747,0,,2578
4,34345620,34347687,del,NA19676,0,,2067
4,133865549,133871642,del,NA18949,0,,6093
4,109721052,109722215,del,HG00277,0,,1163
4,142105966,142106645,del,NA19703,0,,679
4,98110644,98110970,del,NA19331,0,,326
4,53212831,53213489,del,NA18522,0,,658
4,21447698,21467372,del,NA19439,0,,19674
4,64098143,64098469,del,NA18549,0,,326
4,57767189,57768492,del,HG00557,0,,1303
4,58486204,58490698,del,NA18909,0,,4494
4,168109566,168115222,del,HG00512,0,,5656
4,55808674,55808918,del,NA12890,0,,244
4,6140161,6143154,del,NA19346,0,,2993
4,3601117,3601342,del,NA20505,0,,225
4,98989747,98992132,del,NA19213,0,,2385
4,143329635,143330575,del,NA19726,0,,940
4,15658295,15658632,del,NA20818,0,,337
4,130626374,130626648,del,HG01177,0,,274
4,30057530,30057892,del,NA19398,0,,362
4,103781275,103783706,del,NA12830,0,,2431
4,171267675,171273889,del,HG00344,0,,6214
4,111625901,111626850,del,NA18633,0,,949
4,37180426,37184468,del,HG00112,0,,4042
4,128156466,128157294,del,NA19467,0,,828
4,49125321,49145871,del,NA19390,0,,20550
4,6682393,6685861,del,NA19679,0,,3468
4,188927559,188938196,del,HG01133,0,,10637
4,637532,642265,del,NA19383,0,,4733
4,20158183,20162366,del,NA19723,0,,4183
4,160864418,160871445,del,HG01350,0,,7027
4,42764066,42769872,del,HG01498,0,,5806
4,85125854,85133548,del,NA19435,0,,7694
4,133974883,134011840,del,HG00335,0,,36957
4,166614649,166615188,del,NA20531,0,,539
4,49132298,49133649,del,HG01357,0,,1351
4,104060208,104060318,del,HG00327,0,,110
4,189301921,189302159,del,NA19138,0,,238
4,91719230,91719646,del,NA19819,0,,416
4,128201391,128208307,del,NA19466,0,,6916
4,56457668,56461891,del,HG00262,0,,4223
4,35203616,35205522,del,HG00188,0,,1906
4,184474079,184474497,del,NA19452,0,,418
4,151874566,151886372,del,NA19190,0,,11806
4,182628339,182644015,del,NA18612,0,,15676
4,198780,199082,del,NA18909,0,,302
4,123973259,123976058,del,NA18982,0,,2799
4,56469386,56470440,del,NA19448,0,,1054
4,8395029,8395189,del,NA12829,0,,160
4,184655817,184658969,del,HG00278,0,,3152
4,61330106,61333186,del,HG01149,0,,3080
4,85459649,85463435,del,NA12155,0,,3786
4,44821433,44822263,del,HG00421,0,,830
4,152778524,152778992,del,HG01177,0,,468
4,120552216,120557122,del,NA19449,0,,4906
4,86704901,86707307,del,NA11933,0,,2406
4,76998328,76999814,del,NA19726,0,,1486
4,133180732,133182976,del,HG00613,0,,2244
4,68848043,68887967,del,HG00158,0,,39924
4,126497797,126502574,del,NA18565,0,,4777
4,59242627,59242962,del,HG00313,0,,335
4,117843896,117849415,del,NA20585,0,,5519
4,25711955,25735874,del,NA19009,0,,23919
4,84041371,84042769,del,HG00125,0,,1398
4,63669426,63676131,del,HG00313,0,,6705
4,48718275,48722238,del,NA19678,0,,3963
4,109607214,109608940,del,HG00637,0,,1726
4,1602956,1603669,del,NA19171,0,,713
4,178467225,178488474,del,NA18505,0,,21249
4,179240638,179246433,del,NA19625,0,,5795
4,144728826,144858373,del,HG00690,0,,129547
4,4154478,4156976,del,NA18868,0,,2498
4,83334557,83336121,del,NA19054,0,,1564
4,74475652,74479541,del,NA19080,0,,3889
4,116880216,116888269,del,NA19317,0,,8053
4,164613715,164614903,del,NA18963,0,,1188
4,179785423,179786238,del,HG01197,0,,815
4,178320279,178324684,del,NA18539,0,,4405
4,184674304,184675636,del,HG00476,0,,1332
4,34121761,34122400,del,NA18956,0,,639
4,105266280,105273834,del,NA19462,0,,7554
4,44323851,44331399,del,NA19257,0,,7548
4,33768894,33769069,del,NA18511,0,,175
4,180485006,180486580,del,NA19466,0,,1574
4,114147893,114149791,del,NA12400,0,,1898
4,154759333,154761215,del,NA20828,0,,1882
4,66394349,66430771,del,NA07037,0,,36422
4,100576692,100582551,del,HG00542,0,,5859
4,79632629,79634459,del,NA19703,0,,1830
4,84467381,84468648,del,HG00590,0,,1267
4,90740273,90741547,del,NA12154,0,,1274
4,15843155,15849242,del,NA18871,0,,6087
4,40568444,40575506,del,NA19916,0,,7062
4,172528790,172529837,del,NA19982,0,,1047
4,11935338,11936098,del,NA20582,0,,760
4,20474752,20474871,del,HG00583,0,,119
4,76479673,76479983,del,NA19397,0,,310
4,189039320,189050044,del,HG00692,0,,10724
4,3321506,3322463,del,HG00608,0,,957
4,119311166,119320629,del,NA19920,0,,9463
4,91803004,91804727,del,HG00361,0,,1723
4,83179778,83180090,del,HG00662,0,,312
4,45521411,45527675,del,NA18505,0,,6264
4,165982375,165982564,del,NA19172,0,,189
4,108788903,108790860,del,NA19114,0,,1957
4,188688730,188704090,del,NA11993,0,,15360
4,157861573,157868633,del,NA19373,0,,7060
4,141145851,141146143,del,NA11829,0,,292
4,143615996,143621345,del,NA19099,0,,5349
4,37554640,37555037,del,HG00273,0,,397
4,145316445,145319905,del,HG00692,0,,3460
4,161765950,161766214,del,HG00310,0,,264
4,114538761,114539064,del,NA12283,0,,303
4,70260303,70279676,del,NA19661,0,,19373
4,33085066,33085643,del,NA18523,0,,577
4,185545721,185545902,del,NA18566,0,,181
4,112569782,112571895,del,NA19788,0,,2113
4,9625116,9630322,del,NA18924,0,,5206
4,2060016,2062422,del,NA19338,0,,2406
4,26442765,26454138,del,NA19236,0,,11373
4,76743073,76744610,del,NA19236,0,,1537
4,23720766,23721822,del,HG00369,0,,1056
4,8956065,9490098,del,HG00501,0,,534033
4,144042349,144042845,del,NA19397,0,,496
4,168677436,168678193,del,NA19350,0,,757
4,28055558,28059179,del,NA19664,0,,3621
4,41227562,41232240,del,NA12058,0,,4678
4,93553545,93586825,del,HG00662,0,,33280
4,3491887,3493277,del,NA20812,0,,1390
4,110376945,110378773,del,NA20810,0,,1828
4,102526704,102536388,del,NA19102,0,,9684
4,188346045,188348547,del,NA19657,0,,2502
4,111009668,111013792,del,NA19909,0,,4124
4,93857016,93860122,del,HG00158,0,,3106
4,187002458,187003308,del,NA18615,0,,850
4,165204066,165208372,del,NA18555,0,,4306
4,133277278,133292588,del,NA19082,0,,15310
4,156222530,156223184,del,NA19461,0,,654
4,17543642,17569644,del,NA19072,0,,26002
4,184326516,184329222,del,NA19467,0,,2706
4,80360628,80362722,del,HG00592,0,,2094
4,144772726,144893723,del,HG00536,0,,120997
4,147865527,147866596,del,NA18615,0,,1069
4,7970767,7974994,del,HG00325,0,,4227
4,139347265,139347363,del,HG00284,0,,98
4,24472016,24475222,del,HG00690,0,,3206
4,178073450,178074073,del,NA18593,0,,623
4,21369090,21376907,del,NA18505,0,,7817
4,187213980,187214757,del,HG01171,0,,777
4,107840622,107840967,del,HG00244,0,,345
4,158621574,158642750,del,NA19347,0,,21176
4,109632930,109633070,del,HG01108,0,,140
4,53138268,53138618,del,NA18522,0,,350
4,102081191,102085248,del,HG01375,0,,4057
4,21457444,21458386,del,NA20341,0,,942
4,101595731,101597306,del,NA18593,0,,1575
4,6894837,6896047,del,HG00247,0,,1210
4,63516107,63517833,del,NA19247,0,,1726
4,109373552,109378005,del,NA19700,0,,4453
4,99287566,99289476,del,NA19064,0,,1910
4,49136188,49139797,del,NA18934,0,,3609
4,49125409,49145671,del,NA19780,0,,20262
4,130585145,130587969,del,NA19130,0,,2824
4,92073870,92084298,del,NA20801,0,,10428
4,3352660,3365358,del,HG00256,0,,12698
4,72517554,72520444,del,HG01351,0,,2890
4,115146987,115147212,del,NA18498,0,,225
4,15131556,15131862,del,NA20755,0,,306
4,29461100,29462119,del,NA19403,0,,1019
4,177802695,177803886,del,NA19473,0,,1191
4,14493950,14498805,del,HG00701,0,,4855
4,162054302,162063310,del,HG00148,0,,9008
4,5834879,5835192,del,NA18519,0,,313
4,7231657,7231994,del,HG01069,0,,337
4,91287467,91292326,del,NA18546,0,,4859
4,26639703,26640056,del,HG01492,0,,353
4,154386659,154389454,del,NA18574,0,,2795
4,20961595,20968343,del,NA19703,0,,6748
4,5317716,5319522,del,HG00464,0,,1806
4,23417120,23419576,del,HG01366,0,,2456
4,120236164,120237288,del,NA19375,0,,1124
4,31218701,31219430,del,NA19435,0,,729
4,9151312,9690369,del,HG01465,0,,539057
4,135818094,135838567,del,NA18910,0,,20473
4,212963,226958,del,HG00142,0,,13995
4,2629112,2629259,del,HG00437,0,,147
4,69959841,69960165,del,NA19726,0,,324
4,161879716,161885422,del,HG00151,0,,5706
4,9178782,9231988,del,NA18565,0,,53206
4,32329235,32329348,del,NA19723,0,,113
4,187850798,187850900,del,HG00707,0,,102
4,25055989,25061787,del,NA18510,0,,5798
4,103779034,103783573,del,NA11843,0,,4539
4,121856919,121861617,del,NA18951,0,,4698
4,1373550,1373663,del,HG00273,0,,113
4,159214265,159220054,del,HG00693,0,,5789
4,97078682,97081017,del,NA19078,0,,2335
4,134489557,134491462,del,HG00342,0,,1905
4,75401332,75410481,del,HG00638,0,,9149
4,123633910,123635364,del,HG00108,0,,1454
4,103329413,103332047,del,HG00463,0,,2634
4,88689151,88695814,del,NA19435,0,,6663
4,39584013,39589296,del,NA18522,0,,5283
4,26057662,26058229,del,NA20504,0,,567
4,175016215,175017018,del,HG01441,0,,803
4,103811963,103812391,del,NA18510,0,,428
4,86976374,86979951,del,NA07357,0,,3577
4,105486949,105487202,del,NA18573,0,,253
4,164179954,164180794,del,NA19818,0,,840
4,44019716,44027072,del,NA20127,0,,7356
4,64133361,64138513,del,NA19452,0,,5152
4,36917229,36922477,del,HG00281,0,,5248
4,136917707,136918741,del,HG00178,0,,1034
4,18942695,18975659,del,HG00151,0,,32964
4,187491085,187492767,del,HG00154,0,,1682
4,739116,742722,del,HG00281,0,,3606
4,24173272,24181571,del,NA18558,0,,8299
4,7496631,7499703,del,NA12003,0,,3072
4,138918670,138920559,del,NA18534,0,,1889
4,120865522,120866605,del,HG00280,0,,1083
4,49138145,49140306,del,HG01113,0,,2161
4,57761155,57762114,del,HG00373,0,,959
4,21151894,21152093,del,NA19704,0,,199
4,188041758,188043510,del,HG00114,0,,1752
4,134860507,134861456,del,NA20786,0,,949
4,28943956,28952804,del,NA18856,0,,8848
4,7524423,7524667,del,NA19373,0,,244
4,67914,130131,dup,HG02116,0,,62217
4,72279,204237,dup,HG02116,0,,131958
4,138870,148818,dup,HG01260,0,,9948
4,152769,183508,dup,HG01260,0,,30739
4,191270,254556,dup,HG02304,0,,63286
4,262616,285681,dup,HG02304,0,,23065
4,297194,398976,dup,HG02304,0,,101782
4,308401,399950,dup,HG02304,0,,91549
4,467496,499577,dup,HG02860,0,,32081
4,637458,642208,dup,HG00596,0,,4750
4,754376,832076,dup,NA19159,0,,77700
4,968425,1004663,dup,NA19043,0,,36238
4,2942151,3031844,dup,HG00732,0,,89693
4,2947345,2957532,dup,HG00732,0,,10187
4,2959740,3021623,dup,HG00732,0,,61883
4,2974249,3013838,dup,HG00732,0,,39589
4,3060201,3069689,dup,HG01060,0,,9488
4,3446697,3451946,dup,HG01596,0,,5249
4,3467434,3474409,dup,HG00382,0,,6975
4,3599563,3715752,dup,NA18983,0,,116189
4,3601813,3701023,dup,NA18969,0,,99210
4,3906095,3993252,dup,HG01444,0,,87157
4,4025615,4080175,dup,HG01444,0,,54560
4,4061549,4108273,dup,HG01444,0,,46724
4,4108738,4121868,dup,HG00154,0,,13130
4,4124334,4152937,dup,HG00099,0,,28603
4,5250130,5322284,dup,HG03193,0,,72154
4,5762955,5781763,dup,HG03372,0,,18808
4,5895123,5898621,dup,HG01094,0,,3498
4,8649935,8660641,dup,HG01756,0,,10706
4,8965379,9052699,dup,HG00244,0,,87320
4,9104669,9125871,dup,HG00102,0,,21202
4,9126509,9157215,dup,HG00244,0,,30706
4,9370866,9410140,dup,HG00244,0,,39274
4,9418201,9457405,dup,HG00244,0,,39204
4,9457406,9481022,dup,HG00096,0,,23616
4,9485479,9514822,dup,HG00244,0,,29343
4,9535468,9605987,dup,HG00867,0,,70519
4,9619133,9632874,dup,HG00127,0,,13741
4,9636226,9718010,dup,HG01991,0,,81784
4,9652761,10491300,dup,HG03965,0,,838539
4,9711159,9733248,dup,HG03965,0,,22089
4,9723905,9838581,dup,HG03016,0,,114676
4,10030675,10127241,dup,HG03965,0,,96566
4,10181633,10195923,dup,HG00351,0,,14290
4,10195799,10205531,dup,HG00365,0,,9732
4,10204082,10209831,dup,HG03965,0,,5749
4,10233384,10327414,dup,HG03965,0,,94030
4,10325281,10338613,dup,NA19332,0,,13332
4,10349551,10384214,dup,HG03965,0,,34663
4,10392397,10402099,dup,HG00099,0,,9702
4,10401433,10443128,dup,HG03965,0,,41695
4,10477785,10520353,dup,NA18510,0,,42568
4,11489646,11523092,dup,HG01395,0,,33446
4,11625924,11820523,dup,HG00524,0,,194599
4,11881072,11907948,dup,HG01781,0,,26876
4,11915576,11954865,dup,HG01781,0,,39289
4,11968590,12100422,dup,HG01781,0,,131832
4,12123005,12231899,dup,HG01781,0,,108894
4,12338569,12351485,dup,HG00956,0,,12916
4,12935097,12952114,dup,HG03169,0,,17017
4,13261263,13291036,dup,HG01864,0,,29773
4,13686178,13696505,dup,NA12272,0,,10327
4,13986179,14032443,dup,HG01303,0,,46264
4,13987770,14033059,dup,HG01303,0,,45289
4,14420809,14477354,dup,HG03082,0,,56545
4,14425112,14465495,dup,HG01083,0,,40383
4,14687191,14732797,dup,NA19023,0,,45606
4,14687248,14794535,dup,NA19023,0,,107287
4,14687255,14803963,dup,NA19023,0,,116708
4,15702931,15711185,dup,HG02685,0,,8254
4,15911680,15956852,dup,HG04001,0,,45172
4,16370514,16406844,dup,HG01431,0,,36330
4,16371594,16406705,dup,HG00610,0,,35111
4,17722147,17737687,dup,NA18991,0,,15540
4,18776346,18788141,dup,HG00351,0,,11795
4,18932165,18987520,dup,HG01607,0,,55355
4,19956797,19967513,dup,HG04026,0,,10716
4,20006472,20017119,dup,HG03989,0,,10647
4,21302963,21322786,dup,HG02339,0,,19823
4,21303697,21319442,dup,HG02339,0,,15745
4,21344449,21359901,dup,HG01783,0,,15452
4,21557565,21581577,dup,HG00551,0,,24012
4,21558835,21696626,dup,HG00551,0,,137791
4,22052795,22072226,dup,HG01521,0,,19431
4,22601247,22605504,dup,HG00321,0,,4257
4,23532773,23668597,dup,NA20778,0,,135824
4,23554766,23562744,dup,NA20778,0,,7978
4,23649755,23718597,dup,NA18865,0,,68842
4,23683989,23707087,dup,NA18865,0,,23098
4,24091121,24096566,dup,HG01682,0,,5445
4,24644011,24705745,dup,HG03585,0,,61734
4,25221484,25237313,dup,NA18636,0,,15829
4,25555873,25580214,dup,HG01102,0,,24341
4,26249094,26257042,dup,HG00742,0,,7948
4,27263605,27401704,dup,HG01461,0,,138099
4,28796123,28840269,dup,HG00173,0,,44146
4,29034058,29040281,dup,HG00637,0,,6223
4,29122818,29144869,dup,NA18636,0,,22051
4,29288690,29297515,dup,HG00446,0,,8825
4,32074337,32114593,dup,HG03931,0,,40256
4,32077925,32098862,dup,HG03931,0,,20937
4,32137471,32271941,dup,HG01761,0,,134470
4,32327489,32349999,dup,HG01761,0,,22510
4,32649778,32823993,dup,HG04161,0,,174215
4,32660703,32692965,dup,HG04161,0,,32262
4,32703107,32742979,dup,NA19235,0,,39872
4,32739703,32823348,dup,HG04161,0,,83645
4,32847022,32868088,dup,HG04161,0,,21066
4,32940519,32948172,dup,HG03821,0,,7653
4,32985110,33015202,dup,HG01708,0,,30092
4,33016048,33023892,dup,HG01488,0,,7844
4,33299960,33304057,dup,HG00189,0,,4097
4,34158349,34176370,dup,HG03680,0,,18021
4,34587190,34613013,dup,HG01767,0,,25823
4,34670638,34688424,dup,HG02152,0,,17786
4,34781317,34849886,dup,HG00097,0,,68569
4,35254821,35272459,dup,NA19346,0,,17638
4,36113088,36185561,dup,NA21129,0,,72473
4,36161579,36174085,dup,NA21129,0,,12506
4,36511677,36599507,dup,NA18986,0,,87830
4,38524116,38557369,dup,NA19437,0,,33253
4,39353470,39361108,dup,HG00320,0,,7638
4,39407667,39414271,dup,HG00320,0,,6604
4,39428460,39435166,dup,HG00320,0,,6706
4,40505603,40569585,dup,NA19783,0,,63982
4,40679736,40781036,dup,HG00106,0,,101300
4,40841994,40850045,dup,HG03886,0,,8051
4,41103908,41109328,dup,HG01479,0,,5420
4,41420042,41449896,dup,HG04022,0,,29854
4,42476539,42493596,dup,HG01977,0,,17057
4,44820879,44831657,dup,HG02371,0,,10778
4,44957256,44979732,dup,HG00281,0,,22476
4,44965351,45007354,dup,HG00281,0,,42003
4,44966225,45006225,dup,HG00281,0,,40000
4,44968880,45007637,dup,HG01708,0,,38757
4,45637493,45649678,dup,HG03028,0,,12185
4,45782683,45806729,dup,HG02471,0,,24046
4,47967712,47979948,dup,NA19082,0,,12236
4,48865580,48890630,dup,NA19654,0,,25050
4,49489589,49512133,dup,HG00103,0,,22544
4,52984888,53038240,dup,HG01323,0,,53352
4,52987817,53022526,dup,HG01323,0,,34709
4,53026716,53039082,dup,HG01323,0,,12366
4,53144370,53187629,dup,HG00409,0,,43259
4,53720289,53732094,dup,NA19320,0,,11805
4,54039660,54074525,dup,HG01847,0,,34865
4,54068129,54082115,dup,HG01880,0,,13986
4,54592328,54603344,dup,HG00114,0,,11016
4,55438695,55516899,dup,HG02537,0,,78204
4,55439051,55490568,dup,HG02537,0,,51517
4,55666616,55677517,dup,HG03691,0,,10901
4,56427819,56501917,dup,NA20759,0,,74098
4,56509083,56696187,dup,NA20759,0,,187104
4,57061042,57070922,dup,HG00403,0,,9880
4,57599737,57617826,dup,HG00478,0,,18089
4,58045298,58099135,dup,HG00256,0,,53837
4,58049312,58104458,dup,HG01170,0,,55146
4,58273121,58278212,dup,HG03228,0,,5091
4,58727143,58740309,dup,NA19651,0,,13166
4,59439717,59460138,dup,HG00650,0,,20421
4,59468329,59504527,dup,HG00650,0,,36198
4,59723394,59734326,dup,NA18934,0,,10932
4,59972453,59988195,dup,HG00099,0,,15742
4,60324149,60330809,dup,NA19449,0,,6660
4,60394181,60454488,dup,HG00428,0,,60307
4,60542723,60546328,dup,HG00458,0,,3605
4,61112838,61141173,dup,HG01853,0,,28335
4,61275280,61360920,dup,HG03729,0,,85640
4,61510852,61536160,dup,NA19351,0,,25308
4,61896442,61908439,dup,HG01447,0,,11997
4,63342914,63353874,dup,HG01507,0,,10960
4,63598847,63622719,dup,HG03687,0,,23872
4,63808032,63888301,dup,HG03692,0,,80269
4,63889117,64139415,dup,HG03692,0,,250298
4,64107613,64139122,dup,HG02854,0,,31509
4,64133825,64153198,dup,HG00105,0,,19373
4,64167997,64203905,dup,HG03692,0,,35908
4,64245506,64253694,dup,NA19207,0,,8188
4,64816864,64826964,dup,NA18990,0,,10100
4,65147694,65162402,dup,HG00634,0,,14708
4,65428658,65434650,dup,HG00171,0,,5992
4,65708699,65724954,dup,HG02562,0,,16255
4,66021420,66041376,dup,NA19043,0,,19956
4,66046722,66067226,dup,HG01817,0,,20504
4,66067202,66072209,dup,HG03815,0,,5007
4,66588829,66625528,dup,HG00257,0,,36699
4,66589810,66645309,dup,HG00257,0,,55499
4,67382955,67560904,dup,HG00181,0,,177949
4,67659492,67677354,dup,HG01183,0,,17862
4,67659567,67674979,dup,HG02419,0,,15412
4,68239524,68285517,dup,HG02715,0,,45993
4,68789942,68886328,dup,NA18517,0,,96386
4,68791289,69008212,dup,NA18517,0,,216923
4,69491562,69535052,dup,HG03127,0,,43490
4,69676622,69712873,dup,HG02716,0,,36251
4,69862911,69876366,dup,HG01447,0,,13455
4,70020554,70063889,dup,HG01890,0,,43335
4,70078151,70124435,dup,HG00233,0,,46284
4,70129985,70204226,dup,HG00099,0,,74241
4,70232361,70245651,dup,HG00734,0,,13290
4,70257855,70276678,dup,HG00671,0,,18823
4,70289035,70383630,dup,HG03729,0,,94595
4,70322435,70402928,dup,HG03729,0,,80493
4,70542446,70553107,dup,HG00130,0,,10661
4,70813352,70862479,dup,HG00654,0,,49127
4,70959706,71082055,dup,HG01088,0,,122349
4,71554834,71564898,dup,HG01048,0,,10064
4,71735444,71752503,dup,NA18873,0,,17059
4,72514575,72597012,dup,HG02786,0,,82437
4,72670675,72674624,dup,HG01527,0,,3949
4,73504021,73522235,dup,HG02215,0,,18214
4,73621183,73631060,dup,HG00290,0,,9877
4,73810705,73953440,dup,HG02699,0,,142735
4,73818584,74058231,dup,HG02699,0,,239647
4,74433105,74446513,dup,HG03439,0,,13408
4,76265714,76326221,dup,HG04212,0,,60507
4,78277507,78288949,dup,HG00403,0,,11442
4,78969542,78983663,dup,HG03866,0,,14121
4,79016149,79041114,dup,HG02389,0,,24965
4,79149602,79163126,dup,NA19328,0,,13524
4,79178707,79223620,dup,NA18978,0,,44913
4,80261935,80265749,dup,HG02881,0,,3814
4,80857048,80887833,dup,HG02716,0,,30785
4,80865155,80895489,dup,HG02716,0,,30334
4,81544466,81709984,dup,NA20299,0,,165518
4,81544897,81597336,dup,NA20299,0,,52439
4,81740416,82140390,dup,NA20299,0,,399974
4,81936177,81952354,dup,HG01810,0,,16177
4,82169616,82201938,dup,NA20299,0,,32322
4,82206918,82226672,dup,NA20299,0,,19754
4,82236261,82362284,dup,NA20299,0,,126023
4,82382847,82441791,dup,NA20299,0,,58944
4,82443913,82552181,dup,NA20299,0,,108268
4,82462615,82504581,dup,HG00513,0,,41966
4,82488804,82551040,dup,NA20299,0,,62236
4,83078995,83093380,dup,HG03857,0,,14385
4,83635896,83641048,dup,HG00641,0,,5152
4,84215400,84246367,dup,HG01176,0,,30967
4,84224905,84233635,dup,HG01176,0,,8730
4,84341111,84391392,dup,HG02675,0,,50281
4,86314678,86318022,dup,HG02600,0,,3344
4,87478673,87535532,dup,NA18526,0,,56859
4,87546178,87623154,dup,NA18526,0,,76976
4,88080994,88199951,dup,HG03240,0,,118957
4,88183033,88231720,dup,HG01989,0,,48687
4,88210558,88330809,dup,HG03240,0,,120251
4,88344022,88436933,dup,HG03240,0,,92911
4,88443571,88509821,dup,HG03240,0,,66250
4,88530521,88643345,dup,HG03240,0,,112824
4,88839127,88842867,dup,HG01786,0,,3740
4,89021864,89070121,dup,NA12234,0,,48257
4,90101722,90107794,dup,HG00100,0,,6072
4,91135700,91149074,dup,NA18553,0,,13374
4,92280387,92285260,dup,HG00253,0,,4873
4,92885564,92943844,dup,HG01816,0,,58280
4,92893062,92934577,dup,HG01816,0,,41515
4,92910671,93048663,dup,HG02073,0,,137992
4,92976171,93039727,dup,HG02019,0,,63556
4,93099792,93423943,dup,HG03871,0,,324151
4,93227755,93268209,dup,HG03871,0,,40454
4,93276878,93466839,dup,HG03871,0,,189961
4,93561672,93578300,dup,HG00260,0,,16628
4,93777871,93874952,dup,HG00267,0,,97081
4,93810016,93855451,dup,HG00267,0,,45435
4,93862122,93893631,dup,HG00267,0,,31509
4,93894901,93913512,dup,HG00267,0,,18611
4,94048322,94110625,dup,HG02238,0,,62303
4,94048329,94112567,dup,HG02238,0,,64238
4,94538494,94558881,dup,HG00610,0,,20387
4,94762685,94776395,dup,HG03695,0,,13710
4,95711762,95764130,dup,HG00141,0,,52368
4,96619718,96648400,dup,NA20543,0,,28682
4,97032376,97042375,dup,NA19669,0,,9999
4,97394402,97459163,dup,NA20872,0,,64761
4,97740423,97753992,dup,HG01806,0,,13569
4,97904736,97931805,dup,HG03785,0,,27069
4,97913291,97930630,dup,HG03785,0,,17339
4,98238422,98280469,dup,HG02885,0,,42047
4,98354318,98359087,dup,HG00096,0,,4769
4,98602780,98672841,dup,HG00436,0,,70061
4,98629277,98677041,dup,NA19159,0,,47764
4,98705546,98760119,dup,HG03949,0,,54573
4,98953798,98965057,dup,HG00185,0,,11259
4,99813410,99817170,dup,HG00097,0,,3760
4,99931864,99942410,dup,NA20845,0,,10546
4,100532501,100545851,dup,HG03012,0,,13350
4,100682129,100696022,dup,HG00118,0,,13893
4,101079193,101106326,dup,HG00559,0,,27133
4,101452234,101598357,dup,HG03999,0,,146123
4,101630505,101791585,dup,HG03999,0,,161080
4,101873746,101973538,dup,HG03999,0,,99792
4,102748810,102752782,dup,HG00109,0,,3972
4,102791534,102834965,dup,NA19206,0,,43431
4,102876202,102886749,dup,NA19206,0,,10547
4,104565162,104575796,dup,NA19190,0,,10634
4,105062222,105119995,dup,NA20905,0,,57773
4,105546081,105562948,dup,HG03366,0,,16867
4,105603431,105732235,dup,HG03366,0,,128804
4,105744959,105988099,dup,HG03366,0,,243140
4,106009682,106056577,dup,HG03366,0,,46895
4,106066654,106118399,dup,HG03366,0,,51745
4,107023965,107048931,dup,HG01342,0,,24966
4,107065375,107123050,dup,HG01342,0,,57675
4,107081818,107118786,dup,HG01342,0,,36968
4,107281060,107396380,dup,HG01334,0,,115320
4,108511012,108514761,dup,HG00103,0,,3749
4,108527901,108559162,dup,HG02508,0,,31261
4,108547530,108699927,dup,NA20827,0,,152397
4,108547846,108627420,dup,NA20827,0,,79574
4,109487071,109496312,dup,HG04171,0,,9241
4,109550772,109573669,dup,HG01365,0,,22897
4,112237343,112242388,dup,HG00097,0,,5045
4,112613200,112731682,dup,HG03681,0,,118482
4,114130617,114143214,dup,NA21143,0,,12597
4,114573062,114612690,dup,HG00654,0,,39628
4,114643915,114774918,dup,HG00654,0,,131003
4,115074014,115090368,dup,HG02736,0,,16354
4,115434144,115584277,dup,HG03672,0,,150133
4,115441560,115492098,dup,HG03672,0,,50538
4,115507932,115513687,dup,HG00100,0,,5755
4,115521733,115581575,dup,HG03672,0,,59842
4,116557438,116633671,dup,HG00183,0,,76233
4,116638468,116652944,dup,HG02772,0,,14476
4,116667271,116694814,dup,HG00183,0,,27543
4,116685736,116719106,dup,HG00183,0,,33370
4,116724919,116730031,dup,HG00183,0,,5112
4,116775190,116978184,dup,HG00183,0,,202994
4,116976688,117008393,dup,HG00183,0,,31705
4,117012519,117244731,dup,NA19664,0,,232212
4,117303631,117353051,dup,NA19664,0,,49420
4,117306095,117313500,dup,NA19664,0,,7405
4,117334375,117412779,dup,NA19664,0,,78404
4,117438966,117444268,dup,HG00554,0,,5302
4,117456569,117500496,dup,NA19664,0,,43927
4,117523054,117545955,dup,NA19664,0,,22901
4,117525418,117544362,dup,NA19350,0,,18944
4,117552781,117586921,dup,NA19664,0,,34140
4,117605400,117610159,dup,HG03055,0,,4759
4,117616840,117649154,dup,NA19664,0,,32314
4,117617250,117665813,dup,NA19664,0,,48563
4,117672013,117692762,dup,HG04195,0,,20749
4,118591886,118604217,dup,HG02006,0,,12331
4,118875076,118882142,dup,NA19764,0,,7066
4,119278198,119311110,dup,NA19355,0,,32912
4,119411450,119504748,dup,HG00096,0,,93298
4,119870587,119877924,dup,HG00684,0,,7337
4,119952698,119958275,dup,HG00351,0,,5577
4,119981892,120126520,dup,HG03521,0,,144628
4,120006531,120042445,dup,HG03521,0,,35914
4,120226420,120248758,dup,HG02155,0,,22338
4,120427507,120537068,dup,NA19394,0,,109561
4,120542195,120702423,dup,NA19394,0,,160228
4,121294886,121307060,dup,HG03646,0,,12174
4,122233034,122239134,dup,NA20512,0,,6100
4,122342926,122420978,dup,HG02014,0,,78052
4,122732919,122739652,dup,HG00119,0,,6733
4,122901628,123104964,dup,HG03789,0,,203336
4,122903766,122950049,dup,HG03789,0,,46283
4,123184272,123246000,dup,HG03789,0,,61728
4,123960700,124000402,dup,HG01161,0,,39702
4,124249687,124307954,dup,NA19007,0,,58267
4,124249751,124371440,dup,NA19007,0,,121689
4,124383602,124505931,dup,NA19007,0,,122329
4,124430170,124460109,dup,HG02485,0,,29939
4,124462885,124559974,dup,NA19007,0,,97089
4,124511497,124598409,dup,NA19007,0,,86912
4,124612017,124734932,dup,NA19007,0,,122915
4,124763416,124918164,dup,NA19007,0,,154748
4,124925493,124954156,dup,NA19007,0,,28663
4,124926445,125206843,dup,NA19007,0,,280398
4,125273850,125330964,dup,HG03652,0,,57114
4,125289229,125323323,dup,HG03652,0,,34094
4,125322874,125333029,dup,HG02502,0,,10155
4,125337230,125374075,dup,HG04099,0,,36845
4,126145649,126159919,dup,HG00262,0,,14270
4,126298673,126308805,dup,NA19090,0,,10132
4,126606239,126624524,dup,NA12716,0,,18285
4,126671744,126729305,dup,NA20529,0,,57561
4,126788470,126796817,dup,NA18638,0,,8347
4,126933933,127021765,dup,HG01918,0,,87832
4,126966229,126984584,dup,NA18548,0,,18355
4,127043844,127063586,dup,HG01918,0,,19742
4,127428048,127701663,dup,HG01859,0,,273615
4,129628697,129778365,dup,NA19780,0,,149668
4,129736804,129778980,dup,NA19780,0,,42176
4,129770766,129863713,dup,NA11919,0,,92947
4,129772465,129941772,dup,NA11919,0,,169307
4,130780605,130806442,dup,HG02600,0,,25837
4,130880366,130883963,dup,HG02600,0,,3597
4,130933055,130992475,dup,HG03598,0,,59420
4,131248973,131280990,dup,HG01204,0,,32017
4,131325523,131393538,dup,HG01204,0,,68015
4,131458671,131541373,dup,HG01204,0,,82702
4,131712002,131773148,dup,HG00654,0,,61146
4,131802577,131810097,dup,HG03021,0,,7520
4,131943806,131992377,dup,NA12751,0,,48571
4,131944949,132041364,dup,HG01137,0,,96415
4,131999980,132030688,dup,HG01668,0,,30708
4,132019849,132091230,dup,HG01668,0,,71381
4,132052458,132181902,dup,HG01137,0,,129444
4,132087171,132188325,dup,HG01668,0,,101154
4,132182617,132206529,dup,NA12751,0,,23912
4,132184376,132365626,dup,HG00265,0,,181250
4,132222180,132283562,dup,HG01668,0,,61382
4,132287363,132319515,dup,HG01668,0,,32152
4,132334199,132358426,dup,HG01668,0,,24227
4,132431456,132435035,dup,HG01512,0,,3579
4,133002691,133006285,dup,HG03311,0,,3594
4,134458216,134537453,dup,HG03437,0,,79237
4,134485132,134530128,dup,HG03437,0,,44996
4,134577764,134595342,dup,HG04182,0,,17578
4,134921112,135070247,dup,HG01357,0,,149135
4,135096151,135189805,dup,HG01357,0,,93654
4,135819042,135838371,dup,HG02419,0,,19329
4,135899700,135923202,dup,HG01191,0,,23502
4,136388551,136451990,dup,NA20818,0,,63439
4,136442616,136497379,dup,NA20818,0,,54763
4,136467516,136562791,dup,NA20818,0,,95275
4,136492565,136519331,dup,HG02298,0,,26766
4,136508432,136547494,dup,NA20818,0,,39062
4,137484383,137488242,dup,HG03593,0,,3859
4,138767454,138779670,dup,NA21113,0,,12216
4,140168370,140173767,dup,HG03698,0,,5397
4,140614080,140872746,dup,HG03914,0,,258666
4,140614544,140751263,dup,HG03914,0,,136719
4,140714693,140738552,dup,HG03078,0,,23859
4,140714807,140738115,dup,HG03078,0,,23308
4,142765052,142776579,dup,HG01845,0,,11527
4,143231238,143295706,dup,HG02339,0,,64468
4,143391288,143404406,dup,HG02570,0,,13118
4,144013672,144024537,dup,HG03109,0,,10865
4,144625606,144645863,dup,HG00099,0,,20257
4,144702493,144719515,dup,HG03646,0,,17022
4,144719111,144753693,dup,HG01398,0,,34582
4,144752553,144780573,dup,HG01986,0,,28020
4,144779883,144844102,dup,HG01948,0,,64219
4,144835039,144886417,dup,HG01242,0,,51378
4,144956345,145017148,dup,HG01241,0,,60803
4,144996627,145055060,dup,HG03385,0,,58433
4,145021907,145038870,dup,NA20867,0,,16963
4,145045139,145067229,dup,HG01670,0,,22090
4,145333607,145366865,dup,HG01795,0,,33258
4,145929141,145937503,dup,HG02508,0,,8362
4,148128505,148134036,dup,HG03460,0,,5531
4,149002444,149030154,dup,NA20510,0,,27710
4,150818921,150833511,dup,NA12889,0,,14590
4,151718467,151721902,dup,HG02215,0,,3435
4,151876054,151885557,dup,HG01061,0,,9503
4,152015208,152114899,dup,NA20520,0,,99691
4,152404852,152417725,dup,NA19068,0,,12873
4,152990441,152993939,dup,HG00404,0,,3498
4,153468136,153581029,dup,HG02348,0,,112893
4,153566854,153607128,dup,HG00266,0,,40274
4,153566885,153599237,dup,HG02348,0,,32352
4,153601663,153606278,dup,HG03875,0,,4615
4,155259754,155318376,dup,HG02736,0,,58622
4,155281116,155315088,dup,HG02736,0,,33972
4,157397723,157445317,dup,NA20541,0,,47594
4,157644125,157654865,dup,HG01398,0,,10740
4,157644386,157656776,dup,HG01398,0,,12390
4,157880098,158083853,dup,NA18610,0,,203755
4,157897008,157993983,dup,NA18610,0,,96975
4,158159120,158225043,dup,HG03777,0,,65923
4,158164068,158223281,dup,HG03777,0,,59213
4,158220720,158286488,dup,NA18610,0,,65768
4,158248476,158279874,dup,NA18610,0,,31398
4,158621502,158656642,dup,HG01064,0,,35140
4,159282288,159349020,dup,NA19086,0,,66732
4,159358655,159510780,dup,NA19086,0,,152125
4,159578438,159593114,dup,HG04090,0,,14676
4,160699203,160795913,dup,NA20296,0,,96710
4,160948605,160956519,dup,HG00127,0,,7914
4,160978756,160998652,dup,HG01048,0,,19896
4,161026793,161080534,dup,HG00105,0,,53741
4,161118946,161227781,dup,HG01871,0,,108835
4,161363398,161393578,dup,HG02317,0,,30180
4,161406467,161494321,dup,HG02317,0,,87854
4,161559462,161574718,dup,HG04238,0,,15256
4,161567868,161584158,dup,NA19077,0,,16290
4,161860422,161878760,dup,HG00443,0,,18338
4,161861680,161933800,dup,HG00443,0,,72120
4,161879011,161884782,dup,HG00100,0,,5771
4,161888083,161932126,dup,HG00443,0,,44043
4,161956249,162005433,dup,NA19056,0,,49184
4,162054402,162063246,dup,HG00148,0,,8844
4,162267492,162317421,dup,HG03861,0,,49929
4,163065307,163136729,dup,NA21102,0,,71422
4,163070256,163235211,dup,NA21102,0,,164955
4,163271221,163278159,dup,HG01709,0,,6938
4,163284113,163390348,dup,NA21102,0,,106235
4,163426636,163542410,dup,NA21102,0,,115774
4,163672318,163695593,dup,NA21102,0,,23275
4,163714056,163854750,dup,NA21102,0,,140694
4,163862151,164019924,dup,HG00275,0,,157773
4,164805358,164820846,dup,HG01139,0,,15488
4,165473513,165483927,dup,NA19707,0,,10414
4,165560594,165564665,dup,NA19900,0,,4071
4,165589321,165597910,dup,HG02778,0,,8589
4,165804983,165824115,dup,HG03452,0,,19132
4,165862976,165883379,dup,HG01272,0,,20403
4,166878854,166896919,dup,NA20849,0,,18065
4,167039624,167055716,dup,HG02691,0,,16092
4,167155893,167193851,dup,HG01777,0,,37958
4,167220653,167238074,dup,HG01869,0,,17421
4,167247336,167269458,dup,HG03511,0,,22122
4,167875235,167892738,dup,NA18505,0,,17503
4,168056972,168086065,dup,NA18505,0,,29093
4,168109061,168115010,dup,HG00137,0,,5949
4,168119173,168182725,dup,HG03693,0,,63552
4,168127632,168171592,dup,HG03693,0,,43960
4,168795089,168857734,dup,NA10851,0,,62645
4,168797002,168811988,dup,HG03304,0,,14986
4,168807910,168817347,dup,HG01113,0,,9437
4,168813075,168991760,dup,NA10851,0,,178685
4,168817869,168844126,dup,HG01113,0,,26257
4,168971449,169109454,dup,HG03858,0,,138005
4,169468551,169567205,dup,HG03858,0,,98654
4,169995368,169999377,dup,NA18618,0,,4009
4,171158608,171265457,dup,HG02009,0,,106849
4,171246993,171285812,dup,HG02009,0,,38819
4,171823539,171855838,dup,HG01142,0,,32299
4,171829277,171921524,dup,HG01142,0,,92247
4,171849786,171871782,dup,HG01142,0,,21996
4,171860435,172075914,dup,HG03594,0,,215479
4,171868449,171924744,dup,HG03594,0,,56295
4,172238077,172247826,dup,HG03594,0,,9749
4,172293187,172299905,dup,HG03054,0,,6718
4,172797986,172810557,dup,HG02058,0,,12571
4,172966883,172988432,dup,NA20772,0,,21549
4,173557112,173666331,dup,HG01804,0,,109219
4,173559219,173651858,dup,HG01804,0,,92639
4,173892521,173912725,dup,HG04061,0,,20204
4,175417820,175433735,dup,HG01308,0,,15915
4,175700315,175711068,dup,HG01920,0,,10753
4,175708569,175744199,dup,HG00728,0,,35630
4,175764366,175965438,dup,HG00131,0,,201072
4,175765062,175824678,dup,HG00131,0,,59616
4,175947047,176067900,dup,NA20859,0,,120853
4,176163982,176377488,dup,HG00131,0,,213506
4,176234083,176416901,dup,HG00131,0,,182818
4,176704140,176871620,dup,NA19731,0,,167480
4,176709469,176810561,dup,NA19731,0,,101092
4,176895707,177061366,dup,NA19731,0,,165659
4,177065909,177307632,dup,NA19731,0,,241723
4,177968009,178151230,dup,HG01878,0,,183221
4,178218700,178264443,dup,NA18997,0,,45743
4,178320142,178324707,dup,HG00513,0,,4565
4,178882176,179030375,dup,NA19914,0,,148199
4,179842152,179906199,dup,HG02973,0,,64047
4,179843013,179863304,dup,HG02973,0,,20291
4,180653892,180720232,dup,HG01513,0,,66340
4,180802895,180822471,dup,HG01392,0,,19576
4,180807894,180822110,dup,HG00740,0,,14216
4,180984842,181013022,dup,NA19449,0,,28180
4,181135058,181138561,dup,HG01107,0,,3503
4,181270080,181274486,dup,HG01915,0,,4406
4,181560221,181606838,dup,HG01678,0,,46617
4,183287917,183298075,dup,NA19428,0,,10158
4,184058558,184114964,dup,HG02223,0,,56406
4,184311776,184315213,dup,HG01047,0,,3437
4,184329251,184336931,dup,HG02223,0,,7680
4,184541105,184550838,dup,HG02069,0,,9733
4,184576453,184582385,dup,HG01619,0,,5932
4,185136308,185182280,dup,HG01098,0,,45972
4,185204727,185211726,dup,HG01098,0,,6999
4,185249066,185258342,dup,HG01098,0,,9276
4,185509628,185523601,dup,HG01098,0,,13973
4,185708914,185768956,dup,HG00266,0,,60042
4,185715341,185721883,dup,HG01098,0,,6542
4,185732415,185741502,dup,HG00142,0,,9087
4,185752243,185768247,dup,HG04001,0,,16004
4,185893703,185907949,dup,NA19648,0,,14246
4,185914020,185930486,dup,HG01098,0,,16466
4,186291769,186369721,dup,HG02232,0,,77952
4,186293201,186343210,dup,HG02232,0,,50009
4,186355235,186360334,dup,HG02232,0,,5099
4,186368770,186524214,dup,HG02477,0,,155444
4,186369389,186387600,dup,HG02477,0,,18211
4,186393283,186423013,dup,HG01513,0,,29730
4,186397626,186417734,dup,HG01513,0,,20108
4,186419353,186438808,dup,HG02477,0,,19455
4,186443491,186481402,dup,HG01048,0,,37911
4,186500378,186532901,dup,HG02477,0,,32523
4,186920045,187019047,dup,HG02727,0,,99002
4,186929857,187134219,dup,HG02727,0,,204362
4,186993156,187133773,dup,HG00736,0,,140617
4,187097733,187136114,dup,HG02727,0,,38381
4,187796921,187898304,dup,HG03750,0,,101383
4,187801907,187806156,dup,HG01393,0,,4249
4,187813659,187847757,dup,HG03750,0,,34098
4,187861323,187881644,dup,HG00472,0,,20321
4,187969394,188085531,dup,HG02232,0,,116137
4,187979131,188156196,dup,HG02232,0,,177065
4,188149756,188161903,dup,HG02010,0,,12147
4,188151347,188199616,dup,HG01977,0,,48269
4,188205431,188234325,dup,HG03103,0,,28894
4,188205525,188233429,dup,HG03103,0,,27904
4,188229801,188263073,dup,HG02232,0,,33272
4,188262427,188367289,dup,HG03012,0,,104862
4,188269470,188316304,dup,HG03012,0,,46834
4,188338918,188542771,dup,HG03012,0,,203853
4,188371672,188395075,dup,HG03012,0,,23403
4,188391224,188448744,dup,HG03012,0,,57520
4,188457027,188481277,dup,HG03012,0,,24250
4,188508591,188555481,dup,HG03012,0,,46890
4,188533503,188574584,dup,HG03012,0,,41081
4,188535967,188837647,dup,HG02477,0,,301680
4,188595853,188712095,dup,HG02477,0,,116242
4,188773860,188883781,dup,HG01250,0,,109921
4,188860649,188873655,dup,HG01250,0,,13006
4,188959518,189003384,dup,HG03604,0,,43866
4,188966135,188976718,dup,HG03604,0,,10583
4,189132960,189139537,dup,HG02568,0,,6577
4,189144135,189147152,dup,HG02568,0,,3017
4,189149615,189179008,dup,HG02568,0,,29393
4,189172110,189202202,dup,HG02568,0,,30092
4,189193566,189214438,dup,HG02568,0,,20872
4,189207817,189222251,dup,HG02568,0,,14434
4,189215981,189248171,dup,HG02568,0,,32190
4,189268364,189289663,dup,HG02568,0,,21299
4,189285416,189314246,dup,HG02568,0,,28830
4,189342472,189387184,dup,HG02568,0,,44712
4,189382662,189397520,dup,HG02568,0,,14858
4,189394906,189412661,dup,HG02568,0,,17755
4,189406721,189424425,dup,HG02568,0,,17704
4,189454832,189497427,dup,HG02568,0,,42595
4,189513494,189546363,dup,HG04100,0,,32869
4,189548348,189575485,dup,HG04100,0,,27137
4,189582417,189643679,dup,HG04100,0,,61262
4,189634769,189692806,dup,NA18560,0,,58037
4,189703976,189790512,dup,HG02658,0,,86536
4,189811806,189936032,dup,HG02658,0,,124226
4,189950725,190008943,dup,HG00592,0,,58218
4,190027606,190068721,dup,HG03589,0,,41115
4,190079054,190089907,dup,HG03589,0,,10853
4,190108895,190191423,dup,HG03589,0,,82528
4,190191671,190197843,dup,HG00097,0,,6172
4,190201737,190212459,dup,HG03046,0,,10722
4,190230986,190325353,dup,HG02571,0,,94367
4,190330507,190384449,dup,HG03046,0,,53942
4,190426952,190505988,dup,HG03046,0,,79036
4,190563190,190603293,dup,HG03589,0,,40103
4,190626112,190656168,dup,HG03589,0,,30056
4,190687565,190752430,dup,HG03589,0,,64865
4,190766366,190778812,dup,HG03589,0,,12446
4,190780063,190791596,dup,HG02580,0,,11533
4,190808807,190820458,dup,HG03589,0,,11651
5,25071670,25074407,del,NA18486,0,,2737
5,15719465,15720950,del,NA18933,0,,1485
5,1197576,1197709,del,HG00278,0,,133
5,108595074,108601121,del,HG00737,0,,6047
5,74166086,74167954,del,NA19461,0,,1868
5,34860374,34861249,del,NA18988,0,,875
5,84278939,84279461,del,NA18912,0,,522
5,15227972,15231026,del,NA19431,0,,3054
5,105576114,105590887,del,NA19713,0,,14773
5,119439590,119448275,del,HG00693,0,,8685
5,132314197,132314408,del,HG01069,0,,211
5,19334565,19346955,del,NA19681,0,,12390
5,109129204,109130303,del,NA20522,0,,1099
5,128276924,128306957,del,NA20519,0,,30033
5,56257512,56259716,del,NA20805,0,,2204
5,2332841,2332997,del,NA18873,0,,156
5,101693839,101694769,del,NA12718,0,,930
5,172468150,172468830,del,NA18989,0,,680
5,169865054,169869697,del,HG00126,0,,4643
5,5678756,5680987,del,NA19472,0,,2231
5,21515122,21519608,del,HG00736,0,,4486
5,66106656,66131113,del,HG00640,0,,24457
5,176387579,176390180,del,NA19679,0,,2601
5,12691127,12695637,del,NA19474,0,,4510
5,21252065,21252656,del,HG00158,0,,591
5,642088,642214,del,NA18530,0,,126
5,17691720,17699161,del,NA19429,0,,7441
5,178334580,178339125,del,NA18555,0,,4545
5,21141285,21144059,del,NA18947,0,,2774
5,178108256,178115093,del,NA19663,0,,6837
5,173747531,173747699,del,HG00272,0,,168
5,150790064,150792909,del,HG00524,0,,2845
5,103062349,103074005,del,HG00331,0,,11656
5,152765271,153107114,del,HG00533,0,,341843
5,13967885,13967974,del,HG00662,0,,89
5,114207714,114217034,del,NA19396,0,,9320
5,177221916,177236122,del,HG01518,0,,14206
5,122782164,122782611,del,NA19213,0,,447
5,155125098,155126133,del,HG00342,0,,1035
5,78277726,78278045,del,NA18610,0,,319
5,136626387,136627887,del,NA12546,0,,1500
5,176525013,176529223,del,NA19172,0,,4210
5,151580985,151583771,del,NA20802,0,,2786
5,99978680,99978983,del,HG01440,0,,303
5,125105612,125105894,del,NA18853,0,,282
5,156144814,156145945,del,NA19338,0,,1131
5,113978676,113978866,del,HG01080,0,,190
5,106019439,106239812,del,NA18637,0,,220373
5,98049769,98052063,del,NA19448,0,,2294
5,178740372,178740791,del,HG00699,0,,419
5,9734831,9735696,del,NA19209,0,,865
5,104271983,104310194,del,NA20753,0,,38211
5,83652956,83656330,del,NA19776,0,,3374
5,142618535,142619859,del,HG00138,0,,1324
5,134781542,134783351,del,NA18964,0,,1809
5,22117552,22122700,del,NA11918,0,,5148
5,26796698,26801896,del,HG00254,0,,5198
5,88043138,88043466,del,NA19716,0,,328
5,19277877,19287983,del,HG00553,0,,10106
5,159549264,159549792,del,NA20276,0,,528
5,24540524,24552026,del,HG01136,0,,11502
5,172823770,172826039,del,NA19383,0,,2269
5,3638416,3639122,del,HG00112,0,,706
5,140230566,140234922,del,NA12489,0,,4356
5,2712715,2715350,del,NA18520,0,,2635
5,17098427,17100130,del,HG01133,0,,1703
5,116179330,116187672,del,HG01052,0,,8342
5,104966909,104967262,del,NA11931,0,,353
5,9901263,9925556,del,HG01140,0,,24293
5,79902127,79904622,del,NA20802,0,,2495
5,112948779,112949791,del,HG00263,0,,1012
5,28813576,28813829,del,NA20517,0,,253
5,162822002,162823139,del,NA18971,0,,1137
5,52458952,52459671,del,NA12286,0,,719
5,96799958,96802359,del,NA19782,0,,2401
5,172229598,172236384,del,NA19059,0,,6786
5,151705029,151705377,del,NA19700,0,,348
5,141459200,141459505,del,NA19469,0,,305
5,138065674,138076400,del,NA19429,0,,10726
5,89003720,89004043,del,HG01072,0,,323
5,106396275,106396730,del,HG01440,0,,455
5,25316197,25316504,del,NA19403,0,,307
5,153366281,153369687,del,HG00654,0,,3406
5,143080256,143080458,del,NA18516,0,,202
5,20437106,20444331,del,NA19428,0,,7225
5,17475021,17480134,del,NA18550,0,,5113
5,17056873,17058446,del,HG00403,0,,1573
5,43085812,43089066,del,HG01052,0,,3254
5,103781502,103784971,del,NA19469,0,,3469
5,180561686,180563022,del,NA18907,0,,1336
5,117803406,117813030,del,NA19723,0,,9624
5,14528432,14530888,del,NA19703,0,,2456
5,29530198,29540080,del,NA18637,0,,9882
5,468166,468372,del,HG00246,0,,206
5,45004820,45014528,del,HG00736,0,,9708
5,150285186,150288102,del,NA20525,0,,2916
5,177690112,177691480,del,HG00637,0,,1368
5,124376165,124377420,del,HG00530,0,,1255
5,7917516,7919822,del,HG00693,0,,2306
5,14403479,14403628,del,HG01354,0,,149
5,175504381,175507844,del,NA19236,0,,3463
5,126126005,126127682,del,NA18502,0,,1677
5,179723746,179723856,del,NA18562,0,,110
5,1080350,1080466,del,NA18547,0,,116
5,96247611,96257720,del,NA18983,0,,10109
5,130449494,130454030,del,NA19062,0,,4536
5,10273229,10275073,del,HG01052,0,,1844
5,1539616,1539886,del,HG00321,0,,270
5,97035249,97035581,del,HG00173,0,,332
5,134415608,134422196,del,NA19788,0,,6588
5,54081758,54081907,del,NA19137,0,,149
5,34860203,34861322,del,NA18988,0,,1119
5,14658966,14660646,del,HG01102,0,,1680
5,46165396,46185933,del,NA18517,0,,20537
5,17671257,17696646,del,HG00258,0,,25389
5,99608147,99608459,del,HG00473,0,,312
5,37972662,37974437,del,NA20278,0,,1775
5,166724422,166729699,del,NA18557,0,,5277
5,121013005,121015380,del,HG01440,0,,2375
5,83350687,83351272,del,NA19446,0,,585
5,754267,846940,del,HG00264,0,,92673
5,39775355,39776603,del,HG00173,0,,1248
5,41062035,41062225,del,NA19379,0,,190
5,121396777,121397164,del,NA19747,0,,387
5,147544790,147544987,del,NA12889,0,,197
5,37777633,37778585,del,HG00427,0,,952
5,86004064,86007277,del,NA18617,0,,3213
5,59947887,59951634,del,HG00342,0,,3747
5,2819404,2821251,del,HG01067,0,,1847
5,4579149,4579438,del,HG00708,0,,289
5,120187285,120247492,del,NA18988,0,,60207
5,111779702,111786739,del,HG00124,0,,7037
5,141961886,141963905,del,NA19726,0,,2019
5,96704396,96705198,del,NA19359,0,,802
5,104271904,104298426,del,NA07357,0,,26522
5,66608685,66612599,del,NA19385,0,,3914
5,10792988,10798010,del,NA18510,0,,5022
5,168131200,168131346,del,NA19375,0,,146
5,8234330,8235340,del,NA19130,0,,1010
5,45127240,45127670,del,NA19384,0,,430
5,13655626,13655916,del,HG00140,0,,290
5,1323273,1323504,del,HG01069,0,,231
5,172973010,172974750,del,HG01351,0,,1740
5,176229095,176231751,del,HG01051,0,,2656
5,79652781,79659333,del,NA19350,0,,6552
5,172350035,172350212,del,HG00249,0,,177
5,88889998,88890270,del,NA11994,0,,272
5,148706623,148706863,del,NA19116,0,,240
5,81625514,81640251,del,NA18605,0,,14737
5,51170160,51170908,del,NA19350,0,,748
5,291476,291677,del,HG00533,0,,201
5,105894447,105895553,del,NA18582,0,,1106
5,12881277,12882896,del,NA20758,0,,1619
5,84788378,84788532,del,NA18547,0,,154
5,2862666,2863243,del,NA18548,0,,577
5,33111865,33112667,del,NA19401,0,,802
5,16150012,16150779,del,NA19467,0,,767
5,87208649,87209719,del,HG01366,0,,1070
5,12722596,12730468,del,HG01354,0,,7872
5,27663987,27667691,del,HG00442,0,,3704
5,73062919,73064826,del,NA18917,0,,1907
5,33626479,33626727,del,HG00159,0,,248
5,119376932,119386129,del,NA19397,0,,9197
5,171754748,171755127,del,HG01170,0,,379
5,94984971,94987351,del,NA19213,0,,2380
5,23804662,23806631,del,NA19457,0,,1969
5,82062216,82065922,del,HG01351,0,,3706
5,7836899,7842200,del,NA19147,0,,5301
5,178348362,178353197,del,HG00336,0,,4835
5,170129734,170131205,del,NA18612,0,,1471
5,109460070,109475352,del,NA19449,0,,15282
5,19078553,19079036,del,NA19005,0,,483
5,128664726,128747093,del,NA07000,0,,82367
5,140186936,140201523,del,NA12878,0,,14587
5,77960872,77962080,del,NA19819,0,,1208
5,138270509,138281452,del,HG00692,0,,10943
5,174128299,174132004,del,NA18523,0,,3705
5,176495043,176496273,del,NA18522,0,,1230
5,139752890,139757213,del,HG00531,0,,4323
5,66941635,66943722,del,NA19446,0,,2087
5,97119777,97120553,del,NA19917,0,,776
5,180374816,180431472,del,HG00421,0,,56656
5,41226813,41243961,del,NA18618,0,,17148
5,164549681,164555156,del,NA18599,0,,5475
5,98714314,98715316,del,HG01170,0,,1002
5,61697686,61705632,del,NA18602,0,,7946
5,123134807,123140979,del,NA11932,0,,6172
5,82482756,82483062,del,HG00284,0,,306
5,157333021,157334730,del,NA19461,0,,1709
5,99843327,99846764,del,NA20813,0,,3437
5,179102168,179103546,del,HG01197,0,,1378
5,94322287,94325278,del,NA18538,0,,2991
5,46340179,46342156,del,NA18618,0,,1977
5,166402762,166403630,del,HG01357,0,,868
5,146394416,146395722,del,HG00422,0,,1306
5,127335816,127337422,del,HG00525,0,,1606
5,114021278,114021519,del,NA19403,0,,241
5,25180,35161,del,NA19379,0,,9981
5,683409,775547,del,NA20797,0,,92138
5,14528205,14534116,del,HG00699,0,,5911
5,160716108,160717240,del,NA18867,0,,1132
5,49542520,49545422,del,NA19070,0,,2902
5,178561496,178562660,del,HG00479,0,,1164
5,33186521,33193152,del,HG00126,0,,6631
5,178109066,178114735,del,HG01440,0,,5669
5,32639948,32641134,del,HG00690,0,,1186
5,135302317,135334981,del,NA18547,0,,32664
5,172430168,172438653,del,HG00672,0,,8485
5,32260110,32261307,del,NA19007,0,,1197
5,177523016,177523722,del,NA12282,0,,706
5,41585698,41596425,del,NA19062,0,,10727
5,176591856,176600686,del,NA19904,0,,8830
5,104425322,104432096,del,HG00281,0,,6774
5,17646457,17694432,del,HG00442,0,,47975
5,178106861,178111873,del,HG00242,0,,5012
5,101356967,101361585,del,HG00270,0,,4618
5,151511018,151518864,del,HG00512,0,,7846
5,180375816,180430372,del,NA19004,0,,54556
5,25821782,25823948,del,HG00268,0,,2166
5,120424187,120467839,del,HG00281,0,,43652
5,9400610,9400880,del,NA07346,0,,270
5,78925402,78929709,del,NA19085,0,,4307
5,4524354,4528473,del,NA19819,0,,4119
5,101166760,101207359,del,NA18505,0,,40599
5,1046929,1047330,del,NA19835,0,,401
5,161552407,161552544,del,NA19818,0,,137
5,40836320,40840272,del,HG00421,0,,3952
5,123062451,123064389,del,NA19430,0,,1938
5,82951241,82957277,del,NA19385,0,,6036
5,141995172,141998639,del,NA18986,0,,3467
5,114726848,114729200,del,HG00252,0,,2352
5,97401968,97402150,del,NA20518,0,,182
5,4134116,4137146,del,NA19440,0,,3030
5,75054982,75055397,del,NA19063,0,,415
5,4388926,4399092,del,HG00634,0,,10166
5,4424889,4434135,del,NA19657,0,,9246
5,61807559,61810474,del,NA20341,0,,2915
5,114880870,114882651,del,HG00330,0,,1781
5,5375710,5378381,del,NA20787,0,,2671
5,131172963,131181861,del,HG00513,0,,8898
5,137181328,137187955,del,HG00282,0,,6627
5,43550081,43550826,del,NA19444,0,,745
5,46269966,46283222,del,NA20810,0,,13256
5,77181522,77182749,del,HG01079,0,,1227
5,17711520,17719482,del,NA19347,0,,7962
5,173090383,173091245,del,NA18520,0,,862
5,112666835,112672316,del,NA19172,0,,5481
5,50234380,50239464,del,HG00257,0,,5084
5,29374682,29378691,del,HG01075,0,,4009
5,1941144,1941454,del,NA19010,0,,310
5,98477590,98478333,del,NA19384,0,,743
5,143406084,143409416,del,NA18557,0,,3332
5,75665481,75667060,del,HG01055,0,,1579
5,18140504,18140680,del,NA18486,0,,176
5,60897616,60897872,del,HG01441,0,,256
5,11796858,11797672,del,HG00580,0,,814
5,124363835,124364161,del,HG01497,0,,326
5,146305489,146317327,del,NA20509,0,,11838
5,44498947,44499110,del,NA18948,0,,163
5,59354343,59358956,del,HG00472,0,,4613
5,54625606,54626429,del,NA19660,0,,823
5,163537393,163538299,del,NA18959,0,,906
5,22914417,22929505,del,NA18596,0,,15088
5,836145,837050,del,NA20515,0,,905
5,45693376,45693952,del,NA19129,0,,576
5,133134674,133136488,del,NA07037,0,,1814
5,166402455,166403568,del,NA19719,0,,1113
5,67404976,67406095,del,HG00154,0,,1119
5,165838883,165849965,del,NA18498,0,,11082
5,150210002,150210129,del,HG00427,0,,127
5,149441738,149442163,del,HG00140,0,,425
5,37447603,37472877,del,NA18614,0,,25274
5,20419692,20428474,del,NA19397,0,,8782
5,17140726,17141162,del,NA19462,0,,436
5,162306938,162310163,del,HG00259,0,,3225
5,174435919,174440569,del,NA18989,0,,4650
5,160518039,160519009,del,NA20775,0,,970
5,180591316,180596022,del,NA18626,0,,4706
5,140096741,140103981,del,NA19685,0,,7240
5,125551310,125566270,del,HG00422,0,,14960
5,30915519,30916055,del,NA20322,0,,536
5,63698343,63701356,del,NA19129,0,,3013
5,161066843,161070866,del,HG01377,0,,4023
5,173453108,173457969,del,NA19700,0,,4861
5,125412802,125417277,del,NA18610,0,,4475
5,178935729,178937549,del,NA20773,0,,1820
5,113326599,113336716,del,HG00265,0,,10117
5,52571737,52575010,del,NA07346,0,,3273
5,177653386,177660732,del,HG00274,0,,7346
5,176533817,176535541,del,NA19982,0,,1724
5,65443635,65444172,del,NA20527,0,,537
5,697033,788359,del,HG01107,0,,91326
5,91066720,91081189,del,HG00443,0,,14469
5,156538096,156540413,del,NA19346,0,,2317
5,97400502,97403786,del,NA11829,0,,3284
5,177226516,177235822,del,HG00123,0,,9306
5,150880807,150882992,del,NA19982,0,,2185
5,7238277,7240269,del,NA19434,0,,1992
5,125138695,125141371,del,NA19648,0,,2676
5,155311783,155312574,del,HG00120,0,,791
5,41084883,41085073,del,NA18502,0,,190
5,140004124,140006180,del,NA12341,0,,2056
5,98743177,98744459,del,NA19063,0,,1282
5,12811019,12820535,del,NA19716,0,,9516
5,123539547,123546309,del,NA19390,0,,6762
5,80685589,80686564,del,NA19719,0,,975
5,83589252,83590006,del,NA19818,0,,754
5,136814793,136815629,del,NA19920,0,,836
5,114325356,114334992,del,NA18638,0,,9636
5,176438180,176439546,del,HG00524,0,,1366
5,40334325,40352024,del,NA19474,0,,17699
5,173758371,173760122,del,HG01365,0,,1751
5,83798767,83805046,del,NA19093,0,,6279
5,35191134,35191471,del,NA20515,0,,337
5,178118297,178119261,del,NA12489,0,,964
5,135621866,135625372,del,NA19467,0,,3506
5,118937015,118938751,del,NA19703,0,,1736
5,109445849,109445972,del,NA19473,0,,123
5,84359993,84362127,del,NA19398,0,,2134
5,754621,846671,del,HG01149,0,,92050
5,7371648,7372821,del,NA20346,0,,1173
5,87668419,87668605,del,NA19075,0,,186
5,19235508,19236107,del,NA19350,0,,599
5,180375916,180431222,del,HG01519,0,,55306
5,66202926,66203177,del,NA18933,0,,251
5,97088847,97097687,del,HG00112,0,,8840
5,61747960,61749373,del,NA19093,0,,1413
5,42628311,42630990,del,NA12775,0,,2679
5,45964795,45968559,del,NA18916,0,,3764
5,12427054,12428732,del,NA18505,0,,1678
5,65268025,65269966,del,HG01437,0,,1941
5,66134513,66134696,del,HG00463,0,,183
5,20886714,20887400,del,HG00148,0,,686
5,38208062,38208199,del,NA18593,0,,137
5,176531869,176532125,del,NA18501,0,,256
5,539943,550771,del,HG00525,0,,10828
5,14589179,14591822,del,NA18947,0,,2643
5,178386734,178391199,del,HG00671,0,,4465
5,141753340,141756409,del,NA11843,0,,3069
5,31890785,31894867,del,NA07037,0,,4082
5,21649508,21651248,del,NA18542,0,,1740
5,9897548,9899710,del,NA19920,0,,2162
5,169990822,169993090,del,NA18908,0,,2268
5,36486028,36486301,del,NA18570,0,,273
5,166942545,166949996,del,NA20586,0,,7451
5,8702316,8747722,del,HG01521,0,,45406
5,2039452,2066205,del,NA20585,0,,26753
5,108604046,108608604,del,NA20346,0,,4558
5,1273273,1273921,del,NA12275,0,,648
5,153689926,153693851,del,HG00183,0,,3925
5,2769423,2769640,del,HG00442,0,,217
5,57257911,57260258,del,NA18620,0,,2347
5,21532469,21539602,del,NA19726,0,,7133
5,59949554,59951865,del,NA19789,0,,2311
5,79557188,79557502,del,HG00702,0,,314
5,46214890,46220605,del,NA19703,0,,5715
5,68319474,68320949,del,NA20811,0,,1475
5,14527279,14529934,del,NA19064,0,,2655
5,172495986,172498834,del,HG00595,0,,2848
5,126081863,126083513,del,NA19376,0,,1650
5,95966535,95967361,del,HG00422,0,,826
5,159474206,159474657,del,HG00421,0,,451
5,98090012,98098387,del,NA12489,0,,8375
5,145792945,145796942,del,NA19401,0,,3997
5,54110553,54121327,del,HG01069,0,,10774
5,99757285,99757682,del,NA19172,0,,397
5,134952676,134953794,del,NA19099,0,,1118
5,102402338,102402719,del,NA19093,0,,381
5,179810561,179811724,del,NA19081,0,,1163
5,74223088,74223930,del,NA12383,0,,842
5,3323350,3323999,del,HG00119,0,,649
5,81242254,81242573,del,NA20586,0,,319
5,39077109,39100207,del,NA20818,0,,23098
5,852825,853722,del,NA19080,0,,897
5,60400916,60404500,del,NA19456,0,,3584
5,179847413,179848633,del,HG00377,0,,1220
5,41569274,41582708,del,NA19000,0,,13434
5,43238382,43243014,del,NA19379,0,,4632
5,177873681,177878918,del,HG00339,0,,5237
5,164722268,164725991,del,NA19431,0,,3723
5,63884983,63886318,del,NA19719,0,,1335
5,149261414,149262418,del,NA18870,0,,1004
5,175255546,175257586,del,HG00707,0,,2040
5,128924475,128926468,del,NA19000,0,,1993
5,170282435,170283634,del,HG00256,0,,1199
5,75868312,75870417,del,HG00693,0,,2105
5,82063426,82066153,del,NA19204,0,,2727
5,147338010,147340528,del,NA19248,0,,2518
5,149377016,149377608,del,NA19236,0,,592
5,16869712,16870740,del,NA19102,0,,1028
5,109563688,109573914,del,NA12748,0,,10226
5,172145677,172145928,del,HG00278,0,,251
5,106081772,106081845,del,NA19240,0,,73
5,28245696,28253275,del,NA19431,0,,7579
5,3630929,3631097,del,HG00263,0,,168
5,7883484,7883658,del,NA19396,0,,174
5,45929904,45943717,del,NA20517,0,,13813
5,151516266,151518722,del,HG00327,0,,2456
5,160991215,160991688,del,NA19313,0,,473
5,43163296,43171233,del,HG00556,0,,7937
5,26119155,26119392,del,NA20544,0,,237
5,19405062,19413047,del,NA18498,0,,7985
5,82005239,82008590,del,HG00684,0,,3351
5,1682463,1682775,del,HG00418,0,,312
5,79878612,79878925,del,HG00640,0,,313
5,149896361,149898339,del,HG00731,0,,1978
5,55611742,55612992,del,HG00326,0,,1250
5,53386746,53388262,del,NA18574,0,,1516
5,62687437,62687708,del,HG00120,0,,271
5,148711203,148711963,del,NA19116,0,,760
5,29530198,29540081,del,HG00611,0,,9883
5,66718374,66720661,del,NA18983,0,,2287
5,152684089,152692308,del,NA18637,0,,8219
5,165383215,165389683,del,NA18543,0,,6468
5,129383602,129383751,del,NA19434,0,,149
5,151678064,151682738,del,NA12827,0,,4674
5,132918964,132924990,del,NA18547,0,,6026
5,99854591,99855926,del,HG00156,0,,1335
5,180374816,180430422,del,NA12889,0,,55606
5,44125522,44125712,del,NA18951,0,,190
5,133395521,133398648,del,NA12144,0,,3127
5,161266100,161266984,del,NA20773,0,,884
5,24308455,24313568,del,NA19430,0,,5113
5,140222137,140238931,del,HG01136,0,,16794
5,23262684,23270004,del,NA19818,0,,7320
5,121426677,121427417,del,HG00475,0,,740
5,118925374,118932179,del,NA18564,0,,6805
5,137693445,137694030,del,NA12003,0,,585
5,46333637,46336496,del,HG00607,0,,2859
5,151086785,151088393,del,NA20761,0,,1608
5,128378681,128378992,del,HG01441,0,,311
5,87112093,87113018,del,NA19372,0,,925
5,174130019,174132005,del,NA19382,0,,1986
5,83049476,83055000,del,NA19394,0,,5524
5,155593428,155594477,del,HG00315,0,,1049
5,132874846,132875596,del,NA19916,0,,750
5,92984686,92985744,del,NA19391,0,,1058
5,737205,829374,del,HG01353,0,,92169
5,754730,846680,del,NA18544,0,,91950
5,99513834,99520358,del,NA20342,0,,6524
5,34855249,34855359,del,NA19391,0,,110
5,16525208,16525419,del,HG00476,0,,211
5,160620034,160621129,del,NA19256,0,,1095
5,36751399,36751995,del,NA19372,0,,596
5,6524390,6524715,del,NA19789,0,,325
5,21578235,21578784,del,NA18868,0,,549
5,17639241,17651719,del,NA18605,0,,12478
5,104432113,104503672,del,NA12878,0,,71559
5,178641141,178641291,del,HG00463,0,,150
5,176600117,176608977,del,NA19394,0,,8860
5,301941,303041,del,NA19379,0,,1100
5,151956968,151960988,del,NA18908,0,,4020
5,161590116,161597051,del,NA19463,0,,6935
5,160588799,160590305,del,HG00159,0,,1506
5,36086435,36090402,del,NA19678,0,,3967
5,169440206,169441156,del,HG00472,0,,950
5,174248321,174249101,del,NA19403,0,,780
5,131236150,131242546,del,NA19451,0,,6396
5,172406062,172407379,del,HG00537,0,,1317
5,2541740,2542076,del,NA18486,0,,336
5,27336,27987,del,NA19130,0,,651
5,101278052,101279134,del,NA07000,0,,1082
5,57955857,57959508,del,NA19456,0,,3651
5,28357066,28389372,del,NA19004,0,,32306
5,80103916,80107722,del,NA20582,0,,3806
5,13053735,13059901,del,NA19904,0,,6166
5,1196073,1196253,del,NA19129,0,,180
5,17077313,17078620,del,NA19394,0,,1307
5,140557249,140593328,del,HG00362,0,,36079
5,173012311,173012654,del,NA18499,0,,343
5,10756180,10756515,del,HG00684,0,,335
5,17620307,17620943,del,NA19834,0,,636
5,8179569,8180524,del,NA20802,0,,955
5,96722768,96726451,del,NA19713,0,,3683
5,146315716,146316260,del,NA20510,0,,544
5,13358885,13385068,del,NA19359,0,,26183
5,161558848,161559242,del,NA12144,0,,394
5,128881271,128884062,del,NA19443,0,,2791
5,114706251,114721123,del,HG00692,0,,14872
5,116617593,116621133,del,NA19438,0,,3540
5,21450220,21452475,del,HG01384,0,,2255
5,115455209,115456919,del,NA19236,0,,1710
5,75349313,75356485,del,HG00683,0,,7172
5,59491061,59494958,del,HG01133,0,,3897
5,10112908,10114311,del,HG00264,0,,1403
5,9267219,9275423,del,HG00325,0,,8204
5,26009473,26011758,del,NA19138,0,,2285
5,4148679,4149324,del,NA19360,0,,645
5,61574938,61576444,del,HG00418,0,,1506
5,145691091,145692888,del,HG01374,0,,1797
5,100058008,100069634,del,HG01060,0,,11626
5,11310895,11311017,del,HG00589,0,,122
5,3001335,3001449,del,HG00274,0,,114
5,11567824,11569779,del,HG00268,0,,1955
5,98839889,98842906,del,NA18508,0,,3017
5,43479102,43482428,del,HG00118,0,,3326
5,142016220,142021503,del,NA19917,0,,5283
5,40848985,40851014,del,NA18635,0,,2029
5,39847232,39851048,del,HG01492,0,,3816
5,12426119,12428650,del,NA19900,0,,2531
5,138927238,138933502,del,NA19060,0,,6264
5,143707549,143708800,del,HG00557,0,,1251
5,85350027,85350149,del,NA19114,0,,122
5,45527023,45527489,del,HG01069,0,,466
5,166150748,166151068,del,NA19324,0,,320
5,1041702,1046286,del,HG01357,0,,4584
5,41901919,41903716,del,NA19920,0,,1797
5,54543097,54547138,del,HG00403,0,,4041
5,59489409,59496825,del,HG00275,0,,7416
5,166858930,166859677,del,NA19102,0,,747
5,163665008,163666447,del,HG00243,0,,1439
5,94840046,94840290,del,NA19129,0,,244
5,122808512,122822014,del,HG01055,0,,13502
5,120595585,120596467,del,NA19789,0,,882
5,179342030,179344298,del,HG00274,0,,2268
5,37471331,37473338,del,NA19360,0,,2007
5,99725768,99728199,del,HG00345,0,,2431
5,180066155,180066304,del,HG00275,0,,149
5,682508,774654,del,NA12827,0,,92146
5,46074374,46074715,del,HG01377,0,,341
5,91546063,91548437,del,HG01440,0,,2374
5,42165928,42167769,del,NA07000,0,,1841
5,79567147,79568115,del,NA18599,0,,968
5,45191890,45213533,del,NA19429,0,,21643
5,76317844,76323029,del,NA12341,0,,5185
5,143181043,143186147,del,NA18567,0,,5104
5,178108933,178113868,del,NA19003,0,,4935
5,140531151,140536898,del,NA12046,0,,5747
5,125496694,125498752,del,HG00580,0,,2058
5,84903339,84904200,del,NA19921,0,,861
5,78953283,78959915,del,HG00478,0,,6632
5,103761364,103766642,del,NA18617,0,,5278
5,109460539,109469149,del,NA19372,0,,8610
5,147608465,147609552,del,HG01136,0,,1087
5,17527013,17606098,del,NA19470,0,,79085
5,66337615,66338124,del,NA20773,0,,509
5,46398184,46399028,del,HG01125,0,,844
5,112477827,112478366,del,NA12282,0,,539
5,86815057,86815977,del,HG00346,0,,920
5,23633244,23633670,del,HG01136,0,,426
5,67361079,67362397,del,NA19834,0,,1318
5,138357379,138362004,del,HG00479,0,,4625
5,7372016,7372422,del,HG00148,0,,406
5,153805417,153807246,del,HG00277,0,,1829
5,127407439,127410916,del,HG00369,0,,3477
5,4463637,4466623,del,NA19108,0,,2986
5,178386816,178391322,del,HG00448,0,,4506
5,70980214,70983247,del,HG00277,0,,3033
5,151476232,151476363,del,HG00613,0,,131
5,1870845,1871197,del,NA18561,0,,352
5,56404292,56405533,del,NA18873,0,,1241
5,32966140,32970903,del,NA12400,0,,4763
5,171714816,171719823,del,HG00124,0,,5007
5,46255138,46292084,del,HG00118,0,,36946
5,17758844,17760592,del,HG01389,0,,1748
5,27519268,27530115,del,HG00277,0,,10847
5,106741447,106742269,del,NA19474,0,,822
5,105003910,105007634,del,NA19190,0,,3724
5,7371608,7372639,del,NA20768,0,,1031
5,25889803,25892388,del,NA19625,0,,2585
5,82421886,82429044,del,HG00626,0,,7158
5,1998550,1998864,del,NA19431,0,,314
5,12851592,12855228,del,NA20815,0,,3636
5,89796407,89797966,del,HG01489,0,,1559
5,75689586,75690126,del,NA19722,0,,540
5,86115337,86117858,del,NA18526,0,,2521
5,142767469,142768543,del,NA18635,0,,1074
5,118250946,118254361,del,NA18999,0,,3415
5,178119250,178121187,del,NA19381,0,,1937
5,151514804,151518864,del,HG00740,0,,4060
5,33517269,33526099,del,HG00315,0,,8830
5,37254629,37257767,del,NA12890,0,,3138
5,17609511,17619281,del,NA19707,0,,9770
5,149298804,149303595,del,HG00247,0,,4791
5,5026186,5027653,del,NA18610,0,,1467
5,32860898,32862802,del,NA18549,0,,1904
5,44679325,44681769,del,NA12889,0,,2444
5,175201379,175201739,del,NA18592,0,,360
5,170131207,170131521,del,HG01107,0,,314
5,616812,616907,del,HG01083,0,,95
5,57579819,57582467,del,HG00596,0,,2648
5,135825374,135833961,del,NA19437,0,,8587
5,35417915,35431851,del,NA19397,0,,13936
5,68913316,68925322,del,NA18861,0,,12006
5,177329716,177352222,del,HG00264,0,,22506
5,176256920,176257129,del,NA19920,0,,209
5,121132602,121135952,del,HG00337,0,,3350
5,150177661,150181599,del,HG00650,0,,3938
5,31346945,31348395,del,NA18910,0,,1450
5,77380436,77382563,del,NA20543,0,,2127
5,54908594,54911041,del,NA12843,0,,2447
5,63846287,63847523,del,NA19472,0,,1236
5,180591115,180596581,del,NA18549,0,,5466
5,102967859,102981900,del,HG00158,0,,14041
5,90574693,90574986,del,HG00373,0,,293
5,65613983,65613968,del,NA12889,0,,-15
5,37191561,37192730,del,NA19445,0,,1169
5,45949658,45971966,del,NA20296,0,,22308
5,67497288,67498161,del,NA19466,0,,873
5,38508608,38509246,del,NA20582,0,,638
5,99494170,99494429,del,NA19359,0,,259
5,99205808,99205948,del,HG01187,0,,140
5,29533328,29533453,del,HG01374,0,,125
5,32161097,32162522,del,HG01183,0,,1425
5,101231406,101280690,del,NA12144,0,,49284
5,109818227,109818704,del,NA19707,0,,477
5,139367568,139369582,del,NA20798,0,,2014
5,120649513,120652351,del,NA19443,0,,2838
5,17222148,17223269,del,NA19468,0,,1121
5,143707712,143708862,del,HG00707,0,,1150
5,153802587,153807016,del,NA19108,0,,4429
5,163950354,163950982,del,NA19678,0,,628
5,123448817,123451753,del,HG00183,0,,2936
5,55485638,55493427,del,HG01437,0,,7789
5,112224235,112226889,del,NA18595,0,,2654
5,94828258,94828497,del,NA19920,0,,239
5,156421850,156426959,del,NA19720,0,,5109
5,133954887,133955822,del,HG00263,0,,935
5,159922262,159923713,del,NA19190,0,,1451
5,86355866,86356036,del,NA18634,0,,170
5,141308446,141308545,del,NA18511,0,,99
5,179276031,179276781,del,HG00190,0,,750
5,93603039,93606320,del,NA19318,0,,3281
5,17960677,17993098,del,NA19393,0,,32421
5,20127285,20131107,del,NA19239,0,,3822
5,135666691,135667663,del,HG00319,0,,972
5,103508331,103534583,del,HG00106,0,,26252
5,16888366,16889009,del,NA18924,0,,643
5,180510652,180518667,del,NA19771,0,,8015
5,23048881,23051369,del,NA19403,0,,2488
5,161543294,161543871,del,NA19190,0,,577
5,24221925,24280508,del,HG01149,0,,58583
5,6571333,6571727,del,HG00699,0,,394
5,109460879,109465480,del,NA12275,0,,4601
5,151141076,151144967,del,HG00116,0,,3891
5,87378880,87382064,del,NA18870,0,,3184
5,90624296,90626074,del,NA18486,0,,1778
5,172965900,172972296,del,NA19783,0,,6396
5,128524447,128524988,del,NA19147,0,,541
5,160796689,160797002,del,HG00628,0,,313
5,7907579,7908052,del,HG00422,0,,473
5,8111203,8121675,del,HG01366,0,,10472
5,155876183,155881976,del,NA19789,0,,5793
5,118956240,118961754,del,NA20801,0,,5514
5,119710934,119714950,del,NA19901,0,,4016
5,119909416,119910872,del,NA19449,0,,1456
5,72657390,72662114,del,NA19399,0,,4724
5,28216657,28225299,del,NA18916,0,,8642
5,2082302,2082818,del,NA18547,0,,516
5,31826731,31827747,del,NA19909,0,,1016
5,172598142,172601428,del,NA19449,0,,3286
5,3957859,3970713,del,HG00318,0,,12854
5,102323937,102324096,del,NA19172,0,,159
5,26159830,26160627,del,NA18858,0,,797
5,137807485,137816901,del,HG00106,0,,9416
5,10526940,10532374,del,HG01359,0,,5434
5,148795642,148796443,del,NA19921,0,,801
5,108203827,108204769,del,NA18597,0,,942
5,140223666,140228972,del,NA12776,0,,5306
5,152470103,152471317,del,HG01390,0,,1214
5,14527908,14530294,del,NA18516,0,,2386
5,13416591,13422853,del,NA11992,0,,6262
5,125153278,125154701,del,NA19385,0,,1423
5,34304789,34307904,del,HG00525,0,,3115
5,150789733,150792626,del,NA19384,0,,2893
5,129405745,129410985,del,NA19054,0,,5240
5,170094251,170096712,del,HG00651,0,,2461
5,745054,837119,del,NA19313,0,,92065
5,2541832,2542133,del,HG00580,0,,301
5,177653338,177660691,del,HG00274,0,,7353
5,21481967,21482783,del,HG00533,0,,816
5,104480397,104497326,del,HG00277,0,,16929
5,35345497,35346051,del,HG01108,0,,554
5,40735865,40740582,del,NA19648,0,,4717
5,133134516,133136822,del,HG01378,0,,2306
5,180247435,180252978,del,HG00530,0,,5543
5,179865354,179866850,del,HG00596,0,,1496
5,145792429,145793409,del,HG01365,0,,980
5,11128275,11135243,del,NA18543,0,,6968
5,2873819,2874968,del,NA10851,0,,1149
5,80778683,80847263,del,NA11918,0,,68580
5,22303383,22304906,del,NA18608,0,,1523
5,74237344,74237616,del,NA19382,0,,272
5,87279157,87291811,del,HG00524,0,,12654
5,83904627,83907458,del,NA19375,0,,2831
5,103853916,103860122,del,NA19147,0,,6206
5,99854591,99855928,del,NA19238,0,,1337
5,852819,854280,del,NA19474,0,,1461
5,100954064,100960038,del,NA19909,0,,5974
5,124946764,124946941,del,HG00342,0,,177
5,152420141,152421057,del,NA19247,0,,916
5,136854316,136856222,del,HG01187,0,,1906
5,138734450,138734744,del,NA19355,0,,294
5,157303376,157304578,del,HG00464,0,,1202
5,131385671,131390323,del,HG00473,0,,4652
5,1001065,1049274,del,NA19108,0,,48209
5,63118309,63119932,del,HG00478,0,,1623
5,177867091,177870845,del,HG00476,0,,3754
5,146728556,146729336,del,HG01389,0,,780
5,36357374,36357565,del,NA19657,0,,191
5,1870488,1870764,del,NA18511,0,,276
5,46331943,46335328,del,HG01052,0,,3385
5,19389280,19391186,del,NA18520,0,,1906
5,151663319,151704511,del,HG00357,0,,41192
5,132180434,132181462,del,NA19657,0,,1028
5,19956604,19964688,del,NA20278,0,,8084
5,77002876,77003621,del,NA19056,0,,745
5,79013702,79014009,del,NA19058,0,,307
5,42635977,42644266,del,NA19463,0,,8289
5,68828716,68881122,del,NA18638,0,,52406
5,17619270,17620817,del,HG00330,0,,1547
5,112823564,112826926,del,NA20783,0,,3362
5,155078545,155082980,del,NA19372,0,,4435
5,85405341,85405510,del,NA12777,0,,169
5,176535225,176535672,del,HG01173,0,,447
5,684529,776619,del,NA19398,0,,92090
5,135122812,135123057,del,NA18989,0,,245
5,21649455,21650969,del,NA18990,0,,1514
5,116836078,116836394,del,NA19443,0,,316
5,21263915,21484397,del,NA19395,0,,220482
5,12810016,12820872,del,HG00619,0,,10856
5,176533763,176535521,del,NA19107,0,,1758
5,108617717,108619516,del,HG01440,0,,1799
5,113156561,113172799,del,HG00232,0,,16238
5,39323113,39324855,del,NA19385,0,,1742
5,137870738,137871587,del,NA19732,0,,849
5,81265007,81274075,del,HG00151,0,,9068
5,9597828,9598838,del,NA18549,0,,1010
5,88604264,88605528,del,NA18534,0,,1264
5,157644330,157655250,del,HG01048,0,,10920
5,51466683,51471372,del,NA18990,0,,4689
5,178107316,178114772,del,HG00176,0,,7456
5,124626974,124628062,del,NA19374,0,,1088
5,26091125,26091617,del,NA19371,0,,492
5,2784640,2784725,del,HG01083,0,,85
5,12375840,12376265,del,HG00650,0,,425
5,86984940,86987441,del,HG00638,0,,2501
5,113995887,113996139,del,NA19443,0,,252
5,144871904,144872805,del,NA18977,0,,901
5,12661620,12665567,del,HG00309,0,,3947
5,95704016,95705922,del,NA19372,0,,1906
5,136934954,136937861,del,HG01359,0,,2907
5,107362510,107373274,del,NA18638,0,,10764
5,180009735,180015256,del,NA19079,0,,5521
5,46139448,46184564,del,NA19382,0,,45116
5,99161928,99162196,del,NA18522,0,,268
5,106324751,106326443,del,HG00565,0,,1692
5,60428335,60431202,del,NA19777,0,,2867
5,63863333,63866626,del,NA19445,0,,3293
5,179617427,179617605,del,HG00436,0,,178
5,150789916,150793222,del,NA18565,0,,3306
5,105657816,105659722,del,HG00592,0,,1906
5,720814,805142,del,NA19720,0,,84328
5,129613875,129618216,del,NA19457,0,,4341
5,35841815,35841932,del,HG00513,0,,117
5,91480767,91481128,del,HG00136,0,,361
5,178268021,178268233,del,NA18861,0,,212
5,16535736,16536725,del,NA12003,0,,989
5,176286623,176286954,del,HG00324,0,,331
5,101644997,101650951,del,NA19901,0,,5954
5,173086160,173087212,del,NA20589,0,,1052
5,178108092,178112372,del,HG00270,0,,4280
5,121426796,121427536,del,NA18595,0,,740
5,146639591,146639673,del,HG00268,0,,82
5,80103855,80109037,del,NA20582,0,,5182
5,16008435,16018526,del,NA19382,0,,10091
5,77880804,77881127,del,HG00737,0,,323
5,24568569,24577601,del,NA19239,0,,9032
5,5610671,5610959,del,HG01334,0,,288
5,31391053,31391975,del,NA19377,0,,922
5,149686594,149686651,del,NA12155,0,,57
5,137532547,137533464,del,NA19470,0,,917
5,115505223,115508642,del,NA18596,0,,3419
5,121041111,121041242,del,HG00254,0,,131
5,146363007,146364713,del,HG01073,0,,1706
5,25541973,25547188,del,HG01073,0,,5215
5,116878752,116882881,del,NA19904,0,,4129
5,126039641,126040394,del,NA19063,0,,753
5,1627139,1628841,del,NA20588,0,,1702
5,54479391,54479873,del,NA18573,0,,482
5,175988753,175994587,del,HG00651,0,,5834
5,133367562,133376305,del,NA20795,0,,8743
5,111939582,111944340,del,NA20758,0,,4758
5,52911909,52918452,del,HG00261,0,,6543
5,162861773,162863291,del,NA19834,0,,1518
5,140531432,140537179,del,NA19443,0,,5747
5,71173050,71173692,del,NA19469,0,,642
5,180184454,180184722,del,HG00662,0,,268
5,24778338,24785945,del,HG00312,0,,7607
5,26765479,26788042,del,NA19435,0,,22563
5,159742556,159742662,del,NA19719,0,,106
5,7917046,7920554,del,HG01187,0,,3508
5,117868222,117868534,del,NA11892,0,,312
5,148224750,148225261,del,NA19057,0,,511
5,146622651,146623084,del,HG00146,0,,433
5,118457571,118458471,del,HG00118,0,,900
5,86246004,86247142,del,NA18873,0,,1138
5,86359210,86363223,del,NA19383,0,,4013
5,137833515,137835047,del,NA19707,0,,1532
5,15603668,15606515,del,NA20544,0,,2847
5,43583048,43583785,del,NA19107,0,,737
5,4145052,4145408,del,NA19380,0,,356
5,133237942,133239015,del,NA19248,0,,1073
5,112679256,112681361,del,NA20783,0,,2105
5,141995060,141998620,del,HG00689,0,,3560
5,114012320,114017637,del,HG00187,0,,5317
5,40794615,40794978,del,HG00536,0,,363
5,3323346,3324099,del,NA19780,0,,753
5,2873807,2874931,del,NA10851,0,,1124
5,60881925,60891311,del,HG00565,0,,9386
5,149907372,149908179,del,NA18621,0,,807
5,12645460,12645678,del,NA20531,0,,218
5,1333219,1333318,del,HG00418,0,,99
5,32334365,32335675,del,NA19900,0,,1310
5,683958,776098,del,NA18565,0,,92140
5,8236054,8236562,del,NA19130,0,,508
5,173237816,173238362,del,NA19396,0,,546
5,18643328,18648334,del,NA07346,0,,5006
5,161823234,161827745,del,NA19719,0,,4511
5,37293799,37294130,del,NA19456,0,,331
5,131134960,131137857,del,NA19347,0,,2897
5,25653044,25653266,del,HG00338,0,,222
5,84673369,84679305,del,NA19379,0,,5936
5,5753196,5763667,del,NA19470,0,,10471
5,39968911,39976619,del,NA18871,0,,7708
5,137145668,137151731,del,HG00125,0,,6063
5,126195121,126201798,del,NA19704,0,,6677
5,59142881,59144746,del,HG01190,0,,1865
5,128882066,128885472,del,HG01149,0,,3406
5,180680074,180681413,del,NA19138,0,,1339
5,60379389,60380283,del,HG00142,0,,894
5,98839889,98842908,del,HG00557,0,,3019
5,110627489,110630065,del,NA19676,0,,2576
5,144635344,144636868,del,NA19401,0,,1524
5,62304703,62304822,del,HG00315,0,,119
5,118923595,118927808,del,HG00699,0,,4213
5,7167594,7176721,del,HG00422,0,,9127
5,32039256,32039572,del,NA18610,0,,316
5,57859486,57859953,del,NA19679,0,,467
5,159530072,159535279,del,NA18599,0,,5207
5,149011043,149012996,del,NA19129,0,,1953
5,35392754,35393219,del,HG01197,0,,465
5,111339414,111348948,del,NA19403,0,,9534
5,106970160,106970543,del,NA19776,0,,383
5,44244497,44259368,del,HG01047,0,,14871
5,68471095,68471149,del,NA12045,0,,54
5,21450169,21452462,del,NA19372,0,,2293
5,83948305,83955267,del,NA18606,0,,6962
5,133134716,133136622,del,NA12045,0,,1906
5,129309804,129324084,del,HG00560,0,,14280
5,73499616,73499922,del,HG00244,0,,306
5,160184172,160186290,del,NA19347,0,,2118
5,60962854,60963296,del,NA19359,0,,442
5,144994872,144995188,del,NA19060,0,,316
5,158895400,158898706,del,HG00117,0,,3306
5,15091385,15094890,del,NA19247,0,,3505
5,5107853,5109888,del,HG00557,0,,2035
5,6370034,6371778,del,NA18505,0,,1744
5,25888863,25889089,del,NA18502,0,,226
5,81098,81141,del,NA19391,0,,43
5,34191094,34191904,del,NA19779,0,,810
5,157736959,157737165,del,HG00501,0,,206
5,78474174,78478563,del,HG00543,0,,4389
5,121342392,121343479,del,NA18861,0,,1087
5,130583827,130584874,del,NA12272,0,,1047
5,132379995,132382550,del,NA18530,0,,2555
5,117387098,117393883,del,NA18487,0,,6785
5,49499544,49502753,del,NA18536,0,,3209
5,121576115,121580808,del,HG00693,0,,4693
5,149746191,149746517,del,NA19078,0,,326
5,138111831,138111887,del,HG00656,0,,56
5,103854274,103860326,del,HG00543,0,,6052
5,64634413,64640750,del,HG01191,0,,6337
5,160150646,160153325,del,HG01125,0,,2679
5,28545719,28547719,del,NA19700,0,,2000
5,137382643,137385131,del,NA19461,0,,2488
5,132007925,132008297,del,NA19403,0,,372
5,15906527,15912662,del,NA19375,0,,6135
5,97418156,97478799,del,NA20753,0,,60643
5,22254316,22257727,del,NA19463,0,,3411
5,175988668,175994488,del,HG00651,0,,5820
5,8028586,8029215,del,NA19468,0,,629
5,147345157,147345592,del,NA19334,0,,435
5,3346526,3349782,del,NA12044,0,,3256
5,146394711,146397307,del,NA18608,0,,2596
5,17669325,17670059,del,HG00284,0,,734
5,36710468,36711049,del,NA19190,0,,581
5,59129318,59135974,del,NA18868,0,,6656
5,121924268,121927431,del,HG00260,0,,3163
5,96744301,96747166,del,HG00120,0,,2865
5,171904999,171905874,del,NA18989,0,,875
5,140223666,140227622,del,NA18635,0,,3956
5,132471930,132504020,del,HG01069,0,,32090
5,180700117,180715834,del,NA19713,0,,15717
5,21611845,21614776,del,NA19448,0,,2931
5,45191649,45193692,del,NA12287,0,,2043
5,55870784,55871084,del,NA19107,0,,300
5,127476299,127476702,del,NA19397,0,,403
5,135876675,135880698,del,NA19360,0,,4023
5,82062916,82065922,del,HG00256,0,,3006
5,14230281,14233089,del,HG01140,0,,2808
5,7371812,7372952,del,HG00326,0,,1140
5,23303356,23304790,del,NA19102,0,,1434
5,18873312,18874847,del,NA19985,0,,1535
5,105563418,105566699,del,HG00543,0,,3281
5,88572772,88578910,del,NA19383,0,,6138
5,138532856,138534711,del,NA19087,0,,1855
5,67182941,67184489,del,HG01353,0,,1548
5,28152074,28154683,del,NA20519,0,,2609
5,17772797,17776712,del,HG00740,0,,3915
5,138672919,138674541,del,NA19381,0,,1622
5,1047635,1048751,del,NA19385,0,,1116
5,51577105,51580307,del,NA20340,0,,3202
5,144605303,144605526,del,NA19920,0,,223
5,60207822,60213181,del,NA18867,0,,5359
5,125157005,125176423,del,NA18953,0,,19418
5,77895377,77898962,del,NA12286,0,,3585
5,140223366,140228322,del,NA19381,0,,4956
5,17093134,17098262,del,NA19681,0,,5128
5,29709975,29712311,del,NA19395,0,,2336
5,20876950,20878586,del,NA18567,0,,1636
5,62150243,62151128,del,NA18617,0,,885
5,1178293,1180732,del,NA20787,0,,2439
5,137004556,137005199,del,NA20533,0,,643
5,159022307,159022981,del,HG00653,0,,674
5,46164099,46164439,del,HG01183,0,,340
5,122842227,122843064,del,NA18560,0,,837
5,45156627,45159471,del,NA12546,0,,2844
5,22566550,22567297,del,NA18634,0,,747
5,16698720,16699031,del,NA19398,0,,311
5,97047855,97096158,del,NA11830,0,,48303
5,127336000,127336931,del,NA19762,0,,931
5,177866874,177870954,del,HG00476,0,,4080
5,113379502,113380506,del,NA19713,0,,1004
5,68915616,68926522,del,HG00449,0,,10906
5,17618869,17645545,del,HG00117,0,,26676
5,79982151,79982673,del,NA20796,0,,522
5,84463921,84478627,del,HG01124,0,,14706
5,77130479,77131038,del,NA12058,0,,559
5,105894716,105895722,del,NA18502,0,,1006
5,172700231,172700557,del,HG00331,0,,326
5,141438175,141440060,del,NA19334,0,,1885
5,78876910,78881974,del,NA19700,0,,5064
5,165767392,165779964,del,NA20585,0,,12572
5,19223060,19232165,del,NA19473,0,,9105
5,78518161,78518795,del,HG00421,0,,634
5,119380146,119382680,del,NA20276,0,,2534
5,32913709,32919886,del,HG01462,0,,6177
5,1238454,1238640,del,NA19317,0,,186
5,83594,85561,del,NA19700,0,,1967
5,9235645,9235876,del,NA18964,0,,231
5,748316,753022,del,NA18550,0,,4706
5,84655071,84656655,del,NA20828,0,,1584
5,27524884,27526215,del,NA20769,0,,1331
5,106533362,106534209,del,NA20530,0,,847
5,5737288,5744699,del,NA20815,0,,7411
5,70292516,70391122,del,NA18999,0,,98606
5,73275887,73276021,del,HG00442,0,,134
5,142270498,142272276,del,NA18510,0,,1778
5,40851563,40851744,del,HG00513,0,,181
5,171557377,171562738,del,HG00443,0,,5361
5,114633529,114634441,del,HG00154,0,,912
5,155488929,155494981,del,NA19390,0,,6052
5,112938456,112953968,del,HG00361,0,,15512
5,103450994,103451168,del,HG01383,0,,174
5,123314226,123329452,del,HG00436,0,,15226
5,136854675,136856391,del,NA19172,0,,1716
5,21375472,21377361,del,HG01174,0,,1889
5,1562616,1562707,del,NA18620,0,,91
5,104848913,104854976,del,NA19428,0,,6063
5,1098401,1098823,del,HG00329,0,,422
5,37143864,37144338,del,NA18489,0,,474
5,150789796,150792647,del,NA18545,0,,2851
5,17661510,17664258,del,HG00331,0,,2748
5,343353,343535,del,NA06986,0,,182
5,12684763,12759128,del,NA19377,0,,74365
5,55938365,55938562,del,NA19663,0,,197
5,66600658,66603218,del,HG00512,0,,2560
5,90616600,90624232,del,HG01108,0,,7632
5,157291216,157292953,del,NA19099,0,,1737
5,140222216,140240422,del,HG01356,0,,18206
5,180375027,180430528,del,HG01495,0,,55501
5,1037001,1037161,del,HG00683,0,,160
5,180569233,180569978,del,NA19456,0,,745
5,147742502,147749933,del,NA18861,0,,7431
5,135126463,135133325,del,HG00596,0,,6862
5,20018896,20019206,del,NA18557,0,,310
5,148425026,148425533,del,NA19102,0,,507
5,129729022,129729182,del,NA18910,0,,160
5,152897516,152899511,del,HG00701,0,,1995
5,161702630,161707952,del,NA18623,0,,5322
5,141070682,141070786,del,HG00263,0,,104
5,43786359,43805194,del,NA19472,0,,18835
5,179415108,179425399,del,HG00663,0,,10291
5,66599400,66601575,del,NA19331,0,,2175
5,31572376,31576969,del,NA18874,0,,4593
5,179066133,179066647,del,NA19916,0,,514
5,171514606,171514931,del,NA18523,0,,325
5,17637863,17650272,del,HG00671,0,,12409
5,79801239,79801538,del,NA19473,0,,299
5,41901889,41903717,del,NA19238,0,,1828
5,92162916,92171646,del,NA19818,0,,8730
5,120648416,120652122,del,NA18873,0,,3706
5,139258062,139259042,del,NA19060,0,,980
5,122816007,122830095,del,NA18871,0,,14088
5,28491061,28495538,del,NA10851,0,,4477
5,20907635,20907973,del,NA19063,0,,338
5,41754867,41757770,del,NA19466,0,,2903
5,178386781,178391296,del,HG00671,0,,4515
5,100422743,100422938,del,HG00343,0,,195
5,177229016,177236022,del,NA19746,0,,7006
5,99399393,99712804,del,HG01070,0,,313411
5,21490043,21497147,del,NA19077,0,,7104
5,177606377,177608733,del,NA19731,0,,2356
5,134210869,134223878,del,HG00331,0,,13009
5,150176716,150180422,del,NA20356,0,,3706
5,49940745,49946288,del,NA18546,0,,5543
5,156358852,156359041,del,NA19397,0,,189
5,127776806,127778244,del,NA19238,0,,1438
5,155948339,155954256,del,NA19114,0,,5917
5,113601594,113603239,del,HG00684,0,,1645
5,120094893,120159008,del,HG00332,0,,64115
5,40779266,40786797,del,HG00353,0,,7531
5,173607093,173607413,del,NA11918,0,,320
5,73129251,73133471,del,HG00174,0,,4220
5,42944019,42944204,del,NA11919,0,,185
5,121389022,121394970,del,NA19350,0,,5948
5,107198484,107199321,del,NA20588,0,,837
5,85559895,85564842,del,HG00534,0,,4947
5,116845503,116857085,del,NA18555,0,,11582
5,27628066,27635785,del,HG01082,0,,7719
5,46270652,46275836,del,HG01167,0,,5184
5,129215827,129216928,del,NA18973,0,,1101
5,138231293,138233138,del,NA19835,0,,1845
5,163220050,163225467,del,NA19056,0,,5417
5,90615213,90617038,del,NA18987,0,,1825
5,54814096,54848948,del,NA11995,0,,34852
5,111779649,111794135,del,NA18570,0,,14486
5,14540781,14541797,del,NA19390,0,,1016
5,121442411,121442818,del,NA19704,0,,407
5,32085304,32085799,del,NA19147,0,,495
5,88412588,88412791,del,NA12761,0,,203
5,149640665,149640734,del,NA11993,0,,69
5,155063446,155064354,del,HG00284,0,,908
5,98761465,98814305,del,HG00345,0,,52840
5,176508543,176508875,del,NA19818,0,,332
5,114254932,114261432,del,NA19449,0,,6500
5,155476716,155493922,del,NA06989,0,,17206
5,21834222,21837527,del,NA19355,0,,3305
5,128926885,128929975,del,NA19081,0,,3090
5,176823407,176823569,del,NA11830,0,,162
5,49478502,49480038,del,HG00258,0,,1536
5,17342774,17357156,del,HG00262,0,,14382
5,674517,675048,del,NA18909,0,,531
5,160588700,160590362,del,HG01124,0,,1662
5,110375738,110382429,del,HG01375,0,,6691
5,8702660,8748804,del,HG01389,0,,46144
5,175857387,175857590,del,HG01098,0,,203
5,16272165,16276970,del,HG00557,0,,4805
5,152131194,152134277,del,NA18563,0,,3083
5,41420719,41426579,del,HG00634,0,,5860
5,140004151,140006207,del,HG00174,0,,2056
5,20990983,20991181,del,HG01383,0,,198
5,125028800,125028937,del,NA19360,0,,137
5,46341225,46345375,del,NA19982,0,,4150
5,146392916,146396922,del,NA18546,0,,4006
5,19134059,19178922,del,HG01389,0,,44863
5,59947780,59949262,del,NA19055,0,,1482
5,109546242,109546404,del,NA18573,0,,162
5,4899716,4901538,del,NA18501,0,,1822
5,148866179,148866955,del,NA18951,0,,776
5,32557323,32558481,del,NA19457,0,,1158
5,16124810,16125491,del,HG00133,0,,681
5,7492684,7492779,del,NA19819,0,,95
5,82062416,82065222,del,NA19200,0,,2806
5,114403259,114409349,del,NA20801,0,,6090
5,18504524,18504879,del,NA19093,0,,355
5,8762252,8771435,del,NA18541,0,,9183
5,78109799,78111870,del,NA19066,0,,2071
5,173987397,173996319,del,HG00137,0,,8922
5,83285058,83290567,del,NA19713,0,,5509
5,102198719,102198887,del,NA19248,0,,168
5,14370556,14371873,del,NA18566,0,,1317
5,63408399,63410421,del,NA19083,0,,2022
5,116185744,116188340,del,NA19385,0,,2596
5,40982142,40985544,del,NA19009,0,,3402
5,97933118,97939834,del,NA18633,0,,6716
5,52666176,52682367,del,NA20759,0,,16191
5,65028083,65030380,del,NA19461,0,,2297
5,1048275,1048728,del,HG00614,0,,453
5,17691598,17739138,del,NA19818,0,,47540
5,134651081,134652867,del,NA19461,0,,1786
5,43216077,43216477,del,NA18853,0,,400
5,39665119,39665223,del,NA19138,0,,104
5,29271613,29271825,del,HG00323,0,,212
5,96804842,96805423,del,NA20768,0,,581
5,153805375,153807204,del,NA19374,0,,1829
5,98868043,98869020,del,HG00500,0,,977
5,45949697,45971353,del,NA19324,0,,21656
5,99653646,99685585,del,HG01375,0,,31939
5,22796610,22796928,del,NA18973,0,,318
5,105576415,105589581,del,NA19713,0,,13166
5,6982006,6982151,del,HG01173,0,,145
5,81566075,81569475,del,NA19429,0,,3400
5,32852915,32853739,del,NA18545,0,,824
5,1238350,1238760,del,NA18516,0,,410
5,106494777,106504664,del,NA18870,0,,9887
5,7371413,7372134,del,NA18538,0,,721
5,82421946,82429035,del,NA18612,0,,7089
5,85102988,85108171,del,HG00273,0,,5183
5,178109061,178113411,del,HG00253,0,,4350
5,19375269,19376396,del,NA12058,0,,1127
5,119038073,119041691,del,NA19102,0,,3618
5,33200859,33201171,del,NA12749,0,,312
5,66065220,66068326,del,NA18635,0,,3106
5,16889587,16891464,del,NA19818,0,,1877
5,17615700,17617746,del,NA18608,0,,2046
5,65957686,66041109,del,NA19726,0,,83423
5,119910226,119910826,del,NA18522,0,,600
5,142861188,142866075,del,NA20798,0,,4887
5,155577191,155591407,del,NA19172,0,,14216
5,105499093,105501243,del,NA19467,0,,2150
5,15091138,15094835,del,NA19247,0,,3697
5,179067100,179067861,del,NA19398,0,,761
5,754569,846796,del,NA20768,0,,92227
5,116382472,116387866,del,NA18567,0,,5394
5,151851519,151852474,del,NA19473,0,,955
5,171495160,171495738,del,NA20757,0,,578
5,79663014,79693644,del,NA20819,0,,30630
5,139703481,139703823,del,NA19190,0,,342
5,104350737,104356147,del,HG00442,0,,5410
5,136321124,136323436,del,HG01461,0,,2312
5,9512893,9514484,del,HG00577,0,,1591
5,137873442,137874050,del,NA20340,0,,608
5,133133716,133136672,del,NA19452,0,,2956
5,151249104,151253050,del,NA19313,0,,3946
5,79478211,79483403,del,HG00740,0,,5192
5,135344593,135346300,del,NA19130,0,,1707
5,147400655,147409600,del,HG00731,0,,8945
5,145863286,145865490,del,NA19473,0,,2204
5,8027060,8027353,del,NA12829,0,,293
5,42251242,42253305,del,NA19466,0,,2063
5,180560460,180563132,del,NA18853,0,,2672
5,36745161,36745307,del,NA06986,0,,146
5,78180832,78180970,del,HG01101,0,,138
5,43405912,43414182,del,HG00536,0,,8270
5,94332549,94333863,del,HG00328,0,,1314
5,55429206,55430346,del,HG00254,0,,1140
5,74692,76765,del,NA19467,0,,2073
5,44344380,44345022,del,NA18907,0,,642
5,84099673,84101190,del,NA19682,0,,1517
5,37504336,37504527,del,NA18613,0,,191
5,10501328,10502219,del,HG01067,0,,891
5,115590099,115626439,del,HG01108,0,,36340
5,167080853,167088825,del,NA20536,0,,7972
5,108941737,108946359,del,HG01140,0,,4622
5,108305516,108305822,del,NA19332,0,,306
5,3657088,3660541,del,NA18638,0,,3453
5,2594455,2594617,del,NA18559,0,,162
5,153108786,153328045,del,HG00500,0,,219259
5,175760866,175764164,del,HG01204,0,,3298
5,125886146,125886358,del,NA11992,0,,212
5,176991431,176991830,del,HG00342,0,,399
5,105362979,105364597,del,NA18576,0,,1618
5,110627476,110630150,del,NA19676,0,,2674
5,176878418,176878799,del,HG00334,0,,381
5,17636127,17649832,del,NA19909,0,,13705
5,178466028,178473615,del,NA18941,0,,7587
5,16318139,16323113,del,NA20828,0,,4974
5,177227716,177236022,del,NA20810,0,,8306
5,42412359,42416646,del,NA19713,0,,4287
5,49462414,49524449,del,HG00264,0,,62035
5,65129641,65129858,del,HG00282,0,,217
5,718323,802605,del,NA20530,0,,84282
5,98689491,98696762,del,NA19397,0,,7271
5,86858023,86858135,del,NA20356,0,,112
5,89737801,89740377,del,NA19789,0,,2576
5,25215130,25220334,del,NA19446,0,,5204
5,28356942,28357230,del,HG00596,0,,288
5,22016060,22018550,del,NA19359,0,,2490
5,114056498,114121204,del,NA20586,0,,64706
5,133462726,133463818,del,HG00512,0,,1092
5,112263894,112280087,del,HG00126,0,,16193
5,42092172,42095997,del,NA18523,0,,3825
5,164141592,164143361,del,HG00146,0,,1769
5,57858907,57859325,del,NA18550,0,,418
5,96747534,96756271,del,NA19075,0,,8737
5,8320508,8321623,del,NA12342,0,,1115
5,3241782,3244449,del,NA19236,0,,2667
5,166441393,166441486,del,NA18856,0,,93
5,46380923,46382210,del,NA20758,0,,1287
5,61697660,61705903,del,NA18602,0,,8243
5,98048654,98054447,del,NA19723,0,,5793
5,1968395,1971583,del,HG00607,0,,3188
5,22315051,22315228,del,HG00246,0,,177
5,151511699,151518217,del,HG00264,0,,6518
5,132513297,132513614,del,NA19394,0,,317
5,12811017,12820523,del,HG00246,0,,9506
5,130437076,130438312,del,NA18602,0,,1236
5,172687754,172688092,del,HG00190,0,,338
5,79409625,79413786,del,NA19350,0,,4161
5,137607291,137607726,del,NA19819,0,,435
5,41599445,41600123,del,NA18951,0,,678
5,166343926,166344682,del,NA19439,0,,756
5,124167842,124177004,del,NA18941,0,,9162
5,18383,23028,del,NA18858,0,,4645
5,95703149,95706446,del,HG01048,0,,3297
5,176228709,176228832,del,HG00740,0,,123
5,64165866,64169153,del,HG00116,0,,3287
5,179713145,179713723,del,HG00443,0,,578
5,120330447,120330720,del,NA18501,0,,273
5,52961964,52965126,del,NA19652,0,,3162
5,179100246,179101059,del,NA19776,0,,813
5,74759681,74762999,del,HG00122,0,,3318
5,97400583,97403755,del,NA11829,0,,3172
5,101606947,101608174,del,NA19472,0,,1227
5,109459940,109479408,del,NA19383,0,,19468
5,36399581,36439518,del,NA19625,0,,39937
5,91071221,91072272,del,NA19398,0,,1051
5,156848607,156850881,del,NA19085,0,,2274
5,27830360,27834404,del,NA19077,0,,4044
5,17463660,17471088,del,NA18916,0,,7428
5,141158354,141159758,del,HG00443,0,,1404
5,13587502,13589954,del,HG00476,0,,2452
5,2233955,2237382,del,NA20804,0,,3427
5,146841604,146843565,del,NA19456,0,,1961
5,80265400,80267661,del,HG01465,0,,2261
5,174758358,174759146,del,NA19445,0,,788
5,169467690,169467949,del,NA19914,0,,259
5,54380336,54386998,del,NA18487,0,,6662
5,172401928,172402213,del,NA19463,0,,285
5,160540664,160550322,del,NA18582,0,,9658
5,97911,101445,del,NA19819,0,,3534
5,22113,50855,dup,HG02684,0,,28742
5,40417,176437,dup,HG04033,0,,136020
5,52870,65655,dup,HG03271,0,,12785
5,74575,122678,dup,HG04033,0,,48103
5,124186,163795,dup,HG01525,0,,39609
5,239684,246929,dup,HG02696,0,,7245
5,301268,312351,dup,HG00629,0,,11083
5,325948,388352,dup,HG03166,0,,62404
5,359687,478235,dup,HG01855,0,,118548
5,376799,458358,dup,HG01855,0,,81559
5,392281,428197,dup,HG01855,0,,35916
5,453795,475761,dup,HG00266,0,,21966
5,486761,636277,dup,HG00978,0,,149516
5,486779,502792,dup,HG00610,0,,16013
5,507986,519518,dup,HG00978,0,,11532
5,521194,554663,dup,HG00978,0,,33469
5,550510,598085,dup,HG00978,0,,47575
5,697449,710926,dup,HG00159,0,,13477
5,714988,733938,dup,HG00159,0,,18950
5,757676,778933,dup,HG00136,0,,21257
5,788137,797761,dup,HG00123,0,,9624
5,814446,825367,dup,HG00123,0,,10921
5,856227,877937,dup,HG00245,0,,21710
5,952102,1049222,dup,HG03040,0,,97120
5,964859,976324,dup,HG03978,0,,11465
5,1000871,1054743,dup,HG03040,0,,53872
5,1039104,1201088,dup,HG00139,0,,161984
5,1086859,1259822,dup,HG00139,0,,172963
5,1228092,1245155,dup,HG02291,0,,17063
5,1295705,1331221,dup,HG00139,0,,35516
5,1344431,1382187,dup,HG00139,0,,37756
5,1603415,1622699,dup,HG03166,0,,19284
5,1638557,1833528,dup,HG00581,0,,194971
5,1641870,1744144,dup,HG03166,0,,102274
5,1893302,1945903,dup,HG03916,0,,52601
5,2632801,2638620,dup,HG02265,0,,5819
5,2983027,2988080,dup,HG03742,0,,5053
5,3218366,3225014,dup,HG03744,0,,6648
5,3566433,3591172,dup,HG01121,0,,24739
5,4221449,4294504,dup,HG00244,0,,73055
5,4234471,4264425,dup,HG00244,0,,29954
5,4524203,4528514,dup,HG01915,0,,4311
5,4950685,5421029,dup,HG00117,0,,470344
5,4971939,5073176,dup,HG00117,0,,101237
5,5098882,5240499,dup,HG00117,0,,141617
5,5243497,5359315,dup,HG00117,0,,115818
5,5361195,5387926,dup,HG00117,0,,26731
5,5400731,5427088,dup,HG00117,0,,26357
5,5681945,5719273,dup,HG01606,0,,37328
5,5682780,5713828,dup,HG00319,0,,31048
5,6511573,6515222,dup,HG00177,0,,3649
5,7173649,7193726,dup,HG00160,0,,20077
5,9874783,9887877,dup,HG03382,0,,13094
5,9901195,9924345,dup,HG01108,0,,23150
5,10105690,10189706,dup,HG01396,0,,84016
5,10119391,10178312,dup,HG01396,0,,58921
5,10139867,10177934,dup,HG01396,0,,38067
5,11166142,11179922,dup,HG02060,0,,13780
5,12162802,12178627,dup,HG02667,0,,15825
5,12188723,12270356,dup,HG02667,0,,81633
5,12680805,12830133,dup,HG04131,0,,149328
5,13064469,13098130,dup,HG04026,0,,33661
5,13150442,13197115,dup,NA20761,0,,46673
5,13359237,13391335,dup,HG02545,0,,32098
5,13791375,13905006,dup,HG03175,0,,113631
5,13792100,14184282,dup,HG03175,0,,392182
5,13816947,14092729,dup,HG03175,0,,275782
5,14075395,14184668,dup,HG00186,0,,109273
5,14980195,15134366,dup,HG02808,0,,154171
5,14980257,15059964,dup,HG02808,0,,79707
5,16528152,16533090,dup,HG00699,0,,4938
5,16954057,17014239,dup,HG02410,0,,60182
5,16960689,16996855,dup,HG02410,0,,36166
5,17000405,17012042,dup,NA10847,0,,11637
5,17412662,17483745,dup,HG02623,0,,71083
5,17482137,17517650,dup,HG00536,0,,35513
5,17599748,17606279,dup,HG00111,0,,6531
5,17609342,17621361,dup,HG00111,0,,12019
5,17616816,17632004,dup,HG00111,0,,15188
5,17647751,17670243,dup,HG00442,0,,22492
5,17664474,17692285,dup,HG00258,0,,27811
5,17716741,17734989,dup,HG00181,0,,18248
5,17960118,17996512,dup,NA19393,0,,36394
5,18595077,18676014,dup,HG02322,0,,80937
5,18610715,18630561,dup,HG02589,0,,19846
5,18623971,18670624,dup,HG03442,0,,46653
5,18831252,18866299,dup,HG00321,0,,35047
5,18873813,18981184,dup,NA19786,0,,107371
5,18987847,18993355,dup,HG02676,0,,5508
5,19018123,19168073,dup,NA20544,0,,149950
5,19193871,19286635,dup,NA20544,0,,92764
5,19383839,19396485,dup,HG01464,0,,12646
5,19447999,19473251,dup,HG03354,0,,25252
5,20083368,20113566,dup,NA18577,0,,30198
5,20085111,20111053,dup,NA18577,0,,25942
5,21021822,21269432,dup,HG01269,0,,247610
5,21588445,21611561,dup,NA20757,0,,23116
5,21619749,21708092,dup,NA20757,0,,88343
5,21714745,21725624,dup,HG00266,0,,10879
5,22127047,22247299,dup,HG01804,0,,120252
5,22139516,22173754,dup,HG00096,0,,34238
5,22305068,22363549,dup,NA12842,0,,58481
5,22307959,22318708,dup,NA21126,0,,10749
5,22313357,22352652,dup,NA12842,0,,39295
5,22355314,22378140,dup,HG01102,0,,22826
5,22371740,22425561,dup,HG01281,0,,53821
5,22392419,22422231,dup,HG01281,0,,29812
5,22503162,22624797,dup,HG01804,0,,121635
5,23174631,23195291,dup,NA20525,0,,20660
5,25335775,25387204,dup,HG03136,0,,51429
5,25926207,25930117,dup,NA19027,0,,3910
5,26834697,26890326,dup,NA12717,0,,55629
5,26892727,27234012,dup,NA12717,0,,341285
5,27369464,27428774,dup,NA12717,0,,59310
5,27433951,27564525,dup,NA12717,0,,130574
5,27638922,27782528,dup,NA12717,0,,143606
5,27665391,27673173,dup,NA19783,0,,7782
5,28034190,28167257,dup,NA12717,0,,133067
5,28184594,28196399,dup,HG01200,0,,11805
5,28213967,28321236,dup,NA12717,0,,107269
5,28325554,28334834,dup,HG00851,0,,9280
5,28640868,28729791,dup,HG02122,0,,88923
5,29077028,29204488,dup,NA12717,0,,127460
5,29166467,29230255,dup,HG01936,0,,63788
5,29236723,29428142,dup,NA12717,0,,191419
5,29263325,29278506,dup,HG03743,0,,15181
5,29456247,29575899,dup,NA12717,0,,119652
5,29584364,29589501,dup,HG00699,0,,5137
5,29624360,29636264,dup,HG00108,0,,11904
5,29659347,29780742,dup,NA12717,0,,121395
5,29724399,29735176,dup,NA18948,0,,10777
5,29812586,29841623,dup,NA19332,0,,29037
5,29860379,30121293,dup,NA12717,0,,260914
5,30475367,30567255,dup,NA20587,0,,91888
5,30527565,30787848,dup,NA12717,0,,260283
5,30794216,30932729,dup,NA12717,0,,138513
5,30966303,31121010,dup,NA12717,0,,154707
5,31135050,31452135,dup,NA12717,0,,317085
5,31525736,32360166,dup,NA12717,0,,834430
5,31646447,31679867,dup,HG00139,0,,33420
5,31647717,31667604,dup,HG00139,0,,19887
5,31697817,31772821,dup,NA12717,0,,75004
5,31729402,31739919,dup,HG01885,0,,10517
5,31948398,32125666,dup,HG03832,0,,177268
5,31959478,32006639,dup,HG03832,0,,47161
5,32102676,32202739,dup,HG00341,0,,100063
5,32105468,32126730,dup,HG00341,0,,21262
5,32463030,32522979,dup,HG03832,0,,59949
5,32464776,32512957,dup,HG03832,0,,48181
5,32625565,32725574,dup,NA12717,0,,100009
5,32735996,32960283,dup,NA12717,0,,224287
5,32968672,33129765,dup,NA12717,0,,161093
5,33150958,33324517,dup,HG01250,0,,173559
5,33174260,33203812,dup,HG01250,0,,29552
5,33184384,33220759,dup,HG01250,0,,36375
5,33253380,33269589,dup,HG01250,0,,16209
5,33280502,33574682,dup,NA12717,0,,294180
5,33291252,33324517,dup,HG03604,0,,33265
5,33525574,33658003,dup,NA12717,0,,132429
5,33702699,33752131,dup,NA12717,0,,49432
5,33888743,33940620,dup,NA12717,0,,51877
5,33947570,34004990,dup,NA12717,0,,57420
5,34258998,34564136,dup,NA12717,0,,305138
5,34401772,34409835,dup,HG02143,0,,8063
5,34492726,34936311,dup,NA12717,0,,443585
5,34558868,34655760,dup,HG00189,0,,96892
5,34575993,34661890,dup,NA12717,0,,85897
5,34661891,34882683,dup,NA12717,0,,220792
5,34888192,34922317,dup,NA12717,0,,34125
5,34934772,35064147,dup,NA12717,0,,129375
5,35110795,35228580,dup,NA12717,0,,117785
5,35355090,35366942,dup,NA20900,0,,11852
5,35492285,35566847,dup,NA12717,0,,74562
5,35501808,35563094,dup,NA18877,0,,61286
5,35513586,36501676,dup,NA12717,0,,988090
5,35709791,35762492,dup,NA12717,0,,52701
5,36217890,36239959,dup,NA12717,0,,22069
5,36242903,36377435,dup,NA12717,0,,134532
5,36398468,36438636,dup,NA19625,0,,40168
5,36613144,36726850,dup,NA12717,0,,113706
5,37145474,37511131,dup,HG04006,0,,365657
5,37180399,37213166,dup,HG02973,0,,32767
5,37207176,37309633,dup,HG04006,0,,102457
5,37264695,37293413,dup,HG04006,0,,28718
5,37415357,37513798,dup,HG04006,0,,98441
5,37515237,37546923,dup,HG02180,0,,31686
5,37537749,37597777,dup,HG02180,0,,60028
5,37721014,37849032,dup,NA12717,0,,128018
5,37854146,37998005,dup,NA12717,0,,143859
5,37912909,37928666,dup,HG02763,0,,15757
5,38056739,38805964,dup,NA12717,0,,749225
5,38165704,38201672,dup,HG00542,0,,35968
5,38221667,38446117,dup,NA12717,0,,224450
5,38395634,38507398,dup,NA19900,0,,111764
5,38622962,38816368,dup,NA12717,0,,193406
5,38961430,39069596,dup,NA12717,0,,108166
5,39072467,39193418,dup,HG03479,0,,120951
5,39178151,39183482,dup,HG03774,0,,5331
5,39235519,39382763,dup,NA12717,0,,147244
5,39385249,39627532,dup,NA12717,0,,242283
5,39638973,39736753,dup,NA12717,0,,97780
5,39795773,39900001,dup,NA12717,0,,104228
5,39968754,39976611,dup,HG01880,0,,7857
5,40138175,40308370,dup,NA12717,0,,170195
5,40315007,40379418,dup,NA12717,0,,64411
5,40385843,40505269,dup,NA12717,0,,119426
5,40902912,40933815,dup,NA18566,0,,30903
5,40939140,41084056,dup,NA18566,0,,144916
5,41127489,41285267,dup,NA12717,0,,157778
5,41252939,41390064,dup,NA19038,0,,137125
5,41261968,41447049,dup,NA12717,0,,185081
5,41473444,41577083,dup,NA12717,0,,103639
5,41564154,41583570,dup,NA18942,0,,19416
5,41564154,41600321,dup,HG00675,0,,36167
5,41591881,41992855,dup,NA12717,0,,400974
5,41866499,41966498,dup,HG02716,0,,99999
5,41870516,41961862,dup,HG02716,0,,91346
5,42091843,42095992,dup,HG00553,0,,4149
5,42158109,42229250,dup,NA12717,0,,71141
5,42236816,42493136,dup,NA12717,0,,256320
5,42501321,42624836,dup,NA12717,0,,123515
5,42628085,42758107,dup,NA12717,0,,130022
5,42828552,42959100,dup,NA12717,0,,130548
5,42828571,42908992,dup,NA18599,0,,80421
5,42828778,42956835,dup,NA12717,0,,128057
5,43321064,43334800,dup,NA19712,0,,13736
5,43343921,43405424,dup,NA12717,0,,61503
5,43397397,43408939,dup,HG01770,0,,11542
5,43496406,43611698,dup,NA12717,0,,115292
5,43612808,43675166,dup,NA12717,0,,62358
5,44189473,44195847,dup,HG02461,0,,6374
5,45088588,45128044,dup,HG04158,0,,39456
5,45191828,45221380,dup,HG01883,0,,29552
5,45823990,45844490,dup,HG04100,0,,20500
5,45831253,45902810,dup,HG01513,0,,71557
5,49441645,49455684,dup,HG00266,0,,14039
5,49586584,49591410,dup,HG01597,0,,4826
5,49619711,49629196,dup,HG03593,0,,9485
5,49854415,49942569,dup,NA19749,0,,88154
5,50002127,50022347,dup,NA19070,0,,20220
5,51035034,51051381,dup,HG02682,0,,16347
5,51205058,51228343,dup,HG03461,0,,23285
5,51995594,52017142,dup,NA19900,0,,21548
5,53356332,53368400,dup,HG02102,0,,12068
5,53688156,53694142,dup,HG00513,0,,5986
5,53864566,53870855,dup,HG01893,0,,6289
5,54087329,54111114,dup,HG00671,0,,23785
5,57049627,57122610,dup,HG02601,0,,72983
5,57320371,57338133,dup,HG00096,0,,17762
5,57426790,57458414,dup,HG03697,0,,31624
5,59354083,59359129,dup,HG00410,0,,5046
5,59397194,59434828,dup,NA20863,0,,37634
5,59398726,59437142,dup,NA20863,0,,38416
5,59710152,59775708,dup,HG00260,0,,65556
5,59712744,59772543,dup,HG00115,0,,59799
5,60376860,60395396,dup,HG02130,0,,18536
5,60402415,60445168,dup,HG00145,0,,42753
5,60983727,60994675,dup,HG02028,0,,10948
5,61619982,61654643,dup,HG03823,0,,34661
5,61624018,61833468,dup,HG03823,0,,209450
5,61648446,61690932,dup,HG03823,0,,42486
5,61713214,61730099,dup,HG03823,0,,16885
5,61738580,61745974,dup,HG03823,0,,7394
5,61760546,61828393,dup,HG03823,0,,67847
5,61950533,62068720,dup,HG02179,0,,118187
5,61958288,61990335,dup,HG02179,0,,32047
5,61993819,62016612,dup,HG02179,0,,22793
5,62128941,62150451,dup,HG02179,0,,21510
5,62948041,62960280,dup,HG02476,0,,12239
5,62960883,62972960,dup,NA19731,0,,12077
5,63364652,63388706,dup,HG00404,0,,24054
5,63441523,63446344,dup,HG00237,0,,4821
5,63777482,63792726,dup,HG03027,0,,15244
5,66105868,66133378,dup,HG00640,0,,27510
5,66313269,66330113,dup,NA20870,0,,16844
5,66575925,66591388,dup,HG01707,0,,15463
5,66580943,66602203,dup,NA20758,0,,21260
5,66592428,66601726,dup,HG03019,0,,9298
5,68290214,68293223,dup,HG00260,0,,3009
5,68591802,68644283,dup,HG01980,0,,52481
5,68593981,68609551,dup,HG01980,0,,15570
5,70306516,70313302,dup,HG00128,0,,6786
5,71957897,72040583,dup,HG02577,0,,82686
5,73075792,73080313,dup,HG04202,0,,4521
5,73980203,74001022,dup,NA12749,0,,20819
5,73982446,73989695,dup,NA12749,0,,7249
5,75430723,75450441,dup,NA12154,0,,19718
5,75431218,75457960,dup,NA12154,0,,26742
5,76056808,76069895,dup,HG01503,0,,13087
5,76085534,76136178,dup,HG00146,0,,50644
5,76839033,76843886,dup,HG02445,0,,4853
5,77811027,77815789,dup,HG03969,0,,4762
5,78375131,78389234,dup,HG00185,0,,14103
5,78803012,78834934,dup,NA12383,0,,31922
5,78824170,78861127,dup,HG03372,0,,36957
5,78827277,79067991,dup,HG03372,0,,240714
5,78890390,78906769,dup,HG03372,0,,16379
5,78923050,78948901,dup,HG03372,0,,25851
5,78967879,79069778,dup,HG03372,0,,101899
5,79363896,79462624,dup,HG03372,0,,98728
5,79428483,79435558,dup,HG03372,0,,7075
5,79449334,79465344,dup,HG03372,0,,16010
5,79462626,79683257,dup,HG00096,0,,220631
5,79594162,79617434,dup,HG03372,0,,23272
5,79664033,79697035,dup,HG03372,0,,33002
5,79697937,79898752,dup,HG03372,0,,200815
5,79856409,79880987,dup,HG03372,0,,24578
5,79939727,79952105,dup,NA19682,0,,12378
5,80702795,80769776,dup,HG03687,0,,66981
5,80743851,80938336,dup,HG03687,0,,194485
5,80776050,80846599,dup,NA11918,0,,70549
5,80831624,80906453,dup,HG03687,0,,74829
5,80918882,80932206,dup,NA18618,0,,13324
5,81421525,81429563,dup,HG00406,0,,8038
5,82017858,82041025,dup,HG00154,0,,23167
5,83755379,83787263,dup,HG01161,0,,31884
5,84009219,84116570,dup,HG02778,0,,107351
5,84010609,84114350,dup,HG02778,0,,103741
5,84386820,84557667,dup,HG00361,0,,170847
5,84660051,84694363,dup,HG02386,0,,34312
5,84832435,84960335,dup,HG03837,0,,127900
5,84836261,84904568,dup,HG03837,0,,68307
5,85108030,85111203,dup,HG01241,0,,3173
5,87279977,87365786,dup,HG01945,0,,85809
5,89657266,89676019,dup,NA20504,0,,18753
5,90611309,90627643,dup,NA18953,0,,16334
5,92293165,92300194,dup,HG00137,0,,7029
5,93101368,93105929,dup,NA18971,0,,4561
5,94348119,94415467,dup,HG04158,0,,67348
5,95042173,95049016,dup,HG01804,0,,6843
5,95299666,95455667,dup,NA18582,0,,156001
5,95308421,95453479,dup,NA18582,0,,145058
5,96404071,96540171,dup,HG02121,0,,136100
5,96408385,96478102,dup,HG02121,0,,69717
5,96495135,96541983,dup,HG02121,0,,46848
5,96557771,96656369,dup,HG00584,0,,98598
5,96559377,96629275,dup,HG00584,0,,69898
5,97012385,97035652,dup,HG02017,0,,23267
5,97018277,97039288,dup,HG02017,0,,21011
5,97050505,97128253,dup,HG00106,0,,77748
5,97087783,97129503,dup,NA12283,0,,41720
5,97125784,97144033,dup,HG02136,0,,18249
5,97208196,97236556,dup,HG03624,0,,28360
5,97256889,97291841,dup,NA18968,0,,34952
5,97421089,97499613,dup,NA20753,0,,78524
5,97476286,97568464,dup,HG03572,0,,92178
5,97815864,97911138,dup,HG01607,0,,95274
5,97963771,97969629,dup,HG04020,0,,5858
5,98434356,98489483,dup,HG02648,0,,55127
5,98435657,98578842,dup,HG02648,0,,143185
5,98625437,98633021,dup,HG02491,0,,7584
5,98764339,98804814,dup,HG01495,0,,40475
5,98823932,98833385,dup,HG01577,0,,9453
5,99071967,99115249,dup,NA19080,0,,43282
5,99162038,99173547,dup,NA19080,0,,11509
5,99168814,99185566,dup,NA19762,0,,16752
5,99190523,99338637,dup,HG02804,0,,148114
5,99197965,99281369,dup,HG02804,0,,83404
5,99284927,99324357,dup,NA21107,0,,39430
5,99404547,99504494,dup,HG03073,0,,99947
5,99415701,99712038,dup,HG03073,0,,296337
5,99632538,99703992,dup,HG03073,0,,71454
5,99749902,99803821,dup,HG01610,0,,53919
5,99943057,100099596,dup,HG00478,0,,156539
5,100008770,100096175,dup,HG00478,0,,87405
5,100907191,101067809,dup,HG01348,0,,160618
5,100913350,100944494,dup,HG02219,0,,31144
5,100941237,100979596,dup,HG02219,0,,38359
5,100982898,101108646,dup,HG01348,0,,125748
5,100985941,101016489,dup,HG01348,0,,30548
5,101192762,101261608,dup,HG02219,0,,68846
5,101200643,101239536,dup,HG02219,0,,38893
5,101489653,101569583,dup,NA19064,0,,79930
5,101502822,101530915,dup,HG00232,0,,28093
5,101524822,101552395,dup,HG02583,0,,27573
5,101696373,101748151,dup,HG03837,0,,51778
5,101735096,101834266,dup,HG03837,0,,99170
5,101794615,101844944,dup,NA20881,0,,50329
5,101828235,101842379,dup,NA20881,0,,14144
5,102496272,102611460,dup,HG01786,0,,115188
5,102599626,102642846,dup,HG03118,0,,43220
5,102599825,102713775,dup,NA12046,0,,113950
5,102644272,102769754,dup,NA12046,0,,125482
5,102726568,102879991,dup,NA12046,0,,153423
5,102755446,102776462,dup,NA12046,0,,21016
5,102793753,102835166,dup,HG00364,0,,41413
5,102840034,102881377,dup,NA19025,0,,41343
5,102885672,103048429,dup,NA19025,0,,162757
5,103054135,103135996,dup,NA19025,0,,81861
5,103062746,103072091,dup,HG00331,0,,9345
5,103074579,103113776,dup,NA19025,0,,39197
5,103399601,103406654,dup,HG00319,0,,7053
5,103697025,103788913,dup,HG02727,0,,91888
5,103847117,103963160,dup,NA21122,0,,116043
5,103954738,103974913,dup,NA19152,0,,20175
5,104196567,104343271,dup,HG02976,0,,146704
5,104234956,104266374,dup,HG02976,0,,31418
5,104429223,104506021,dup,HG00240,0,,76798
5,104536373,104629721,dup,HG03815,0,,93348
5,104586098,104626433,dup,HG03815,0,,40335
5,104646207,104730581,dup,HG01980,0,,84374
5,106032724,106047323,dup,NA19746,0,,14599
5,106529837,106534465,dup,HG03711,0,,4628
5,109273399,109305568,dup,HG00255,0,,32169
5,109274377,109329166,dup,HG00255,0,,54789
5,109293298,109475582,dup,HG00258,0,,182284
5,109474762,109489773,dup,HG00112,0,,15011
5,109572219,109632844,dup,HG01785,0,,60625
5,110415464,110450342,dup,NA20803,0,,34878
5,110602861,110633808,dup,NA20803,0,,30947
5,111010136,111083182,dup,NA20803,0,,73046
5,111091731,111250495,dup,NA20803,0,,158764
5,111265331,111335609,dup,HG04063,0,,70278
5,111394518,111529302,dup,HG02262,0,,134784
5,111438237,111476444,dup,HG01187,0,,38207
5,111612621,111628000,dup,HG04140,0,,15379
5,111708073,111732609,dup,HG03756,0,,24536
5,112506946,112523908,dup,HG03995,0,,16962
5,112936666,112950240,dup,HG00345,0,,13574
5,112964414,112992931,dup,HG03777,0,,28517
5,113474740,113514469,dup,HG01251,0,,39729
5,113840433,113996038,dup,HG01112,0,,155605
5,114207545,114216342,dup,HG01939,0,,8797
5,114516942,114539849,dup,HG03971,0,,22907
5,115408794,115440761,dup,NA19083,0,,31967
5,115414541,115636855,dup,NA19083,0,,222314
5,115461026,115471251,dup,HG02462,0,,10225
5,115473502,115515378,dup,HG02685,0,,41876
5,115544617,115603349,dup,NA19083,0,,58732
5,115562465,115607289,dup,HG01108,0,,44824
5,115649894,115717552,dup,HG03770,0,,67658
5,116362087,116399232,dup,NA21122,0,,37145
5,116955815,116982299,dup,NA21142,0,,26484
5,116977749,117024286,dup,HG04212,0,,46537
5,117581371,117607221,dup,HG02769,0,,25850
5,117583457,117600284,dup,HG02769,0,,16827
5,117767564,117883169,dup,NA07056,0,,115605
5,117823448,117863940,dup,NA07056,0,,40492
5,117832693,117848526,dup,HG04047,0,,15833
5,117836068,117964839,dup,HG02790,0,,128771
5,117884603,117951290,dup,HG02790,0,,66687
5,118028813,118132412,dup,HG04164,0,,103599
5,118100755,118236309,dup,HG04164,0,,135554
5,118157025,118318059,dup,HG04164,0,,161034
5,118516444,118591864,dup,NA19759,0,,75420
5,118652041,118685795,dup,NA20504,0,,33754
5,119253151,119284201,dup,HG02611,0,,31050
5,119289543,119367022,dup,HG02611,0,,77479
5,119370251,119380083,dup,HG03729,0,,9832
5,119389400,119405972,dup,HG01917,0,,16572
5,119434124,119606851,dup,NA19054,0,,172727
5,119468915,119575731,dup,NA19054,0,,106816
5,119573807,119596181,dup,HG00259,0,,22374
5,119580409,119598127,dup,HG00259,0,,17718
5,119871984,119901008,dup,HG02178,0,,29024
5,119931290,119946965,dup,HG02178,0,,15675
5,119966828,119989564,dup,HG02178,0,,22736
5,119983084,120006447,dup,HG02017,0,,23363
5,120008555,120033876,dup,HG02178,0,,25321
5,120046975,120061181,dup,HG01626,0,,14206
5,120054299,120073570,dup,HG01079,0,,19271
5,120220544,120324191,dup,HG01326,0,,103647
5,120246982,120266531,dup,HG03672,0,,19549
5,120287271,120418226,dup,HG01326,0,,130955
5,120330478,120364199,dup,HG01326,0,,33721
5,120369117,120425362,dup,HG01326,0,,56245
5,120425363,120529003,dup,HG01326,0,,103640
5,120670972,120682140,dup,NA19080,0,,11168
5,120681641,120695247,dup,NA20514,0,,13606
5,120691404,120707344,dup,NA20514,0,,15940
5,120825087,120845988,dup,HG04194,0,,20901
5,121087664,121094015,dup,HG00531,0,,6351
5,122538757,122549337,dup,NA20897,0,,10580
5,122591883,122633454,dup,NA18579,0,,41571
5,123994560,124004308,dup,HG03692,0,,9748
5,124251638,124255541,dup,HG01866,0,,3903
5,124330375,124400638,dup,HG01495,0,,70263
5,124416590,124624990,dup,HG01495,0,,208400
5,124626478,124743728,dup,HG01495,0,,117250
5,125271662,125279094,dup,HG03577,0,,7432
5,125669006,125685396,dup,HG03121,0,,16390
5,125756972,125808080,dup,NA20758,0,,51108
5,125760007,125879269,dup,NA20758,0,,119262
5,125760606,126098972,dup,NA20758,0,,338366
5,125811297,125963911,dup,NA20758,0,,152614
5,125968978,126104140,dup,NA20758,0,,135162
5,126011440,126022687,dup,HG02651,0,,11247
5,126230402,126241621,dup,HG00742,0,,11219
5,126724514,126730762,dup,HG01085,0,,6248
5,127249945,127264868,dup,HG02224,0,,14923
5,128289957,128304919,dup,HG03790,0,,14962
5,128330676,128339350,dup,NA19451,0,,8674
5,128665687,128747184,dup,NA07000,0,,81497
5,128763733,128779111,dup,NA19759,0,,15378
5,128873776,128881915,dup,HG01136,0,,8139
5,129405001,129410526,dup,NA19054,0,,5525
5,130082519,130088716,dup,HG03235,0,,6197
5,130940634,130974279,dup,NA20317,0,,33645
5,131373855,131394806,dup,HG03445,0,,20951
5,131380869,131394647,dup,HG03445,0,,13778
5,132085631,132099716,dup,HG01556,0,,14085
5,132196596,132246510,dup,HG01950,0,,49914
5,132501241,132522057,dup,NA07347,0,,20816
5,133126524,133130876,dup,HG01031,0,,4352
5,133134295,133154144,dup,HG04047,0,,19849
5,134753607,134758106,dup,HG03127,0,,4499
5,135892608,135902185,dup,HG03461,0,,9577
5,136394436,136442665,dup,HG04063,0,,48229
5,136411938,136442394,dup,HG04063,0,,30456
5,136452741,136457988,dup,HG02462,0,,5247
5,136851113,136857394,dup,HG00096,0,,6281
5,136878813,136884246,dup,HG02724,0,,5433
5,137192351,137208762,dup,HG00513,0,,16411
5,137192546,137460222,dup,HG00513,0,,267676
5,137253329,137286261,dup,HG00513,0,,32932
5,137436591,137448251,dup,HG00442,0,,11660
5,137736002,137745383,dup,HG00131,0,,9381
5,138398234,138444390,dup,HG04161,0,,46156
5,138777624,138783164,dup,HG00458,0,,5540
5,140215749,140222045,dup,HG00145,0,,6296
5,140274669,140284694,dup,HG00171,0,,10025
5,140554408,140558942,dup,HG00097,0,,4534
5,140568452,140572702,dup,HG01771,0,,4250
5,140582952,140590510,dup,HG03111,0,,7558
5,140596803,140600846,dup,HG01880,0,,4043
5,140721034,140724833,dup,NA20332,0,,3799
5,140731847,140740978,dup,NA20589,0,,9131
5,140769337,140777530,dup,HG01344,0,,8193
5,140794615,140809794,dup,HG00321,0,,15179
5,141809116,142445189,dup,HG03837,0,,636073
5,141809151,141966860,dup,HG03837,0,,157709
5,141811104,141894528,dup,HG03837,0,,83424
5,141992960,142171747,dup,HG03837,0,,178787
5,142174919,142260351,dup,HG00130,0,,85432
5,142263109,142447062,dup,HG00592,0,,183953
5,143147648,143152787,dup,HG01988,0,,5139
5,143420128,143424969,dup,HG00137,0,,4841
5,143966334,144260397,dup,HG01253,0,,294063
5,144673887,144716956,dup,HG01142,0,,43069
5,145045512,145070460,dup,HG00689,0,,24948
5,147323983,147338197,dup,HG02420,0,,14214
5,147400043,147593175,dup,HG02032,0,,193132
5,147603873,147742858,dup,HG02032,0,,138985
5,147743891,147750140,dup,HG03267,0,,6249
5,148639957,148732845,dup,HG00707,0,,92888
5,148639999,148694083,dup,NA21144,0,,54084
5,148826949,148872387,dup,HG03817,0,,45438
5,148827365,148850404,dup,HG00272,0,,23039
5,148831740,148871111,dup,HG03817,0,,39371
5,148992414,149054333,dup,HG01342,0,,61919
5,148994506,149047805,dup,HG02854,0,,53299
5,149299626,149303728,dup,HG00113,0,,4102
5,150032134,150048945,dup,NA20513,0,,16811
5,150032170,150049851,dup,NA20588,0,,17681
5,151399693,151417334,dup,HG01947,0,,17641
5,151956986,151961485,dup,HG01894,0,,4499
5,152321236,152409295,dup,HG03926,0,,88059
5,152584463,152597600,dup,HG00463,0,,13137
5,153301322,153324553,dup,NA19086,0,,23231
5,154438124,154523795,dup,HG03268,0,,85671
5,154439285,154498750,dup,HG03268,0,,59465
5,154478750,154526229,dup,NA18963,0,,47479
5,154910504,154929081,dup,HG00121,0,,18577
5,155294406,155306850,dup,HG02624,0,,12444
5,155475886,155488649,dup,HG00100,0,,12763
5,155566445,155591598,dup,HG01061,0,,25153
5,155793848,155840217,dup,HG02102,0,,46369
5,156265789,156323975,dup,HG02645,0,,58186
5,156266556,156482065,dup,HG02645,0,,215509
5,156372692,156419004,dup,HG02645,0,,46312
5,156375509,156401374,dup,HG02645,0,,25865
5,156396774,156479831,dup,HG02645,0,,83057
5,156703017,156707344,dup,HG03603,0,,4327
5,157095130,157132498,dup,NA12762,0,,37368
5,157125548,157141017,dup,HG03714,0,,15469
5,158180107,158332137,dup,HG01528,0,,152030
5,158703831,158905328,dup,HG01528,0,,201497
5,159344411,159462617,dup,HG01528,0,,118206
5,159346337,159376661,dup,HG01528,0,,30324
5,159379012,159478803,dup,HG01528,0,,99791
5,159485942,159507634,dup,NA19779,0,,21692
5,159488314,159509076,dup,HG01528,0,,20762
5,159530565,159698710,dup,HG01528,0,,168145
5,159563727,159841193,dup,HG01528,0,,277466
5,159733547,159849748,dup,HG01528,0,,116201
5,159860063,159995524,dup,HG01528,0,,135461
5,159985989,160034729,dup,NA21097,0,,48740
5,160186794,160229863,dup,HG01528,0,,43069
5,160275689,160469775,dup,HG04238,0,,194086
5,160294467,160328762,dup,HG04238,0,,34295
5,160610985,160729085,dup,HG01528,0,,118100
5,160959716,161137417,dup,HG01528,0,,177701
5,161375618,161391742,dup,NA19390,0,,16124
5,161530567,161567427,dup,HG01528,0,,36860
5,161605584,161748826,dup,HG01705,0,,143242
5,161618264,161642994,dup,HG01705,0,,24730
5,162149352,162289645,dup,HG01528,0,,140293
5,162214998,162252210,dup,HG03716,0,,37212
5,162235753,162251919,dup,HG01528,0,,16166
5,162467355,162580760,dup,HG03091,0,,113405
5,162763887,162771692,dup,HG03908,0,,7805
5,162852998,162881532,dup,HG02147,0,,28534
5,163200518,163297714,dup,HG02890,0,,97196
5,163206507,163239131,dup,HG02890,0,,32624
5,163252833,163291357,dup,HG02890,0,,38524
5,163779968,163948913,dup,NA21090,0,,168945
5,164034726,164251255,dup,NA21090,0,,216529
5,164174239,164188274,dup,HG01686,0,,14035
5,165373902,165384573,dup,NA19189,0,,10671
5,165403580,165407249,dup,HG01577,0,,3669
5,166450988,166490923,dup,HG01848,0,,39935
5,166452015,166490010,dup,HG01848,0,,37995
5,168048264,168069225,dup,HG03838,0,,20961
5,168706649,168713403,dup,HG03342,0,,6754
5,169378987,169384304,dup,NA18646,0,,5317
5,170411404,170421066,dup,NA18957,0,,9662
5,170902450,170910575,dup,HG03850,0,,8125
5,171264097,171275719,dup,HG02386,0,,11622
5,172087397,172152779,dup,HG02667,0,,65382
5,174170512,174215778,dup,NA20529,0,,45266
5,174796638,174870030,dup,HG01795,0,,73392
5,174871789,175044458,dup,HG00263,0,,172669
5,175040386,175064498,dup,HG03136,0,,24112
5,175353978,175371353,dup,HG00096,0,,17375
5,175426163,175438679,dup,HG00766,0,,12516
5,175503582,175515937,dup,HG01444,0,,12355
5,175525664,175598662,dup,HG02895,0,,72998
5,175556437,175640012,dup,HG00186,0,,83575
5,176180573,176300256,dup,HG00237,0,,119683
5,176457279,176465722,dup,HG03823,0,,8443
5,177045750,177089820,dup,NA18558,0,,44070
5,177110993,177144008,dup,HG01197,0,,33015
5,177258528,177271912,dup,HG00531,0,,13384
5,177379412,177389521,dup,NA19735,0,,10109
5,177388728,177401036,dup,HG00190,0,,12308
5,177826137,177879142,dup,HG00237,0,,53005
5,178134315,178153985,dup,HG03787,0,,19670
5,178431804,178445012,dup,HG02769,0,,13208
5,178540083,178546735,dup,HG01985,0,,6652
5,178548886,178563586,dup,HG00596,0,,14700
5,178726268,178935685,dup,HG00463,0,,209417
5,178728980,178840451,dup,HG00463,0,,111471
5,178957395,179029606,dup,HG01817,0,,72211
5,178994061,179003068,dup,HG01817,0,,9007
5,179522523,179531721,dup,HG03572,0,,9198
5,179796514,179826455,dup,HG00266,0,,29941
5,179796739,179811538,dup,HG01965,0,,14799
5,179813806,179824675,dup,HG00629,0,,10869
5,179862232,179888998,dup,NA18562,0,,26766
5,179870803,179967294,dup,NA19920,0,,96491
5,179882672,179935212,dup,HG00126,0,,52540
5,180111246,180156687,dup,HG01709,0,,45441
5,180111834,180218723,dup,HG01709,0,,106889
5,180175781,180200852,dup,HG00105,0,,25071
5,180191079,180218148,dup,HG01709,0,,27069
5,180212700,180224650,dup,HG01709,0,,11950
5,180375655,180420806,dup,HG00096,0,,45151
5,180430202,180481245,dup,HG01094,0,,51043
5,180488061,180493316,dup,NA19375,0,,5255
5,180522765,180610522,dup,HG01248,0,,87757
5,180525269,180551144,dup,HG01248,0,,25875
5,180561922,180591679,dup,HG01248,0,,29757
5,180590997,180596661,dup,HG00099,0,,5664
5,180668739,180698680,dup,HG01678,0,,29941
5,180669253,180710114,dup,HG01678,0,,40861
6,6254437,6257058,del,NA19437,0,,2621
6,170685416,170685872,del,HG00584,0,,456
6,72862516,72868122,del,NA12400,0,,5606
6,149971270,149975607,del,HG00734,0,,4337
6,142165314,142168514,del,NA18565,0,,3200
6,138947735,138948055,del,HG01350,0,,320
6,162496355,162506952,del,NA19463,0,,10597
6,7781563,7782512,del,NA20507,0,,949
6,160086416,160089822,del,HG00320,0,,3406
6,151485950,151487021,del,NA19082,0,,1071
6,113368575,113371456,del,NA19081,0,,2881
6,32519285,32545310,del,NA19003,0,,26025
6,8432495,8435225,del,HG00463,0,,2730
6,27826396,27827264,del,NA20518,0,,868
6,96029760,96030179,del,HG01073,0,,419
6,31250669,31330446,del,NA12341,0,,79777
6,44337496,44338923,del,NA11992,0,,1427
6,119741334,119752970,del,HG00634,0,,11636
6,150753523,150755064,del,NA19383,0,,1541
6,52652870,52691458,del,NA18564,0,,38588
6,2568175,2571928,del,NA19453,0,,3753
6,9834328,9839323,del,HG00326,0,,4995
6,109252049,109253982,del,NA19108,0,,1933
6,95177104,95177355,del,NA20513,0,,251
6,57733598,57733675,del,HG00281,0,,77
6,63563666,63566018,del,NA19108,0,,2352
6,135351927,135353466,del,HG00337,0,,1539
6,167800463,167801934,del,NA19385,0,,1471
6,121961443,121970900,del,HG00186,0,,9457
6,57836801,58441733,del,HG01137,0,,604932
6,69142164,69143107,del,NA19470,0,,943
6,29920846,29922282,del,NA18520,0,,1436
6,38683566,38683796,del,HG00335,0,,230
6,155386352,155391615,del,NA18631,0,,5263
6,97468019,97470546,del,NA19700,0,,2527
6,170206023,170206856,del,NA11920,0,,833
6,17252642,17255044,del,NA12154,0,,2402
6,12042170,12042434,del,NA19350,0,,264
6,144196453,144199878,del,HG00732,0,,3425
6,164877401,164878440,del,HG01080,0,,1039
6,117269213,117271407,del,NA20756,0,,2194
6,163425770,163426837,del,NA19350,0,,1067
6,40517413,40518461,del,HG01095,0,,1048
6,26730430,26752305,del,HG00134,0,,21875
6,30336379,30336816,del,HG01187,0,,437
6,144647435,144654858,del,NA19311,0,,7423
6,101482612,101486896,del,NA19473,0,,4284
6,100741980,100743969,del,NA18602,0,,1989
6,106733863,106733991,del,NA19360,0,,128
6,147209953,147220224,del,NA18943,0,,10271
6,65710416,65715522,del,HG01067,0,,5106
6,67111012,67111370,del,NA19399,0,,358
6,878278,878565,del,NA19129,0,,287
6,34039757,34040507,del,NA12829,0,,750
6,142019774,142034369,del,NA12046,0,,14595
6,168691443,168691557,del,HG00321,0,,114
6,45613946,45614444,del,HG00418,0,,498
6,4272803,4273085,del,HG00321,0,,282
6,167880173,167880443,del,HG01070,0,,270
6,51739567,51745606,del,HG01133,0,,6039
6,154962605,154964587,del,HG01390,0,,1982
6,72827728,72834401,del,HG00554,0,,6673
6,15191312,15192561,del,HG01354,0,,1249
6,155918172,155919665,del,NA20529,0,,1493
6,126468007,126468244,del,NA19393,0,,237
6,32585103,32585465,del,HG01075,0,,362
6,162899466,162920183,del,NA20503,0,,20717
6,74741807,74791168,del,NA18964,0,,49361
6,16662571,16663213,del,NA20514,0,,642
6,30207808,30208227,del,HG00589,0,,419
6,77437466,77459672,del,NA19682,0,,22206
6,19041416,19049922,del,NA12275,0,,8506
6,136241567,136253486,del,NA18561,0,,11919
6,51063608,51063947,del,NA20520,0,,339
6,27372021,27373091,del,HG00237,0,,1070
6,32629736,32726620,del,NA18637,0,,96884
6,23908513,23909692,del,NA19334,0,,1179
6,151582068,151585711,del,HG01051,0,,3643
6,140782916,140807029,del,HG00249,0,,24113
6,18326432,18327802,del,HG00651,0,,1370
6,168954588,168954762,del,NA18523,0,,174
6,45040579,45144546,del,HG00160,0,,103967
6,4254913,4255367,del,NA19462,0,,454
6,103939866,103943220,del,HG01082,0,,3354
6,148506314,148506448,del,HG01550,0,,134
6,39061022,39062691,del,NA12043,0,,1669
6,66937813,66938400,del,NA19172,0,,587
6,41618834,41619283,del,NA12828,0,,449
6,108555490,108558673,del,NA19982,0,,3183
6,32440804,32557033,del,HG01462,0,,116229
6,29851517,29906344,del,HG00121,0,,54827
6,74592060,74602439,del,HG01383,0,,10379
6,73362006,73365104,del,NA18959,0,,3098
6,143378320,143378814,del,NA19396,0,,494
6,84922314,84922855,del,HG00346,0,,541
6,77449716,77454122,del,NA19700,0,,4406
6,12478909,12483429,del,NA19003,0,,4520
6,167312734,167313359,del,HG00463,0,,625
6,10521050,10522538,del,NA19920,0,,1488
6,169725808,169725913,del,HG00139,0,,105
6,10740679,10744946,del,NA19395,0,,4267
6,32511943,32512212,del,HG01108,0,,269
6,122460038,122460521,del,HG00329,0,,483
6,63597634,63598985,del,NA18949,0,,1351
6,10761076,10761345,del,NA18488,0,,269
6,87181764,87183114,del,NA11893,0,,1350
6,80705237,80709194,del,NA18486,0,,3957
6,13847696,13856956,del,NA19835,0,,9260
6,725528,726426,del,NA19434,0,,898
6,166497640,166502589,del,NA19701,0,,4949
6,31337857,31341966,del,NA18626,0,,4109
6,89801491,89802666,del,NA18549,0,,1175
6,128827777,128829589,del,NA20761,0,,1812
6,101482612,101486973,del,NA19107,0,,4361
6,70592068,70593285,del,NA18616,0,,1217
6,33924643,33942507,del,HG01080,0,,17864
6,156199550,156200068,del,HG00284,0,,518
6,161263767,161264709,del,NA19755,0,,942
6,107046276,107048112,del,HG00171,0,,1836
6,3885191,3887465,del,NA19704,0,,2274
6,29896836,29976968,del,NA18564,0,,80132
6,125817765,125822986,del,NA19701,0,,5221
6,55491839,55494118,del,NA19147,0,,2279
6,80376639,80379517,del,NA19130,0,,2878
6,31421497,31424386,del,NA12383,0,,2889
6,92974266,92980893,del,NA18597,0,,6627
6,32629743,32726608,del,NA18597,0,,96865
6,67067962,67073580,del,NA20536,0,,5618
6,25703887,25707735,del,NA19712,0,,3848
6,29861175,29916076,del,NA18526,0,,54901
6,21164116,21164789,del,NA18520,0,,673
6,67770236,67772365,del,NA19472,0,,2129
6,87028090,87031478,del,NA19380,0,,3388
6,130664907,130679834,del,HG00254,0,,14927
6,7984274,7987008,del,HG00190,0,,2734
6,32643977,32644323,del,NA20778,0,,346
6,135154793,135160037,del,HG01069,0,,5244
6,142098470,142103312,del,HG00580,0,,4842
6,88651308,88651380,del,NA19108,0,,72
6,29759191,29909524,del,NA20522,0,,150333
6,55843175,55846429,del,HG00732,0,,3254
6,154446915,154447237,del,HG00346,0,,322
6,30783550,30783851,del,HG00256,0,,301
6,162968381,162976390,del,HG00501,0,,8009
6,77220540,77221634,del,NA19347,0,,1094
6,83510481,83511710,del,HG00246,0,,1229
6,32454816,32508522,del,HG01550,0,,53706
6,81888600,81889282,del,NA20826,0,,682
6,148088395,148088667,del,NA18516,0,,272
6,31871144,31878813,del,NA18538,0,,7669
6,42081453,42082508,del,HG00320,0,,1055
6,19865314,19867504,del,HG00278,0,,2190
6,132106601,132108785,del,HG00189,0,,2184
6,166998976,167000166,del,NA19470,0,,1190
6,7756499,7767498,del,NA19083,0,,10999
6,26656711,26658666,del,NA18982,0,,1955
6,136851675,136852923,del,NA19138,0,,1248
6,160934653,160943455,del,NA18593,0,,8802
6,134588616,134594972,del,HG00404,0,,6356
6,37041011,37045331,del,HG00608,0,,4320
6,5037249,5039186,del,NA18533,0,,1937
6,154121610,154129899,del,NA18940,0,,8289
6,5705545,5710792,del,NA19437,0,,5247
6,76686241,76687211,del,HG01067,0,,970
6,158876076,158876404,del,NA12156,0,,328
6,88285790,88286233,del,HG00249,0,,443
6,23460324,23465438,del,NA19238,0,,5114
6,87306243,87317406,del,NA19722,0,,11163
6,110602930,110603948,del,HG00152,0,,1018
6,119170077,119172969,del,NA19114,0,,2892
6,32454404,32514176,del,NA18561,0,,59772
6,73728754,73729954,del,HG01461,0,,1200
6,30422464,30450839,del,NA11920,0,,28375
6,57697921,58304893,del,NA19130,0,,606972
6,103655012,103658359,del,NA19474,0,,3347
6,57766471,58373774,del,HG01079,0,,607303
6,17774454,17775805,del,NA19457,0,,1351
6,19685216,19687422,del,NA18597,0,,2206
6,161566107,161567332,del,NA19982,0,,1225
6,13119006,13120083,del,HG01101,0,,1077
6,102031393,102033384,del,HG00427,0,,1991
6,32521516,32547722,del,HG01488,0,,26206
6,170804200,170805505,del,HG01456,0,,1305
6,170564538,170567871,del,HG01366,0,,3333
6,52166186,52171459,del,NA19700,0,,5273
6,81186557,81186829,del,NA18637,0,,272
6,120094127,120098422,del,NA18632,0,,4295
6,102307651,102313394,del,NA19428,0,,5743
6,32486827,32549014,del,NA19908,0,,62187
6,99389322,99391044,del,NA18909,0,,1722
6,169021602,169021799,del,NA18489,0,,197
6,115662072,115664701,del,HG01052,0,,2629
6,129930718,129931132,del,NA19099,0,,414
6,32627016,32635422,del,HG00258,0,,8406
6,22047572,22048634,del,NA20525,0,,1062
6,134351916,134354277,del,HG01107,0,,2361
6,101934559,101939029,del,NA19331,0,,4470
6,168919000,168919130,del,NA20803,0,,130
6,164542666,164547022,del,HG00159,0,,4356
6,109040067,109040381,del,NA19391,0,,314
6,76242259,76266455,del,NA11830,0,,24196
6,46228724,46229969,del,NA19469,0,,1245
6,89955486,89956324,del,NA19256,0,,838
6,147438391,147444429,del,NA19404,0,,6038
6,110172708,110174426,del,NA19399,0,,1718
6,87346982,87351545,del,HG00237,0,,4563
6,150302658,150302804,del,NA18611,0,,146
6,31193239,31194381,del,HG00699,0,,1142
6,29872926,29911228,del,NA11994,0,,38302
6,41953313,41956648,del,HG01492,0,,3335
6,55341642,55345656,del,NA19371,0,,4014
6,143536180,143537292,del,NA19466,0,,1112
6,8337681,8341526,del,HG00246,0,,3845
6,32524964,32551091,del,NA19660,0,,26127
6,98901173,98901265,del,NA12249,0,,92
6,168907789,168908727,del,HG01107,0,,938
6,168591118,168591274,del,NA18613,0,,156
6,31220491,31312858,del,NA19725,0,,92367
6,145136519,145137142,del,HG00690,0,,623
6,17196304,17200629,del,NA19451,0,,4325
6,58423849,58428864,del,HG00149,0,,5015
6,58301793,58314356,del,NA18907,0,,12563
6,94625929,94626262,del,NA19393,0,,333
6,93596329,93599180,del,NA18856,0,,2851
6,53925881,53934009,del,NA20524,0,,8128
6,80376654,80379427,del,NA19130,0,,2773
6,131077076,131077547,del,NA12348,0,,471
6,100404427,100410634,del,NA19921,0,,6207
6,55909288,55916409,del,NA19147,0,,7121
6,19175667,19180703,del,NA18532,0,,5036
6,23159823,23163693,del,NA19713,0,,3870
6,26343825,26351570,del,HG01390,0,,7745
6,29843104,29849240,del,HG01518,0,,6136
6,89554420,89554915,del,NA19347,0,,495
6,30996752,30997352,del,NA19172,0,,600
6,153029971,153033789,del,HG00524,0,,3818
6,81625968,81630663,del,NA19445,0,,4695
6,161276259,161281582,del,NA19350,0,,5323
6,157822944,157823359,del,NA19717,0,,415
6,168135861,168136327,del,NA18532,0,,466
6,146733832,146739324,del,NA12044,0,,5492
6,104546783,104547229,del,NA18536,0,,446
6,5117726,5119817,del,HG00635,0,,2091
6,5728470,5729935,del,HG00684,0,,1465
6,142755436,142756708,del,HG00366,0,,1272
6,62249891,62251072,del,HG01149,0,,1181
6,26753658,26761848,del,HG01334,0,,8190
6,84092496,84096573,del,NA18908,0,,4077
6,18808619,18810539,del,NA19394,0,,1920
6,69683092,69691832,del,NA20770,0,,8740
6,162725094,162725913,del,NA11995,0,,819
6,77097716,77100822,del,NA19064,0,,3106
6,109078450,109083200,del,NA19213,0,,4750
6,34317107,34319601,del,HG00284,0,,2494
6,96700327,96701491,del,NA19114,0,,1164
6,75717900,75725715,del,NA19835,0,,7815
6,33721011,33721572,del,HG01497,0,,561
6,31274816,31288522,del,NA19003,0,,13706
6,153503871,153529065,del,NA20503,0,,25194
6,131659937,131665251,del,NA19393,0,,5314
6,108117355,108118954,del,NA20586,0,,1599
6,80133784,80136169,del,HG01069,0,,2385
6,106454263,106455396,del,NA20509,0,,1133
6,41864770,41865331,del,HG01188,0,,561
6,133726352,133750045,del,NA12340,0,,23693
6,21822953,21828534,del,NA18941,0,,5581
6,168780546,168781084,del,NA19443,0,,538
6,58602643,58608420,del,NA19707,0,,5777
6,160627750,160638096,del,NA19468,0,,10346
6,169271463,169273829,del,HG01070,0,,2366
6,9359557,9360361,del,NA18602,0,,804
6,121179099,121179243,del,HG00122,0,,144
6,67008728,67048916,del,HG00282,0,,40188
6,119165049,119169884,del,NA18505,0,,4835
6,139602116,139606722,del,HG01366,0,,4606
6,99107299,99108050,del,NA19440,0,,751
6,30783152,30783256,del,HG00284,0,,104
6,95289247,95291793,del,HG00321,0,,2546
6,15666868,15667634,del,HG00138,0,,766
6,91122917,91175198,del,HG00436,0,,52281
6,125928170,125930231,del,NA18868,0,,2061
6,78354186,78357234,del,HG00146,0,,3048
6,111295210,111295517,del,NA18909,0,,307
6,54846381,54851438,del,HG01051,0,,5057
6,32522388,32549227,del,HG00326,0,,26839
6,51413784,51414011,del,NA20785,0,,227
6,74849683,74849813,del,NA18614,0,,130
6,32795503,32795680,del,NA19172,0,,177
6,773627,774802,del,NA18522,0,,1175
6,32478704,32516380,del,HG00338,0,,37676
6,48751126,48752266,del,NA18535,0,,1140
6,10978994,10981279,del,NA19468,0,,2285
6,154681011,154683154,del,NA19316,0,,2143
6,161815297,161860053,del,NA19375,0,,44756
6,31288028,31288262,del,HG00436,0,,234
6,140381758,140391457,del,HG00422,0,,9699
6,123533268,123534869,del,HG00148,0,,1601
6,33963334,33969145,del,NA18511,0,,5811
6,32623626,32625605,del,NA18636,0,,1979
6,158346274,158346999,del,NA19908,0,,725
6,32560070,32560278,del,HG00261,0,,208
6,86144298,86144632,del,NA18517,0,,334
6,162566014,162647705,del,NA19059,0,,81691
6,77437278,77459021,del,HG01188,0,,21743
6,70191087,70200344,del,NA19466,0,,9257
6,125462825,125463355,del,NA18909,0,,530
6,32514888,32516285,del,HG01066,0,,1397
6,51666956,51669362,del,NA19350,0,,2406
6,29740825,29886051,del,NA18907,0,,145226
6,97487390,97487607,del,NA19331,0,,217
6,35332941,35334358,del,NA19982,0,,1417
6,89424152,89424460,del,NA19160,0,,308
6,55907649,55912789,del,NA19700,0,,5140
6,121808932,121809164,del,NA20811,0,,232
6,165345073,165345263,del,NA18964,0,,190
6,74818560,74819186,del,NA19248,0,,626
6,82388994,82395641,del,HG00262,0,,6647
6,67430789,67433170,del,NA18517,0,,2381
6,53478560,53480516,del,HG00111,0,,1956
6,125864169,125865352,del,HG00512,0,,1183
6,19041186,19049398,del,NA18534,0,,8212
6,54417662,54418911,del,NA19438,0,,1249
6,29851372,29906224,del,HG01124,0,,54852
6,862026,863679,del,NA19704,0,,1653
6,2181824,2185655,del,NA18596,0,,3831
6,150643434,150647841,del,NA19468,0,,4407
6,154882352,154882470,del,NA19359,0,,118
6,77097616,77102922,del,HG00478,0,,5306
6,101494600,101496611,del,HG01465,0,,2011
6,32480579,32481213,del,NA18511,0,,634
6,22501806,22501905,del,NA19239,0,,99
6,167907274,167907690,del,NA18596,0,,416
6,57354309,57354514,del,HG00139,0,,205
6,94546351,94553601,del,NA18631,0,,7250
6,51199472,51200122,del,NA20289,0,,650
6,96276266,96310222,del,NA18984,0,,33956
6,162962840,162969578,del,NA19371,0,,6738
6,111531862,111536818,del,NA18553,0,,4956
6,5555074,5559436,del,NA19445,0,,4362
6,140952890,140953178,del,HG01366,0,,288
6,162758927,162761143,del,HG00475,0,,2216
6,77437226,77458987,del,HG01055,0,,21761
6,15761941,15774917,del,NA19393,0,,12976
6,40715113,40717902,del,NA19654,0,,2789
6,32522633,32549501,del,NA18945,0,,26868
6,102547082,102556297,del,NA19909,0,,9215
6,71333320,71334230,del,NA19818,0,,910
6,72863851,72873546,del,HG01197,0,,9695
6,32450666,32538419,del,HG00334,0,,87753
6,100475787,100480520,del,NA19371,0,,4733
6,130320484,130322295,del,HG01070,0,,1811
6,162578551,162580279,del,NA19900,0,,1728
6,29899782,29901549,del,NA19725,0,,1767
6,42229808,42230263,del,NA19397,0,,455
6,89921753,89922176,del,HG00103,0,,423
6,151514130,151518168,del,NA18950,0,,4038
6,32498930,32500862,del,HG00662,0,,1932
6,147856609,147864108,del,NA20525,0,,7499
6,24324816,24328322,del,NA18558,0,,3506
6,87108996,87113980,del,NA19238,0,,4984
6,71975102,71977197,del,NA18508,0,,2095
6,160131830,160133571,del,HG00323,0,,1741
6,82124655,82125903,del,NA19395,0,,1248
6,55609194,55610315,del,NA18564,0,,1121
6,167197330,167198149,del,NA12761,0,,819
6,141055221,141055720,del,HG01177,0,,499
6,155379907,155381592,del,NA19448,0,,1685
6,133079381,133080465,del,HG00422,0,,1084
6,83335002,83336129,del,NA20289,0,,1127
6,5558966,5561172,del,NA19917,0,,2206
6,64206556,64209779,del,NA19818,0,,3223
6,57746338,58353486,del,HG00140,0,,607148
6,150410834,150412271,del,NA19920,0,,1437
6,30994009,30995062,del,HG00269,0,,1053
6,17438295,17441911,del,HG00740,0,,3616
6,74340650,74342547,del,NA19093,0,,1897
6,72863851,72873540,del,HG01069,0,,9689
6,169221682,169222873,del,NA20810,0,,1191
6,89842015,89846939,del,NA19916,0,,4924
6,33125920,33126843,del,HG00345,0,,923
6,11444339,11444651,del,HG01498,0,,312
6,67060017,67063491,del,NA19379,0,,3474
6,25893952,25905557,del,NA19076,0,,11605
6,12017947,12024114,del,HG00443,0,,6167
6,33572535,33574187,del,HG01461,0,,1652
6,87074083,87082941,del,NA20801,0,,8858
6,142043327,142050738,del,NA19982,0,,7411
6,162316498,162316718,del,HG00542,0,,220
6,112172054,112175445,del,HG00542,0,,3391
6,32643156,32647935,del,HG01461,0,,4779
6,49949862,49957997,del,NA19661,0,,8135
6,32571354,32571601,del,NA19391,0,,247
6,88426368,88429352,del,NA12830,0,,2984
6,91798850,91800523,del,NA06986,0,,1673
6,55906716,55911822,del,NA19466,0,,5106
6,8066213,8067265,del,NA12003,0,,1052
6,138182491,138183351,del,HG01149,0,,860
6,55341738,55342333,del,NA19657,0,,595
6,169618118,169618214,del,HG00139,0,,96
6,135782134,135783678,del,NA19467,0,,1544
6,86898768,86899102,del,NA18956,0,,334
6,120928681,120929535,del,NA18916,0,,854
6,46597602,46599033,del,NA19347,0,,1431
6,147568626,147569648,del,NA18973,0,,1022
6,78879858,78898877,del,NA18923,0,,19019
6,65711016,65714022,del,NA20512,0,,3006
6,32460890,32461161,del,NA12748,0,,271
6,164543446,164547190,del,NA20344,0,,3744
6,67589180,67594965,del,NA19371,0,,5785
6,80993706,80999802,del,NA19338,0,,6096
6,124307026,124308895,del,HG00690,0,,1869
6,92861038,92862448,del,HG00174,0,,1410
6,62307640,62308301,del,HG00344,0,,661
6,108610684,108615081,del,NA19676,0,,4397
6,4733864,4736272,del,HG00473,0,,2408
6,44511545,44515738,del,NA19116,0,,4193
6,154838716,154840522,del,HG00437,0,,1806
6,32630116,32648022,del,NA20805,0,,17906
6,95400827,95400922,del,HG00268,0,,95
6,31875828,31877842,del,NA18526,0,,2014
6,169126149,169127139,del,NA19712,0,,990
6,116833487,116841449,del,HG00590,0,,7962
6,29860866,29915754,del,HG00445,0,,54888
6,159166129,159174997,del,NA18547,0,,8868
6,32377877,32378653,del,HG00183,0,,776
6,168474924,168475546,del,NA19074,0,,622
6,94963071,94969098,del,NA19428,0,,6027
6,125708749,125711352,del,HG00701,0,,2603
6,14739472,14740972,del,NA19099,0,,1500
6,18319712,18322126,del,NA18546,0,,2414
6,123763416,123763721,del,NA20287,0,,305
6,104872071,104872259,del,HG00139,0,,188
6,3195393,3195954,del,NA18861,0,,561
6,91989970,91998891,del,NA19394,0,,8921
6,159968201,159970837,del,NA19469,0,,2636
6,74932722,74933073,del,NA19762,0,,351
6,131112265,131145068,del,HG01190,0,,32803
6,151485066,151487022,del,NA20798,0,,1956
6,112875195,112879505,del,NA20814,0,,4310
6,51803038,51808780,del,NA20503,0,,5742
6,153180048,153180191,del,NA19116,0,,143
6,169591830,169592685,del,NA19717,0,,855
6,3070708,3072795,del,NA18605,0,,2087
6,28897469,28898015,del,NA18910,0,,546
6,134465013,134466474,del,NA19712,0,,1461
6,160903435,160907848,del,NA19625,0,,4413
6,10724888,10749525,del,NA18986,0,,24637
6,54553853,54557375,del,NA19312,0,,3522
6,170811726,170811949,del,NA19452,0,,223
6,32749230,32749541,del,NA18504,0,,311
6,12393279,12394188,del,HG00581,0,,909
6,159352752,159353803,del,NA20797,0,,1051
6,151582569,151585653,del,HG01051,0,,3084
6,169855980,169857039,del,NA18636,0,,1059
6,30343752,30348465,del,NA19457,0,,4713
6,31337566,31342022,del,NA18963,0,,4456
6,78009157,78011971,del,NA19116,0,,2814
6,95134218,95139426,del,NA19375,0,,5208
6,50159484,50162572,del,HG00583,0,,3088
6,3924456,3926122,del,NA18945,0,,1666
6,70720219,70726294,del,HG00247,0,,6075
6,65848082,65878852,del,NA19225,0,,30770
6,41572633,41573269,del,HG00323,0,,636
6,84734639,84739273,del,HG01072,0,,4634
6,31638204,31639096,del,HG00138,0,,892
6,74613596,74620399,del,NA18861,0,,6803
6,71216,202022,del,NA19055,0,,130806
6,140770575,140781912,del,NA19462,0,,11337
6,161002038,161004169,del,HG00108,0,,2131
6,122545268,122551026,del,HG00436,0,,5758
6,10293995,10294140,del,HG00740,0,,145
6,107124532,107124848,del,NA07346,0,,316
6,26997016,26997422,del,HG01102,0,,406
6,98693546,98698487,del,NA19453,0,,4941
6,72227095,72227738,del,HG00419,0,,643
6,29513086,29513400,del,NA19200,0,,314
6,71056722,71057219,del,NA18517,0,,497
6,30994895,30996727,del,NA19079,0,,1832
6,102418552,102419100,del,NA20289,0,,548
6,89449466,89449672,del,HG01171,0,,206
6,27158523,27159885,del,NA18623,0,,1362
6,26611238,26618019,del,HG01170,0,,6781
6,32488307,32550479,del,NA18536,0,,62172
6,128232133,128233098,del,HG01107,0,,965
6,69138587,69139391,del,HG00179,0,,804
6,168646490,168646915,del,NA19446,0,,425
6,118568833,118569060,del,HG01051,0,,227
6,162717968,162751337,del,NA19448,0,,33369
6,141372328,141382865,del,NA19651,0,,10537
6,96852797,96853128,del,HG00422,0,,331
6,44503032,44512391,del,NA19466,0,,9359
6,125169111,125170475,del,NA19381,0,,1364
6,93575109,93579998,del,NA19384,0,,4889
6,29898916,29901372,del,NA19758,0,,2456
6,160433616,160434022,del,HG01108,0,,406
6,67235262,67235605,del,HG00324,0,,343
6,143606931,143611302,del,NA19093,0,,4371
6,121154099,121156029,del,HG00277,0,,1930
6,162236951,162270004,del,NA20754,0,,33053
6,29650419,29651085,del,NA18537,0,,666
6,34178557,34178953,del,NA19472,0,,396
6,110234345,110234610,del,NA19703,0,,265
6,32593816,32593872,del,NA20127,0,,56
6,12370772,12371784,del,NA20773,0,,1012
6,158992375,158992577,del,HG00366,0,,202
6,17750447,17750884,del,NA06984,0,,437
6,3619179,3621861,del,NA18574,0,,2682
6,13808375,13812053,del,NA19347,0,,3678
6,66399045,66404686,del,HG00501,0,,5641
6,151575495,151576307,del,NA12750,0,,812
6,167543015,167544420,del,NA18910,0,,1405
6,153156410,153174450,del,NA18573,0,,18040
6,57709733,58316812,del,HG01173,0,,607079
6,81901922,81907231,del,NA20517,0,,5309
6,32497968,32557470,del,HG00372,0,,59502
6,105260826,105263757,del,HG00232,0,,2931
6,74613569,74620396,del,NA18574,0,,6827
6,7633022,7633709,del,HG00705,0,,687
6,170768102,170769292,del,NA20761,0,,1190
6,51736109,51736804,del,HG00236,0,,695
6,83883196,83883685,del,NA19257,0,,489
6,32479459,32542087,del,NA18566,0,,62628
6,77097492,77102641,del,NA20581,0,,5149
6,151097538,151097796,del,NA18606,0,,258
6,17110771,17112754,del,NA12340,0,,1983
6,62443831,62465975,del,NA12342,0,,22144
6,134589881,134594721,del,NA19063,0,,4840
6,101380108,101384930,del,NA19469,0,,4822
6,29843104,29843361,del,HG00141,0,,257
6,153932501,153932660,del,HG00309,0,,159
6,150386259,150387021,del,NA20510,0,,762
6,15683338,15684792,del,HG00500,0,,1454
6,22050940,22054346,del,NA20344,0,,3406
6,70332608,70333527,del,NA19332,0,,919
6,72155978,72161035,del,NA18487,0,,5057
6,144572227,144572352,del,HG01069,0,,125
6,168781059,168781234,del,NA19720,0,,175
6,48674121,48677595,del,HG01461,0,,3474
6,31274516,31279222,del,HG00531,0,,4706
6,162583769,162586808,del,HG01048,0,,3039
6,111370056,111370312,del,NA19099,0,,256
6,109089400,109090024,del,HG00442,0,,624
6,68353222,68353507,del,NA19782,0,,285
6,79172897,79173713,del,NA19449,0,,816
6,127938068,127939721,del,NA19457,0,,1653
6,147091815,147094491,del,NA19007,0,,2676
6,126182966,126187241,del,HG01060,0,,4275
6,44997048,45040614,del,HG00136,0,,43566
6,36430651,36435265,del,NA19010,0,,4614
6,62199722,62206520,del,NA20801,0,,6798
6,87406191,87417841,del,NA19138,0,,11650
6,5135257,5135585,del,NA11930,0,,328
6,32522416,32563122,del,HG01521,0,,40706
6,82116830,82119688,del,NA19920,0,,2858
6,169506281,169521151,del,NA18552,0,,14870
6,74832503,74833459,del,HG01550,0,,956
6,12664178,12664510,del,NA20527,0,,332
6,8227923,8228241,del,NA18519,0,,318
6,35732959,35733308,del,NA18871,0,,349
6,74139306,74140581,del,NA18908,0,,1275
6,78440518,78446680,del,NA19901,0,,6162
6,144728235,144740520,del,HG00173,0,,12285
6,24325416,24328272,del,HG00185,0,,2856
6,86708739,86714791,del,NA20756,0,,6052
6,154619989,154621504,del,NA19391,0,,1515
6,11034634,11034769,del,HG00244,0,,135
6,151993491,151993976,del,NA19904,0,,485
6,70212270,70213828,del,NA18571,0,,1558
6,92589457,92593399,del,HG00693,0,,3942
6,55733007,55736296,del,HG00650,0,,3289
6,101618343,101644208,del,HG00584,0,,25865
6,86544532,86572449,del,NA19429,0,,27917
6,29796742,29911448,del,HG01140,0,,114706
6,53928709,53934976,del,HG00346,0,,6267
6,139150899,139159955,del,HG00372,0,,9056
6,31056183,31057917,del,HG01250,0,,1734
6,134101307,134104271,del,NA19371,0,,2964
6,7961119,7961513,del,NA19360,0,,394
6,136817519,136821253,del,NA19385,0,,3734
6,19676316,19677358,del,NA19443,0,,1042
6,31296391,31304909,del,HG00595,0,,8518
6,44678722,44679322,del,NA19436,0,,600
6,30994006,30995080,del,HG00242,0,,1074
6,34654298,34654516,del,HG00449,0,,218
6,159652109,159652422,del,NA12843,0,,313
6,105619607,105620670,del,NA18519,0,,1063
6,115642567,115643668,del,NA18572,0,,1101
6,119011166,119020106,del,NA20756,0,,8940
6,170060912,170061104,del,HG00654,0,,192
6,31238691,31323767,del,NA18933,0,,85076
6,23685995,23686324,del,HG00421,0,,329
6,5898447,5898875,del,NA18620,0,,428
6,142549058,142550857,del,NA18612,0,,1799
6,32454633,32478675,del,NA12347,0,,24042
6,149350956,149351808,del,NA18853,0,,852
6,114963496,114965292,del,HG01060,0,,1796
6,80159633,80161410,del,NA19651,0,,1777
6,79521083,79530685,del,HG00731,0,,9602
6,133745768,133747362,del,NA18873,0,,1594
6,81195116,81195022,del,NA19452,0,,-94
6,100034501,100035321,del,NA06984,0,,820
6,119351668,119356311,del,NA19726,0,,4643
6,128976347,128976564,del,HG01107,0,,217
6,117780555,117780657,del,NA19703,0,,102
6,2568466,2571022,del,NA18916,0,,2556
6,32610316,32625722,del,HG00244,0,,15406
6,52626262,52626878,del,NA18570,0,,616
6,103737464,103762889,del,NA18628,0,,25425
6,73651039,73651220,del,HG01070,0,,181
6,113895269,113895614,del,NA18523,0,,345
6,131951357,131953033,del,NA18617,0,,1676
6,10657616,10660022,del,HG00704,0,,2406
6,27525810,27535514,del,NA20818,0,,9704
6,45199598,45201542,del,HG00353,0,,1944
6,160596012,160598191,del,NA19009,0,,2179
6,103737464,103762893,del,HG00525,0,,25429
6,151486533,151486694,del,HG00641,0,,161
6,14839472,14842000,del,HG00321,0,,2528
6,2936601,2936798,del,HG01353,0,,197
6,99239716,99241754,del,NA19102,0,,2038
6,153165968,153166093,del,HG00345,0,,125
6,10657994,10660880,del,HG00566,0,,2886
6,51369032,51371010,del,HG00136,0,,1978
6,163407811,163432827,del,HG00448,0,,25016
6,78325092,78334580,del,HG00146,0,,9488
6,117069681,117071673,del,NA19445,0,,1992
6,73152037,73152154,del,HG00136,0,,117
6,169143028,169143258,del,NA06986,0,,230
6,132114228,132118550,del,NA19474,0,,4322
6,31945146,31945639,del,HG00635,0,,493
6,148001705,148003331,del,NA19472,0,,1626
6,89845888,89851693,del,HG00500,0,,5805
6,162710275,162763497,del,HG00176,0,,53222
6,131216397,131219668,del,NA19311,0,,3271
6,141452048,141456050,del,NA19430,0,,4002
6,100538166,100539772,del,NA18990,0,,1606
6,167197702,167198149,del,NA19661,0,,447
6,5205410,5205772,del,NA11829,0,,362
6,34011982,34012294,del,NA19147,0,,312
6,98416730,98418537,del,NA19081,0,,1807
6,14379996,14381141,del,NA18977,0,,1145
6,12831631,12837914,del,NA19783,0,,6283
6,15199627,15199917,del,NA19469,0,,290
6,77449470,77452750,del,NA19707,0,,3280
6,52628595,52668943,del,NA19404,0,,40348
6,136861390,136865015,del,NA19068,0,,3625
6,169633657,169634599,del,NA20803,0,,942
6,17378216,17381222,del,HG00137,0,,3006
6,86116802,86126086,del,HG00524,0,,9284
6,157699903,157703269,del,HG01080,0,,3366
6,110885446,110885798,del,HG00608,0,,352
6,168990370,168990727,del,HG00464,0,,357
6,32454616,32517322,del,NA19982,0,,62706
6,32025932,32029271,del,NA19372,0,,3339
6,99142464,99143333,del,HG01359,0,,869
6,65785654,65815832,del,HG00736,0,,30178
6,104228567,104228912,del,HG00245,0,,345
6,481386,483172,del,NA18950,0,,1786
6,62832617,62832847,del,NA18853,0,,230
6,29884497,29970025,del,HG00656,0,,85528
6,34793214,34799169,del,HG00273,0,,5955
6,169633794,169634537,del,NA19372,0,,743
6,88032749,88032839,del,NA18861,0,,90
6,103585660,103588051,del,HG00361,0,,2391
6,115379162,115379379,del,NA18520,0,,217
6,86413067,86413370,del,NA19374,0,,303
6,147906100,147915229,del,HG00366,0,,9129
6,87057350,87060172,del,NA18853,0,,2822
6,21867130,21867670,del,NA19445,0,,540
6,112430847,112431010,del,NA18856,0,,163
6,143264816,143268322,del,HG01440,0,,3506
6,29891316,29905822,del,NA18627,0,,14506
6,161279042,161279395,del,NA19213,0,,353
6,29725690,29739373,del,HG00650,0,,13683
6,32600949,32601659,del,NA11995,0,,710
6,53728708,53732285,del,NA19398,0,,3577
6,57721658,58328716,del,HG00133,0,,607058
6,11959068,11960063,del,HG01204,0,,995
6,33292872,33295365,del,NA19445,0,,2493
6,8337916,8342422,del,NA20520,0,,4506
6,31219602,31229761,del,NA19066,0,,10159
6,91423961,91424951,del,NA18597,0,,990
6,81644850,81646897,del,NA18550,0,,2047
6,31785393,31797587,del,NA18989,0,,12194
6,24879112,24879424,del,NA20502,0,,312
6,153426274,153426858,del,NA19723,0,,584
6,29364920,29385500,del,NA18536,0,,20580
6,66401716,66404522,del,NA18564,0,,2806
6,96043947,96058907,del,NA18536,0,,14960
6,473961,474476,del,HG00663,0,,515
6,90317540,90317665,del,NA19380,0,,125
6,140954751,140957437,del,HG00736,0,,2686
6,37611778,37611863,del,HG00319,0,,85
6,29858061,29912856,del,NA18596,0,,54795
6,66188938,66189030,del,HG00449,0,,92
6,136294223,136294618,del,HG01357,0,,395
6,145688872,145691144,del,NA18627,0,,2272
6,32454916,32539622,del,NA19235,0,,84706
6,168376865,168377316,del,HG00698,0,,451
6,74613566,74620322,del,HG00267,0,,6756
6,170465255,170465357,del,HG00693,0,,102
6,32512684,32513005,del,NA18636,0,,321
6,10214165,10575011,del,NA18873,0,,360846
6,139602667,139602984,del,NA18574,0,,317
6,153771865,153772596,del,NA19383,0,,731
6,169591941,169592604,del,HG00353,0,,663
6,64306480,64306833,del,NA19390,0,,353
6,69794613,69797615,del,HG01190,0,,3002
6,164688747,164691816,del,NA18616,0,,3069
6,89491194,89492315,del,NA19920,0,,1121
6,167800843,167801785,del,HG00179,0,,942
6,32449724,32553631,del,HG00360,0,,103907
6,106824391,106829363,del,NA18626,0,,4972
6,27272102,27273298,del,NA18541,0,,1196
6,31242509,31327504,del,HG00142,0,,84995
6,103762972,103763134,del,NA18558,0,,162
6,32676573,32677030,del,NA19703,0,,457
6,112645055,112645831,del,NA19453,0,,776
6,54662535,54665917,del,NA19819,0,,3382
6,47297272,47300281,del,NA19379,0,,3009
6,42798220,42806596,del,NA18548,0,,8376
6,28018667,28022062,del,NA12717,0,,3395
6,21361720,21367045,del,NA19463,0,,5325
6,159348747,159349903,del,HG00428,0,,1156
6,114021448,114022408,del,NA19835,0,,960
6,50000463,50001033,del,NA18523,0,,570
6,170038118,170038445,del,NA18940,0,,327
6,159418882,159419710,del,NA12718,0,,828
6,23159754,23161565,del,NA19713,0,,1811
6,45166448,45247811,del,NA11920,0,,81363
6,3635625,3635901,del,NA18961,0,,276
6,32516644,32541588,del,NA20526,0,,24944
6,159223978,159224608,del,NA19380,0,,630
6,19423614,19423852,del,HG00344,0,,238
6,32571516,32625722,del,HG00556,0,,54206
6,34218884,34219843,del,NA12043,0,,959
6,67325062,67326021,del,NA19213,0,,959
6,95288666,95291272,del,HG00476,0,,2606
6,165724666,165732132,del,NA10847,0,,7466
6,117837804,117839688,del,NA12155,0,,1884
6,37851224,37852576,del,NA19440,0,,1352
6,62200031,62208130,del,NA19676,0,,8099
6,31235495,31320571,del,NA20507,0,,85076
6,164262647,164262865,del,NA18990,0,,218
6,99118696,99141982,del,NA12144,0,,23286
6,29893716,29905622,del,NA20528,0,,11906
6,67971647,67974165,del,NA20289,0,,2518
6,133582173,133591056,del,NA18571,0,,8883
6,42837559,42839303,del,HG01173,0,,1744
6,128432722,128437598,del,HG00179,0,,4876
6,74050370,74051749,del,NA19916,0,,1379
6,52793036,52796755,del,NA18856,0,,3719
6,32454616,32541222,del,NA19347,0,,86606
6,75303882,75304335,del,NA19444,0,,453
6,95387313,95389267,del,NA20530,0,,1954
6,149290257,149294136,del,HG00250,0,,3879
6,70109918,70111783,del,NA19067,0,,1865
6,108614266,108614619,del,NA18982,0,,353
6,119962788,120019201,del,HG01125,0,,56413
6,169132678,169135907,del,NA19070,0,,3229
6,1270713,1270998,del,HG00692,0,,285
6,72339489,72340467,del,NA19129,0,,978
6,74232261,74232369,del,NA18633,0,,108
6,19041186,19049400,del,NA20818,0,,8214
6,4996865,4998795,del,HG00256,0,,1930
6,13702466,13705408,del,NA19346,0,,2942
6,169116,201822,del,NA19675,0,,32706
6,33937829,33942697,del,NA19116,0,,4868
6,32494672,32554508,del,HG00240,0,,59836
6,146715332,146716434,del,NA19904,0,,1102
6,153226752,153227739,del,NA19443,0,,987
6,32502316,32508022,del,NA19788,0,,5706
6,84582756,84588838,del,HG00343,0,,6082
6,159532866,159532946,del,HG00137,0,,80
6,94734597,94735779,del,NA18908,0,,1182
6,127183506,127188090,del,HG00114,0,,4584
6,81977973,81981464,del,NA19380,0,,3491
6,96545281,96547123,del,NA18487,0,,1842
6,80557132,80570423,del,HG00428,0,,13291
6,169444510,169448295,del,NA19466,0,,3785
6,123168909,123171584,del,HG00369,0,,2675
6,26997232,26997825,del,NA19396,0,,593
6,88731229,88733318,del,NA19350,0,,2089
6,106154649,106157618,del,NA19239,0,,2969
6,43723878,43725002,del,HG00253,0,,1124
6,104745375,104745570,del,NA18613,0,,195
6,134719923,134720554,del,HG00337,0,,631
6,14971115,14976341,del,NA19655,0,,5226
6,160649682,160654957,del,NA20289,0,,5275
6,37294953,37295276,del,NA12154,0,,323
6,158623990,158624278,del,NA18990,0,,288
6,119039465,119040407,del,NA18498,0,,942
6,139602516,139606622,del,HG00190,0,,4106
6,134589674,134594542,del,NA18542,0,,4868
6,162615385,162627670,del,NA19703,0,,12285
6,81283718,81293577,del,HG00731,0,,9859
6,77439416,77457822,del,HG00148,0,,18406
6,162583566,162586922,del,NA19720,0,,3356
6,9274029,9274242,del,NA18984,0,,213
6,35626432,35629744,del,HG00533,0,,3312
6,3331586,3336314,del,NA19076,0,,4728
6,29843116,29904372,del,HG00620,0,,61256
6,31278716,31289122,del,NA19399,0,,10406
6,162430904,162433541,del,HG01197,0,,2637
6,155312335,155314172,del,HG00160,0,,1837
6,96964393,96965679,del,HG00542,0,,1286
6,49870092,49870248,del,HG00253,0,,156
6,32459939,32460671,del,NA07037,0,,732
6,77016710,77029160,del,NA18949,0,,12450
6,94540033,94545221,del,HG01125,0,,5188
6,151364935,151367937,del,NA19077,0,,3002
6,56915768,56916472,del,NA18487,0,,704
6,22896627,22896820,del,NA20815,0,,193
6,135608885,135610919,del,NA19355,0,,2034
6,129616,202022,del,NA11893,0,,72406
6,141377695,141380209,del,NA18912,0,,2514
6,30932630,30932804,del,NA20765,0,,174
6,78474926,78475536,del,NA19129,0,,610
6,132707175,132707474,del,HG00701,0,,299
6,107544263,107546487,del,NA19403,0,,2224
6,29884138,29969648,del,HG00662,0,,85510
6,70378179,70379071,del,HG00657,0,,892
6,81110691,81110892,del,NA19099,0,,201
6,43826334,43833647,del,NA20540,0,,7313
6,160355701,160355849,del,HG01107,0,,148
6,86623833,86625832,del,HG00321,0,,1999
6,7012541,7012672,del,NA11832,0,,131
6,33028587,33030255,del,NA12778,0,,1668
6,82176381,82176876,del,NA19467,0,,495
6,12099580,12099912,del,NA18868,0,,332
6,32665547,32753060,del,HG00237,0,,87513
6,126182116,126188322,del,NA20792,0,,6206
6,154825772,154826941,del,HG00182,0,,1169
6,168872919,168877630,del,NA20503,0,,4711
6,166767467,166767554,del,HG00692,0,,87
6,161215590,161218696,del,NA18522,0,,3106
6,161726293,161727859,del,NA20769,0,,1566
6,139601316,139607522,del,NA12716,0,,6206
6,32615035,32615222,del,NA18522,0,,187
6,32594437,32596300,del,HG00732,0,,1863
6,142111616,142115372,del,NA19319,0,,3756
6,110396052,110414235,del,HG00242,0,,18183
6,149801927,149802886,del,HG00253,0,,959
6,66911051,66915718,del,HG00734,0,,4667
6,78967194,79036475,del,HG00117,0,,69281
6,167313082,167313598,del,NA19054,0,,516
6,19814934,19821193,del,NA18564,0,,6259
6,30466461,31034887,del,HG00656,0,,568426
6,143869379,143872447,del,NA11933,0,,3068
6,77865093,77875752,del,NA19835,0,,10659
6,162112863,162113092,del,HG00619,0,,229
6,167684628,167684783,del,HG01173,0,,155
6,57749947,58357091,del,HG00383,0,,607144
6,20394993,20398348,del,HG00524,0,,3355
6,19531218,19537834,del,NA18605,0,,6616
6,96387601,96389423,del,NA19002,0,,1822
6,130327513,130327703,del,NA19318,0,,190
6,103988910,103994761,del,NA18508,0,,5851
6,29784637,29969407,del,NA20528,0,,184770
6,168976511,168977734,del,NA19908,0,,1223
6,31296367,31304884,del,HG00336,0,,8517
6,88801144,88802422,del,NA18868,0,,1278
6,75265109,75266283,del,NA20543,0,,1174
6,136826489,136827697,del,NA18505,0,,1208
6,132081990,132082220,del,HG01456,0,,230
6,10534554,10536741,del,NA20509,0,,2187
6,74868416,74869548,del,NA19384,0,,1132
6,168475152,168475586,del,HG00437,0,,434
6,62558390,62560137,del,HG00613,0,,1747
6,111087982,111088599,del,NA19921,0,,617
6,92548091,92549175,del,NA19471,0,,1084
6,21890287,21897090,del,NA19473,0,,6803
6,594969,596531,del,NA19160,0,,1562
6,169012956,169013136,del,NA18635,0,,180
6,11059559,11088120,del,NA18530,0,,28561
6,68282542,68314049,del,NA18517,0,,31507
6,122316829,122320039,del,HG00154,0,,3210
6,78047655,78047781,del,NA19129,0,,126
6,127723862,127726483,del,HG00608,0,,2621
6,77437604,77459346,del,HG00101,0,,21742
6,27298643,27306540,del,NA19901,0,,7897
6,62861453,62863128,del,NA18562,0,,1675
6,141548624,141550030,del,NA19900,0,,1406
6,33725168,33726724,del,NA19788,0,,1556
6,32489825,32552029,del,HG01497,0,,62204
6,162469703,162472842,del,HG00176,0,,3139
6,10063861,10069815,del,HG01052,0,,5954
6,119444006,119444247,del,HG01083,0,,241
6,24325361,24327807,del,HG01366,0,,2446
6,132375210,132378878,del,NA12878,0,,3668
6,32461277,32468790,del,NA20530,0,,7513
6,69471195,69471720,del,NA19391,0,,525
6,107007266,107008580,del,NA19474,0,,1314
6,120294581,120298128,del,NA19909,0,,3547
6,134353416,134354222,del,HG01048,0,,806
6,32645165,32645387,del,NA19374,0,,222
6,139601716,139606922,del,NA19395,0,,5206
6,42569618,42569779,del,NA07346,0,,161
6,33493154,33493966,del,NA18868,0,,812
6,29766543,29923000,del,NA19448,0,,156457
6,92345778,92347762,del,NA18947,0,,1984
6,142110603,142114941,del,NA18912,0,,4338
6,29879807,29964797,del,HG00127,0,,84990
6,32563716,32573422,del,HG01168,0,,9706
6,53928709,53934828,del,HG00280,0,,6119
6,55825957,55846712,del,NA11893,0,,20755
6,110569736,110571885,del,NA12006,0,,2149
6,170165954,170166098,del,NA12842,0,,144
6,145705466,145706520,del,NA20291,0,,1054
6,57622877,57627848,del,NA19437,0,,4971
6,98404265,98404879,del,NA19060,0,,614
6,52812079,52812104,del,HG00342,0,,25
6,91358823,91360244,del,HG01440,0,,1421
6,66496636,66498006,del,NA19704,0,,1370
6,149632778,149632944,del,HG00702,0,,166
6,123373881,123374224,del,NA19398,0,,343
6,55907646,55918106,del,NA19700,0,,10460
6,88801144,88802418,del,HG00155,0,,1274
6,31234946,31320016,del,NA19474,0,,85070
6,169275589,169275811,del,HG00310,0,,222
6,162583966,162586922,del,NA18910,0,,2956
6,103456642,103459843,del,NA18873,0,,3201
6,32490272,32526266,del,NA18577,0,,35994
6,24424370,24424595,del,NA19129,0,,225
6,87816,202022,del,HG01515,0,,114206
6,168135953,168136112,del,NA18596,0,,159
6,32521636,32548492,del,HG00367,0,,26856
6,67609571,67619405,del,HG01461,0,,9834
6,48991015,48994955,del,NA18502,0,,3940
6,66022807,66026964,del,NA19436,0,,4157
6,121797443,121798054,del,HG01383,0,,611
6,148177938,148178831,del,NA18868,0,,893
6,142285949,142286658,del,HG01061,0,,709
6,103621651,103649153,del,HG00139,0,,27502
6,89706799,89707625,del,HG01389,0,,826
6,170092454,170093375,del,HG00152,0,,921
6,2907399,2907655,del,NA18977,0,,256
6,126183044,126187336,del,HG00338,0,,4292
6,67040800,67043208,del,HG00701,0,,2408
6,153958367,153961524,del,NA19075,0,,3157
6,158716651,158719800,del,HG00657,0,,3149
6,47982775,47984578,del,NA19380,0,,1803
6,124557878,124558989,del,HG00580,0,,1111
6,164743238,164749844,del,NA19900,0,,6606
6,30995368,30997078,del,NA19390,0,,1710
6,102815148,102815720,del,NA19663,0,,572
6,396674,397055,del,HG00249,0,,381
6,36384909,36391321,del,NA19331,0,,6412
6,43164946,43165383,del,NA19434,0,,437
6,68141856,68142475,del,HG01176,0,,619
6,149989253,149995409,del,NA19390,0,,6156
6,146144584,146148830,del,HG01055,0,,4246
6,33569002,33571285,del,HG00138,0,,2283
6,47907004,47908088,del,NA19900,0,,1084
6,3574966,3584116,del,NA18609,0,,9150
6,66402216,66404522,del,NA18953,0,,2306
6,103621671,103648998,del,HG00139,0,,27327
6,149286052,149289872,del,HG00250,0,,3820
6,154686527,154686804,del,NA19072,0,,277
6,129224271,129224911,del,NA18571,0,,640
6,31279000,31288764,del,HG00278,0,,9764
6,55471154,55477399,del,HG01051,0,,6245
6,140380773,140392248,del,NA18605,0,,11475
6,98595583,98598033,del,HG00437,0,,2450
6,126184466,126187322,del,HG00136,0,,2856
6,63242608,63526081,del,HG00377,0,,283473
6,21205393,21210353,del,NA18977,0,,4960
6,104463942,104468555,del,NA19359,0,,4613
6,167061283,167061367,del,HG00310,0,,84
6,32594494,32596467,del,HG00418,0,,1973
6,58186792,58190912,del,NA18909,0,,4120
6,32247480,32248672,del,NA19379,0,,1192
6,121748745,121749489,del,NA19210,0,,744
6,56615029,56618525,del,HG00263,0,,3496
6,139602598,139607148,del,NA18560,0,,4550
6,26745716,26749322,del,HG01360,0,,3606
6,132696657,132697745,del,HG00537,0,,1088
6,32627116,32633222,del,HG00266,0,,6106
6,65711005,65715712,del,NA19064,0,,4707
6,142111666,142115222,del,NA19190,0,,3556
6,76687450,76687954,del,NA12282,0,,504
6,15283238,15283965,del,HG01461,0,,727
6,139644681,139646060,del,NA18999,0,,1379
6,94837974,94838065,del,HG00111,0,,91
6,138492161,138492534,del,NA19377,0,,373
6,31296283,31304775,del,HG00403,0,,8492
6,8078561,8078784,del,HG00284,0,,223
6,2009062,2018731,del,HG00566,0,,9669
6,150286280,150286467,del,HG00607,0,,187
6,5559895,5562546,del,NA19700,0,,2651
6,170767719,170769292,del,HG01492,0,,1573
6,135287730,135288077,del,NA19457,0,,347
6,140692675,140696812,del,NA12283,0,,4137
6,23878121,23879191,del,HG01366,0,,1070
6,32481682,32517420,del,HG01259,0,,35738
6,17376849,17381254,del,NA20322,0,,4405
6,111071016,111071569,del,NA11994,0,,553
6,159047923,159048225,del,NA18545,0,,302
6,23161751,23163847,del,NA19711,0,,2096
6,57618680,57618879,del,NA20818,0,,199
6,151268438,151269984,del,NA19782,0,,1546
6,76401213,76402870,del,NA19713,0,,1657
6,2791563,2810219,del,HG00554,0,,18656
6,120907552,120907932,del,NA20542,0,,380
6,99967344,99972554,del,NA18501,0,,5210
6,32611016,32625422,del,NA19063,0,,14406
6,100537906,100539258,del,HG00593,0,,1352
6,52797439,52803845,del,NA19129,0,,6406
6,58736114,58737296,del,NA19332,0,,1182
6,62924339,62929171,del,HG00253,0,,4832
6,122080357,122083418,del,NA19701,0,,3061
6,5553403,5576214,del,HG00366,0,,22811
6,103737464,103763134,del,NA19010,0,,25670
6,57903205,58507401,del,HG01375,0,,604196
6,27674964,27679474,del,NA19213,0,,4510
6,34459300,34468807,del,NA12342,0,,9507
6,62045444,62045602,del,NA19239,0,,158
6,67210340,67214629,del,NA19713,0,,4289
6,103967216,103970122,del,HG00343,0,,2906
6,6801660,6811015,del,HG00151,0,,9355
6,157410364,157411103,del,NA20510,0,,739
6,136582615,136589299,del,NA20507,0,,6684
6,167252234,167252411,del,NA18853,0,,177
6,85220385,85220988,del,NA19355,0,,603
6,156484931,156487049,del,NA18539,0,,2118
6,20463956,20466683,del,NA06984,0,,2727
6,85386339,85386455,del,NA18501,0,,116
6,33492795,33498901,del,NA19440,0,,6106
6,32454616,32516122,del,HG01521,0,,61506
6,12527809,12529560,del,NA19430,0,,1751
6,169662908,169663247,del,NA20505,0,,339
6,152303669,152311772,del,NA19375,0,,8103
6,32631719,32728545,del,HG00133,0,,96826
6,6932602,6932740,del,HG01060,0,,138
6,11313638,11313793,del,HG01356,0,,155
6,118241863,118244971,del,NA19003,0,,3108
6,26373713,26380586,del,NA19313,0,,6873
6,19685576,19686505,del,HG00554,0,,929
6,122571424,122576359,del,HG00280,0,,4935
6,152914356,152922287,del,NA19000,0,,7931
6,80326241,80327243,del,NA18498,0,,1002
6,64910075,64911935,del,NA20532,0,,1860
6,95289247,95291789,del,NA10847,0,,2542
6,161811730,161814767,del,NA18853,0,,3037
6,56942773,56946238,del,NA19107,0,,3465
6,31365464,31460442,del,HG01462,0,,94978
6,32616100,32619913,del,HG00273,0,,3813
6,32518316,32541522,del,HG00335,0,,23206
6,87223071,87228896,del,NA11893,0,,5825
6,162384929,162387436,del,NA19917,0,,2507
6,170575920,170576805,del,NA19713,0,,885
6,16884016,16885922,del,NA18543,0,,1906
6,9761424,9764218,del,HG00641,0,,2794
6,106403841,106406220,del,NA18873,0,,2379
6,32453784,32539802,del,NA19455,0,,86018
6,64553662,64556109,del,HG00476,0,,2447
6,121849993,121851916,del,NA19116,0,,1923
6,32599716,32625822,del,NA20356,0,,26106
6,151486053,151487124,del,NA11932,0,,1071
6,163747977,163748169,del,HG00534,0,,192
6,113700957,113703116,del,HG01067,0,,2159
6,149376165,149376717,del,NA18990,0,,552
6,170652361,170653566,del,NA19390,0,,1205
6,8336766,8342272,del,HG01498,0,,5506
6,73362177,73365168,del,NA19004,0,,2991
6,52274772,52279617,del,NA19920,0,,4845
6,32460944,32468706,del,NA19372,0,,7762
6,93575109,93579992,del,NA20289,0,,4883
6,18789321,18789624,del,HG00705,0,,303
6,162738024,162740306,del,NA18597,0,,2282
6,64494438,64497080,del,NA19116,0,,2642
6,109210451,109211608,del,NA19391,0,,1157
6,52694860,52700362,del,NA19916,0,,5502
6,113645153,113651446,del,HG01134,0,,6293
6,76647144,76704516,del,NA20505,0,,57372
6,40434194,40436419,del,NA18523,0,,2225
6,118077366,118084612,del,NA07347,0,,7246
6,170009187,170009638,del,HG00671,0,,451
6,32627216,32647822,del,HG00650,0,,20606
6,23878195,23878899,del,NA12249,0,,704
6,121795569,121800346,del,NA18908,0,,4777
6,33936416,33944022,del,NA19331,0,,7606
6,166466104,166469296,del,NA18516,0,,3192
6,97194996,97210687,del,NA20810,0,,15691
6,29895016,29903122,del,NA19138,0,,8106
6,132707472,132712292,del,HG00736,0,,4820
6,159876485,159879543,del,HG01051,0,,3058
6,34006377,34007255,del,HG00699,0,,878
6,65910057,65910663,del,NA19116,0,,606
6,33938016,33943722,del,NA19102,0,,5706
6,134592209,134592491,del,HG01170,0,,282
6,154212900,154215271,del,NA19066,0,,2371
6,47350429,47350415,del,HG01061,0,,-14
6,44522857,44524345,del,NA18868,0,,1488
6,127679790,127680351,del,HG00271,0,,561
6,55413587,55417865,del,HG01357,0,,4278
6,13671315,13671919,del,HG00442,0,,604
6,150375277,150376763,del,HG01190,0,,1486
6,31208732,31285739,del,NA18564,0,,77007
6,44613484,44613800,del,NA19172,0,,316
6,142313752,142314901,del,HG00280,0,,1149
6,147037431,147037758,del,NA19438,0,,327
6,83735431,83736984,del,NA19404,0,,1553
6,67431166,67434922,del,NA19213,0,,3756
6,30994041,30995125,del,NA12273,0,,1084
6,115776468,115778142,del,NA20518,0,,1674
6,28958096,28959191,del,NA20544,0,,1095
6,31356165,31453117,del,HG00740,0,,96952
6,33576279,33579857,del,NA18549,0,,3578
6,170166007,170166117,del,NA18613,0,,110
6,65768326,65768778,del,HG01389,0,,452
6,9834196,9839307,del,HG00326,0,,5111
6,16884965,16886093,del,NA20588,0,,1128
6,150375304,150376763,del,HG00335,0,,1459
6,77309926,77327604,del,NA20589,0,,17678
6,101380108,101384982,del,NA19372,0,,4874
6,145061328,145064212,del,HG00553,0,,2884
6,29851366,29905672,del,HG01176,0,,54306
6,39068563,39072898,del,NA19435,0,,4335
6,82386126,82387173,del,NA19380,0,,1047
6,133948931,133949662,del,NA19058,0,,731
6,133954686,133956962,del,NA19660,0,,2276
6,34339792,34341119,del,NA18543,0,,1327
6,32454993,32478445,del,NA12829,0,,23452
6,34152009,34152650,del,NA18613,0,,641
6,155118239,155123036,del,HG01461,0,,4797
6,36581874,36582496,del,HG00610,0,,622
6,69406935,69413340,del,HG00662,0,,6405
6,101777045,101778651,del,NA12750,0,,1606
6,29766213,29922674,del,NA19785,0,,156461
6,170555266,170556422,del,NA19444,0,,1156
6,36955566,36955672,del,HG00732,0,,106
6,168905694,168905967,del,HG01374,0,,273
6,32521863,32548708,del,HG01134,0,,26845
6,38498271,38498415,del,NA20814,0,,144
6,115168792,115169473,del,NA19070,0,,681
6,29819210,29819859,del,HG01102,0,,649
6,143265316,143268322,del,HG00475,0,,3006
6,67853545,67858927,del,NA19471,0,,5382
6,48096844,48100861,del,NA19384,0,,4017
6,162993373,163018521,del,HG00554,0,,25148
6,50765956,50766267,del,NA20796,0,,311
6,150366203,150370382,del,NA19443,0,,4179
6,158402348,158404313,del,NA12399,0,,1965
6,86372963,86373928,del,HG01390,0,,965
6,3774680,3779074,del,HG00560,0,,4394
6,67024961,67027284,del,NA19355,0,,2323
6,54747989,54760936,del,NA18487,0,,12947
6,41422022,41422271,del,NA12717,0,,249
6,73980190,73982422,del,NA19391,0,,2232
6,55471308,55477450,del,HG01051,0,,6142
6,15052359,15054063,del,NA19758,0,,1704
6,31278566,31288672,del,HG00131,0,,10106
6,119165115,119172808,del,NA19701,0,,7693
6,22001121,22013216,del,HG01173,0,,12095
6,10744228,10744470,del,NA19147,0,,242
6,98132879,98136976,del,HG00270,0,,4097
6,79657938,79659791,del,NA19704,0,,1853
6,20146728,20147151,del,NA18592,0,,423
6,146869326,146875783,del,HG00242,0,,6457
6,61897967,61905812,del,NA18871,0,,7845
6,163937065,163945618,del,HG00256,0,,8553
6,34712677,34716379,del,NA19434,0,,3702
6,43598329,43600642,del,NA19398,0,,2313
6,26744116,26749122,del,HG00472,0,,5006
6,66595036,66595830,del,NA18950,0,,794
6,45202006,45205528,del,HG00353,0,,3522
6,32630216,32633722,del,HG01465,0,,3506
6,31248708,31325523,del,NA18528,0,,76815
6,18106952,18112895,del,NA19235,0,,5943
6,144879910,144881187,del,NA19707,0,,1277
6,149676765,149685714,del,NA19093,0,,8949
6,29914981,29916983,del,NA19449,0,,2002
6,8368390,8369329,del,HG00232,0,,939
6,125038368,125040561,del,NA19725,0,,2193
6,160086344,160088820,del,HG01359,0,,2476
6,96580133,96580235,del,NA20770,0,,102
6,28018193,28021859,del,HG01204,0,,3666
6,168611005,168611093,del,NA11919,0,,88
6,168634596,168638483,del,NA19440,0,,3887
6,83676074,83676387,del,NA19435,0,,313
6,74228629,74229539,del,NA19077,0,,910
6,34166867,34167409,del,NA19916,0,,542
6,53924803,53934828,del,HG01124,0,,10025
6,149320727,149320948,del,NA11920,0,,221
6,67040800,67043189,del,HG00315,0,,2389
6,95334525,95359977,del,NA18557,0,,25452
6,147817150,147821031,del,NA19311,0,,3881
6,169004991,169006556,del,HG00531,0,,1565
6,57895641,58499641,del,HG01060,0,,604000
6,145127691,145128021,del,HG00542,0,,330
6,58717580,58718231,del,NA19777,0,,651
6,32454616,32511372,del,HG00173,0,,56756
6,32483929,32545595,del,HG01259,0,,61666
6,35845359,35852517,del,HG01073,0,,7158
6,41920839,41922117,del,NA12842,0,,1278
6,102314610,102319413,del,NA19401,0,,4803
6,114865764,114870658,del,NA12342,0,,4894
6,95193322,95194336,del,HG00318,0,,1014
6,128516164,128516706,del,NA19453,0,,542
6,48930945,48938533,del,NA20505,0,,7588
6,144045547,144046634,del,NA19835,0,,1087
6,162734528,162744234,del,HG00479,0,,9706
6,93469481,93472966,del,NA12342,0,,3485
6,84141594,84152385,del,NA18908,0,,10791
6,110476726,110479767,del,NA12006,0,,3041
6,168961226,168963098,del,NA19074,0,,1872
6,154252505,154253097,del,NA18517,0,,592
6,86259924,86263325,del,NA18530,0,,3401
6,74187804,74189021,del,HG00342,0,,1217
6,29921048,29922392,del,NA19904,0,,1344
6,29856032,29910834,del,NA20505,0,,54802
6,63929837,63948871,del,NA19311,0,,19034
6,155295002,155296598,del,NA19663,0,,1596
6,169591965,169592236,del,HG00704,0,,271
6,97505053,97505370,del,NA19225,0,,317
6,112422603,112424402,del,NA18916,0,,1799
6,31812977,31817182,del,NA19403,0,,4205
6,29891266,29904322,del,HG00112,0,,13056
6,170209984,170210367,del,HG01108,0,,383
6,49281753,49295040,del,NA19172,0,,13287
6,32592616,32633222,del,HG01066,0,,40606
6,138508099,138517093,del,NA19818,0,,8994
6,29917097,29937868,del,NA19107,0,,20771
6,32603816,32648122,del,NA19655,0,,44306
6,33093407,33093738,del,NA19670,0,,331
6,147934261,147936400,del,NA20340,0,,2139
6,78967194,79036497,del,HG01098,0,,69303
6,33026916,33028422,del,NA18910,0,,1506
6,26744116,26754622,del,HG01522,0,,10506
6,144647296,144654837,del,NA19311,0,,7541
6,25529870,25530011,del,NA20819,0,,141
6,23878282,23878995,del,HG01366,0,,713
6,170707618,170707973,del,NA19311,0,,355
6,100314880,100315657,del,NA18942,0,,777
6,19966898,19970819,del,NA18612,0,,3921
6,95387089,95588346,del,HG00180,0,,201257
6,149947660,149949335,del,NA19469,0,,1675
6,19041366,19048422,del,HG00127,0,,7056
6,58526247,58526316,del,NA18907,0,,69
6,167808743,167810811,del,HG00533,0,,2068
6,72667161,72667629,del,NA19920,0,,468
6,17727545,17728542,del,NA20126,0,,997
6,123850459,123853448,del,NA20816,0,,2989
6,68223038,68223313,del,NA12892,0,,275
6,71598997,71601675,del,NA19449,0,,2678
6,107581289,107584633,del,NA19079,0,,3344
6,93183740,93184229,del,HG00513,0,,489
6,34039368,34040163,del,NA20317,0,,795
6,134589316,134594722,del,NA18595,0,,5406
6,15418864,15419365,del,NA19455,0,,501
6,29851101,29905945,del,HG00419,0,,54844
6,3955842,3957814,del,HG01342,0,,1972
6,151506661,151512384,del,NA20506,0,,5723
6,29685666,29687872,del,NA18596,0,,2206
6,167178530,167178669,del,NA19083,0,,139
6,25897984,25898300,del,NA18508,0,,316
6,117093311,117097761,del,NA20340,0,,4450
6,162717924,162751299,del,NA19448,0,,33375
6,119139343,119156068,del,HG01489,0,,16725
6,168779849,168780836,del,NA19375,0,,987
6,141036433,141059524,del,NA18561,0,,23091
6,26745716,26754222,del,NA18631,0,,8506
6,121957522,121958326,del,HG01167,0,,804
6,154586583,154588410,del,NA11930,0,,1827
6,33583197,33585844,del,NA19197,0,,2647
6,12046742,12055436,del,HG00133,0,,8694
6,30940079,30999179,del,NA18986,0,,59100
6,31338316,31342022,del,NA18603,0,,3706
6,162403246,162404952,del,NA19235,0,,1706
6,90506540,90509899,del,NA19681,0,,3359
6,62200414,62206526,del,HG00613,0,,6112
6,168696640,168696850,del,NA18606,0,,210
6,108247927,108248759,del,NA18542,0,,832
6,28971010,28971276,del,HG01350,0,,266
6,106733845,106748493,del,NA20771,0,,14648
6,148030537,148033263,del,HG00701,0,,2726
6,29927109,29932969,del,HG01148,0,,5860
6,5692680,5706922,del,NA18582,0,,14242
6,10750305,10754117,del,NA19431,0,,3812
6,57730039,58337096,del,HG00373,0,,607057
6,130506665,130508108,del,NA19438,0,,1443
6,159224183,159224544,del,HG00246,0,,361
6,18327068,18331644,del,NA18546,0,,4576
6,73221940,73222765,del,HG00136,0,,825
6,159313923,159318649,del,NA18553,0,,4726
6,32514816,32552122,del,HG01187,0,,37306
6,81852379,81853880,del,HG00475,0,,1501
6,111168555,111169553,del,HG00338,0,,998
6,129282181,129283320,del,HG00557,0,,1139
6,32172902,32175044,del,NA19210,0,,2142
6,27067116,27069122,del,HG00690,0,,2006
6,34401957,34408252,del,HG00328,0,,6295
6,22261638,22263922,del,NA19066,0,,2284
6,32622530,32622817,del,HG00280,0,,287
6,32593516,32595022,del,HG00140,0,,1506
6,162083701,162084389,del,NA18573,0,,688
6,126160516,126161909,del,NA19391,0,,1393
6,30886430,30886570,del,NA20536,0,,140
6,156160622,156162339,del,NA18505,0,,1717
6,30604153,30610176,del,NA19920,0,,6023
6,29899770,29914857,del,NA18602,0,,15087
6,160086257,160088689,del,NA18985,0,,2432
6,125563143,125564182,del,HG00732,0,,1039
6,96670328,96683326,del,NA18538,0,,12998
6,150623542,150627585,del,NA19467,0,,4043
6,115703958,115718359,del,NA18916,0,,14401
6,18373397,18375888,del,NA19055,0,,2491
6,32026085,32029406,del,NA19372,0,,3321
6,167876685,167904835,del,NA18546,0,,28150
6,160132098,160133571,del,NA18559,0,,1473
6,93706492,93743343,del,HG01365,0,,36851
6,103647468,103657922,del,NA19438,0,,10454
6,22052769,22053727,del,NA19239,0,,958
6,87347006,87358342,del,HG00237,0,,11336
6,40365502,40368845,del,HG00253,0,,3343
6,8789739,8971253,del,HG01075,0,,181514
6,169591906,169592164,del,HG00258,0,,258
6,32559363,32559352,del,NA07037,0,,-11
6,30996167,30997739,del,NA18564,0,,1572
6,161262340,161262553,del,NA19654,0,,213
6,55281081,55281169,del,HG00111,0,,88
6,137313693,137314186,del,HG00404,0,,493
6,32460025,32468600,del,HG00427,0,,8575
6,31231276,31233106,del,HG00418,0,,1830
6,15188408,15190824,del,HG00278,0,,2416
6,67765341,67769087,del,HG00472,0,,3746
6,126793016,126798472,del,NA19087,0,,5456
6,32449187,32536921,del,HG00255,0,,87734
6,150328001,150391991,del,HG00315,0,,63990
6,167796652,167796868,del,HG00690,0,,216
6,55485525,55492757,del,HG00313,0,,7232
6,164413966,164415801,del,HG00651,0,,1835
6,70190685,70192260,del,NA11894,0,,1575
6,70014115,70018394,del,NA19189,0,,4279
6,2207342,2208361,del,NA19901,0,,1019
6,67008416,67048822,del,NA11932,0,,40406
6,82094015,82096439,del,NA19462,0,,2424
6,41749805,41750126,del,NA12843,0,,321
6,31239951,31325021,del,NA20755,0,,85070
6,7793258,7793599,del,NA10851,0,,341
6,135160537,135164858,del,NA18508,0,,4321
6,45098285,45099828,del,NA19470,0,,1543
6,32505816,32516122,del,HG00436,0,,10306
6,14305400,14305634,del,HG01048,0,,234
6,153644849,153657640,del,HG00339,0,,12791
6,8337681,8341579,del,NA19240,0,,3898
6,166895131,166895547,del,HG00543,0,,416
6,81168522,81174184,del,NA19909,0,,5662
6,90016,201822,del,NA20544,0,,111806
6,786051,786141,del,NA18605,0,,90
6,150080259,150080879,del,HG01357,0,,620
6,54780306,54780634,del,HG01359,0,,328
6,154817449,154817647,del,NA12828,0,,198
6,32522816,32547722,del,NA18547,0,,24906
6,74865433,74866584,del,NA20513,0,,1151
6,35496652,35498342,del,NA19390,0,,1690
6,133949673,133950539,del,HG01136,0,,866
6,41563050,41564365,del,NA19138,0,,1315
6,82127929,82136421,del,NA19116,0,,8492
6,124847070,124852213,del,NA19397,0,,5143
6,129737070,129737384,del,HG01047,0,,314
6,57661040,57663096,del,NA19701,0,,2056
6,121629449,121629831,del,HG00319,0,,382
6,96387601,96389421,del,NA18617,0,,1820
6,82029384,82034022,del,NA18519,0,,4638
6,103585657,103588032,del,NA18558,0,,2375
6,23460324,23465435,del,NA19456,0,,5111
6,425876,425958,del,HG00140,0,,82
6,21675893,21683444,del,HG00653,0,,7551
6,111942238,111944668,del,HG00671,0,,2430
6,47564729,47566910,del,HG01136,0,,2181
6,17949660,17951909,del,NA20535,0,,2249
6,66074061,66081426,del,NA19652,0,,7365
6,102880473,102883111,del,NA19920,0,,2638
6,159125944,159126375,del,NA19470,0,,431
6,3365563,3366466,del,HG01125,0,,903
6,168243905,168248406,del,HG01455,0,,4501
6,140385639,140392143,del,NA18593,0,,6504
6,36203993,36204159,del,NA18635,0,,166
6,122159134,122168933,del,NA18555,0,,9799
6,180946,734275,dup,HG03917,0,,553329
6,181655,253229,dup,HG03917,0,,71574
6,192162,209476,dup,HG01988,0,,17314
6,209927,257532,dup,HG03917,0,,47605
6,256502,293373,dup,HG00096,0,,36871
6,305181,340601,dup,HG00096,0,,35420
6,327586,368712,dup,HG00096,0,,41126
6,613060,710620,dup,HG03917,0,,97560
6,748249,867752,dup,HG02851,0,,119503
6,800445,1239636,dup,HG03917,0,,439191
6,834750,855598,dup,HG02851,0,,20848
6,861301,887630,dup,HG03917,0,,26329
6,1030311,1068491,dup,HG03917,0,,38180
6,1136082,1213994,dup,HG03917,0,,77912
6,1167152,1214489,dup,HG03917,0,,47337
6,2093826,2775906,dup,HG03940,0,,682080
6,2103053,2228438,dup,HG03940,0,,125385
6,2623525,2777052,dup,HG03940,0,,153527
6,3159421,3179441,dup,NA19143,0,,20020
6,3159475,3179363,dup,NA19143,0,,19888
6,3331802,3335906,dup,HG00475,0,,4104
6,4492139,4518189,dup,HG01808,0,,26050
6,4493130,4518544,dup,HG01808,0,,25414
6,4560140,4578739,dup,HG04061,0,,18599
6,5430346,5461445,dup,NA20802,0,,31099
6,5685403,5707396,dup,NA18582,0,,21993
6,5931240,5968244,dup,HG00704,0,,37004
6,6005355,6044598,dup,NA20294,0,,39243
6,6059080,6129357,dup,NA20294,0,,70277
6,6071321,6092829,dup,NA20294,0,,21508
6,6603533,6729866,dup,NA18559,0,,126333
6,7432898,7471066,dup,NA18571,0,,38168
6,7433416,7509403,dup,NA18571,0,,75987
6,7433438,7437722,dup,NA18571,0,,4284
6,7483593,7506324,dup,NA18571,0,,22731
6,7541771,7549189,dup,HG00406,0,,7418
6,8592488,8650825,dup,HG01528,0,,58337
6,8654394,8718667,dup,HG01528,0,,64273
6,8861594,8873796,dup,HG01075,0,,12202
6,9118354,9132743,dup,NA18949,0,,14389
6,9523789,9529662,dup,HG00581,0,,5873
6,10522684,10553539,dup,HG02292,0,,30855
6,10727044,10755114,dup,HG00739,0,,28070
6,11168604,11173000,dup,HG02343,0,,4396
6,14866191,14881982,dup,HG01522,0,,15791
6,15086594,15090923,dup,NA06994,0,,4329
6,15417191,15420339,dup,NA18630,0,,3148
6,15538086,15548988,dup,HG01599,0,,10902
6,15660635,15716100,dup,NA18507,0,,55465
6,15660778,15725522,dup,NA19189,0,,64744
6,16259171,16264893,dup,HG01102,0,,5722
6,16390866,16400749,dup,HG00176,0,,9883
6,17620463,17665802,dup,HG00879,0,,45339
6,17706148,17715829,dup,HG00879,0,,9681
6,17713945,17718402,dup,HG01054,0,,4457
6,17715610,17949453,dup,HG00879,0,,233843
6,17729045,17858880,dup,HG00879,0,,129835
6,18497816,18535271,dup,HG01924,0,,37455
6,18754034,18760092,dup,HG02497,0,,6058
6,20652811,20771549,dup,HG00278,0,,118738
6,20664168,20716372,dup,HG00278,0,,52204
6,20861636,20929129,dup,HG00278,0,,67493
6,21889960,21896425,dup,NA19473,0,,6465
6,22169918,22174993,dup,HG00127,0,,5075
6,23299957,23328354,dup,HG02690,0,,28397
6,23745619,23764817,dup,HG03247,0,,19198
6,25144020,25149595,dup,HG02819,0,,5575
6,25405135,25419531,dup,NA12340,0,,14396
6,25695521,25712205,dup,NA19041,0,,16684
6,26026150,26045624,dup,HG00451,0,,19474
6,26103326,26124566,dup,HG00451,0,,21240
6,26151627,26159209,dup,HG02546,0,,7582
6,26196510,26207435,dup,NA12340,0,,10925
6,26368929,26406147,dup,HG02127,0,,37218
6,26678936,26686491,dup,HG02703,0,,7555
6,26739614,26748928,dup,HG00096,0,,9314
6,26762088,26892993,dup,NA11933,0,,130905
6,27618361,27670141,dup,HG01079,0,,51780
6,27634480,27648234,dup,HG01079,0,,13754
6,27732716,27767697,dup,HG01441,0,,34981
6,27795275,27807758,dup,HG00451,0,,12483
6,28525045,28625916,dup,HG03910,0,,100871
6,28533516,28751023,dup,HG03910,0,,217507
6,28777688,28788267,dup,HG03910,0,,10579
6,28791584,28808328,dup,HG03910,0,,16744
6,28814370,28854382,dup,HG03910,0,,40012
6,28849069,28887746,dup,HG03469,0,,38677
6,29080384,29182072,dup,HG00151,0,,101688
6,29089825,29161292,dup,HG00263,0,,71467
6,29128515,29334555,dup,NA18977,0,,206040
6,29213878,29241086,dup,NA19473,0,,27208
6,29830804,29837601,dup,HG01746,0,,6797
6,30053362,30087474,dup,NA18548,0,,34112
6,30857477,30955281,dup,HG01990,0,,97804
6,31107620,31143994,dup,HG02943,0,,36374
6,31131451,31272307,dup,HG00732,0,,140856
6,31138445,31155619,dup,HG02943,0,,17174
6,31234663,31319748,dup,NA18563,0,,85085
6,31259136,31275725,dup,NA18563,0,,16589
6,31278877,31288698,dup,HG00100,0,,9821
6,31333469,31356647,dup,HG02546,0,,23178
6,33406829,34044712,dup,HG00662,0,,637883
6,33963289,33969265,dup,HG00740,0,,5976
6,34529530,34604140,dup,NA18951,0,,74610
6,34537009,34576512,dup,NA18951,0,,39503
6,35481688,35497182,dup,HG03117,0,,15494
6,35488981,35568295,dup,HG00114,0,,79314
6,35501324,35515871,dup,HG00114,0,,14547
6,35520005,35565675,dup,HG00114,0,,45670
6,35521984,35568895,dup,HG00358,0,,46911
6,35631998,35806257,dup,HG03913,0,,174259
6,35677078,35739769,dup,HG03913,0,,62691
6,35754684,35766728,dup,HG00096,0,,12044
6,35773187,35787706,dup,HG03913,0,,14519
6,37687537,37733454,dup,HG01628,0,,45917
6,37787433,37823192,dup,HG01628,0,,35759
6,37831148,37838433,dup,HG01628,0,,7285
6,37841452,37894591,dup,HG01628,0,,53139
6,37961552,37987678,dup,HG00542,0,,26126
6,38145885,38182337,dup,HG00662,0,,36452
6,38181292,38192207,dup,HG01046,0,,10915
6,38202712,38234690,dup,NA21111,0,,31978
6,38237680,38506071,dup,NA21111,0,,268391
6,39592989,39636830,dup,HG02771,0,,43841
6,40244348,40247815,dup,HG02784,0,,3467
6,41300134,41365322,dup,HG03782,0,,65188
6,42143664,42155871,dup,HG00263,0,,12207
6,44148346,44152453,dup,NA18747,0,,4107
6,44293609,44319449,dup,NA19764,0,,25840
6,44946293,44975280,dup,NA18974,0,,28987
6,44997373,45042574,dup,HG00136,0,,45201
6,45792906,45803835,dup,NA20318,0,,10929
6,48330252,48459273,dup,HG03247,0,,129021
6,48341061,48390343,dup,HG03247,0,,49282
6,48667531,48689857,dup,HG02095,0,,22326
6,49063343,49138106,dup,HG00364,0,,74763
6,49079400,49128928,dup,HG00364,0,,49528
6,49225123,49236555,dup,NA20543,0,,11432
6,49429894,49448127,dup,HG00154,0,,18233
6,49770671,49806488,dup,HG03127,0,,35817
6,49831087,49900035,dup,NA20756,0,,68948
6,49855549,49898181,dup,NA20756,0,,42632
6,50138852,50153229,dup,HG01858,0,,14377
6,51306288,51327042,dup,NA19024,0,,20754
6,51475621,51492150,dup,HG04158,0,,16529
6,52219899,52232309,dup,NA12044,0,,12410
6,52243876,52289498,dup,HG03052,0,,45622
6,52625765,52666805,dup,HG00266,0,,41040
6,52627553,52661874,dup,HG01164,0,,34321
6,52659396,52670836,dup,HG02156,0,,11440
6,52792899,52796386,dup,HG01069,0,,3487
6,53581312,53592678,dup,HG02820,0,,11366
6,53630502,53664671,dup,HG00253,0,,34169
6,53916950,53986098,dup,NA18552,0,,69148
6,53919016,53926625,dup,HG02087,0,,7609
6,53933529,53981843,dup,NA18552,0,,48314
6,54724890,54766827,dup,HG03976,0,,41937
6,55464396,55476959,dup,HG03668,0,,12563
6,55480931,55493097,dup,HG00130,0,,12166
6,56144134,56148133,dup,NA20818,0,,3999
6,56913008,56945526,dup,HG01438,0,,32518
6,56945027,56951900,dup,HG01438,0,,6873
6,57088331,57095930,dup,NA19338,0,,7599
6,57096145,57206444,dup,NA20813,0,,110299
6,57107009,57171180,dup,NA20813,0,,64171
6,57205859,57340406,dup,HG00096,0,,134547
6,57268496,57297686,dup,HG00096,0,,29190
6,57300713,57307658,dup,HG00132,0,,6945
6,57323278,57382868,dup,NA19771,0,,59590
6,57357393,57417744,dup,NA19771,0,,60351
6,57427679,57459261,dup,NA19771,0,,31582
6,57450653,57479094,dup,HG00096,0,,28441
6,57494274,57528261,dup,NA19771,0,,33987
6,57570119,57623086,dup,HG00684,0,,52967
6,57627196,57691955,dup,HG00684,0,,64759
6,57678688,57719415,dup,HG00684,0,,40727
6,57704872,57959361,dup,HG00684,0,,254489
6,57876774,58055521,dup,NA19771,0,,178747
6,58185189,58197898,dup,HG02634,0,,12709
6,58310079,58361125,dup,HG01880,0,,51046
6,58365535,58419127,dup,NA20585,0,,53592
6,58602726,58608399,dup,HG00638,0,,5673
6,61949398,62034247,dup,NA19771,0,,84849
6,62052828,62112367,dup,NA19771,0,,59539
6,62186462,62256526,dup,HG01031,0,,70064
6,62249890,62314569,dup,HG02351,0,,64679
6,62330992,62374573,dup,HG02143,0,,43581
6,62343964,62390762,dup,HG02143,0,,46798
6,62376214,62510383,dup,HG02351,0,,134169
6,62385396,62438034,dup,HG02351,0,,52638
6,62432241,62464231,dup,HG00101,0,,31990
6,62460663,62486897,dup,HG02351,0,,26234
6,62489154,62501464,dup,NA11931,0,,12310
6,62494489,62648695,dup,HG02351,0,,154206
6,62523894,62703267,dup,HG02351,0,,179373
6,62524144,62553918,dup,HG02351,0,,29774
6,62704592,62920556,dup,NA11931,0,,215964
6,62834096,62896611,dup,NA18873,0,,62515
6,63299196,63357177,dup,NA19397,0,,57981
6,63403547,63415166,dup,HG02586,0,,11619
6,63623576,63635034,dup,NA18530,0,,11458
6,63668631,63704027,dup,HG02586,0,,35396
6,63720679,63840796,dup,NA18965,0,,120117
6,64009155,64023228,dup,HG03593,0,,14073
6,65039774,65053030,dup,NA18757,0,,13256
6,65896679,65903689,dup,HG00121,0,,7010
6,65897606,65945656,dup,HG03802,0,,48050
6,65918793,65943737,dup,HG03802,0,,24944
6,66223815,66289149,dup,HG00240,0,,65334
6,66566312,66577481,dup,HG00759,0,,11169
6,67133617,67143065,dup,HG00464,0,,9448
6,67159737,67167245,dup,HG00464,0,,7508
6,67561736,67565785,dup,HG01866,0,,4049
6,67847906,67859659,dup,HG02439,0,,11753
6,68232134,68451944,dup,HG02013,0,,219810
6,68308906,68335197,dup,HG02013,0,,26291
6,68452758,68505727,dup,NA12234,0,,52969
6,68460183,68497494,dup,NA12234,0,,37311
6,68818166,68837326,dup,HG02345,0,,19160
6,69123186,69126254,dup,HG02231,0,,3068
6,69128090,69171682,dup,NA18950,0,,43592
6,69180766,69185970,dup,HG02325,0,,5204
6,69230141,69241925,dup,HG00109,0,,11784
6,69365031,69397641,dup,NA11843,0,,32610
6,69687538,69691816,dup,HG00112,0,,4278
6,70123577,70176793,dup,HG01941,0,,53216
6,70127158,70236707,dup,HG01941,0,,109549
6,70202619,70223000,dup,HG01527,0,,20381
6,71030889,71036492,dup,HG01886,0,,5603
6,71639666,71651965,dup,HG01872,0,,12299
6,71648159,71655969,dup,HG01485,0,,7810
6,71868686,71875601,dup,NA19323,0,,6915
6,71982894,72011170,dup,HG02386,0,,28276
6,72818184,72828875,dup,HG00404,0,,10691
6,72827626,72834481,dup,HG00238,0,,6855
6,73933212,73943418,dup,HG00698,0,,10206
6,74038666,74052734,dup,HG02557,0,,14068
6,74457105,74475316,dup,HG03870,0,,18211
6,74540083,74547088,dup,HG00254,0,,7005
6,74564078,74592885,dup,NA18508,0,,28807
6,74591999,74602382,dup,HG00096,0,,10383
6,74707830,74718484,dup,HG00123,0,,10654
6,75061249,75141129,dup,NA18967,0,,79880
6,75370887,75449989,dup,HG02666,0,,79102
6,75451789,75565102,dup,HG02666,0,,113313
6,75569647,75662093,dup,HG02666,0,,92446
6,75686720,75786344,dup,HG03823,0,,99624
6,76646402,76702351,dup,NA20505,0,,55949
6,76666356,76676652,dup,NA20505,0,,10296
6,76978725,76983923,dup,HG02049,0,,5198
6,77411329,77503998,dup,HG02521,0,,92669
6,77418033,77434693,dup,HG00464,0,,16660
6,77437459,77453275,dup,HG00096,0,,15816
6,77465837,77497156,dup,HG00464,0,,31319
6,77539554,77563166,dup,HG01513,0,,23612
6,77662072,77787077,dup,HG04188,0,,125005
6,78134168,78140594,dup,HG01182,0,,6426
6,78879305,78898720,dup,HG01075,0,,19415
6,78892808,79053430,dup,HG00097,0,,160622
6,78899046,78903545,dup,HG01985,0,,4499
6,78918827,78967871,dup,HG03097,0,,49044
6,78967097,79036275,dup,HG00097,0,,69178
6,79378390,79432884,dup,NA18988,0,,54494
6,79796411,79883903,dup,NA20766,0,,87492
6,79899898,79924571,dup,NA20766,0,,24673
6,80112750,80264169,dup,HG01802,0,,151419
6,80125584,80230443,dup,HG01802,0,,104859
6,80333771,80357706,dup,HG01802,0,,23935
6,80884508,81013571,dup,HG01802,0,,129063
6,80887030,80938275,dup,HG01802,0,,51245
6,81506945,81513790,dup,HG01896,0,,6845
6,81532546,81553863,dup,HG00159,0,,21317
6,82153541,82174673,dup,NA18972,0,,21132
6,83520186,83574783,dup,NA12399,0,,54597
6,83523953,83563850,dup,NA12399,0,,39897
6,83954506,83961122,dup,HG03199,0,,6616
6,84245092,84259630,dup,HG02614,0,,14538
6,84765561,84796467,dup,HG02922,0,,30906
6,85033660,85222052,dup,HG02922,0,,188392
6,85213533,85334845,dup,HG02146,0,,121312
6,85390517,85443795,dup,HG02146,0,,53278
6,85502648,85557645,dup,HG02146,0,,54997
6,85616185,85652598,dup,HG02146,0,,36413
6,85690750,85704704,dup,HG01918,0,,13954
6,86378324,86382817,dup,HG02134,0,,4493
6,86397705,86433137,dup,NA20801,0,,35432
6,87101255,87132570,dup,HG01853,0,,31315
6,87252140,87282863,dup,HG03055,0,,30723
6,87367194,87528670,dup,HG03754,0,,161476
6,88138945,88143289,dup,HG02938,0,,4344
6,88663882,88673289,dup,HG03066,0,,9407
6,88836377,88867149,dup,NA20532,0,,30772
6,89056528,89135542,dup,NA18644,0,,79014
6,89154477,89164015,dup,HG00099,0,,9538
6,89692771,89702715,dup,NA19086,0,,9944
6,89719019,89726463,dup,NA19086,0,,7444
6,90153016,90166824,dup,HG02977,0,,13808
6,90153836,90219270,dup,NA19248,0,,65434
6,90156288,90394830,dup,NA19248,0,,238542
6,90163067,90315741,dup,NA19248,0,,152674
6,91832056,91845414,dup,NA19394,0,,13358
6,91849767,91960709,dup,NA19394,0,,110942
6,92540222,92551973,dup,HG00355,0,,11751
6,92673516,92747970,dup,HG01920,0,,74454
6,92681597,92740693,dup,HG01920,0,,59096
6,93064575,93153604,dup,NA19093,0,,89029
6,93066429,93150332,dup,NA19093,0,,83903
6,93366356,93391869,dup,HG02081,0,,25513
6,93990937,94014639,dup,HG01615,0,,23702
6,94737503,94844028,dup,NA20357,0,,106525
6,94922234,95049169,dup,NA20357,0,,126935
6,95066544,95209556,dup,HG03729,0,,143012
6,95243787,95286789,dup,NA18636,0,,43002
6,95344734,95359854,dup,HG02155,0,,15120
6,95363755,95393975,dup,NA20908,0,,30220
6,95399630,95430561,dup,HG00171,0,,30931
6,95434130,95462116,dup,HG00125,0,,27986
6,95440413,95567493,dup,HG02139,0,,127080
6,95464267,95510694,dup,HG00125,0,,46427
6,95500120,95533738,dup,HG00125,0,,33618
6,95523100,95591163,dup,HG00171,0,,68063
6,95571060,95623756,dup,HG01375,0,,52696
6,96738567,96742467,dup,HG00343,0,,3900
6,97695651,97709345,dup,HG03920,0,,13694
6,97855214,97901456,dup,HG03920,0,,46242
6,100346647,100385973,dup,NA19700,0,,39326
6,101197216,101326762,dup,HG03884,0,,129546
6,101198060,101411646,dup,HG03884,0,,213586
6,101944846,101974013,dup,NA19010,0,,29167
6,102314571,102319438,dup,HG01577,0,,4867
6,102349405,102546571,dup,HG02003,0,,197166
6,102546854,102558185,dup,HG02888,0,,11331
6,102566480,102577822,dup,HG01510,0,,11342
6,102581358,102596017,dup,HG02839,0,,14659
6,102757875,102764901,dup,HG01326,0,,7026
6,102985973,102998181,dup,NA12778,0,,12208
6,103489932,103522535,dup,HG01121,0,,32603
6,103961044,104116429,dup,HG02003,0,,155385
6,103963998,103996441,dup,HG02003,0,,32443
6,104004177,104039676,dup,HG01119,0,,35499
6,104056023,104287477,dup,HG02003,0,,231454
6,104164827,104318206,dup,HG02003,0,,153379
6,104864385,104936491,dup,HG00143,0,,72106
6,104899310,104937748,dup,HG01108,0,,38438
6,105322417,105519910,dup,NA11881,0,,197493
6,105324440,105370415,dup,NA11881,0,,45975
6,105448626,105586104,dup,NA11881,0,,137478
6,105523654,105587339,dup,NA11881,0,,63685
6,106494585,106510005,dup,HG04183,0,,15420
6,106560625,106905461,dup,HG03063,0,,344836
6,106560632,106684493,dup,HG03063,0,,123861
6,106560737,106641879,dup,HG03063,0,,81142
6,106707130,106906740,dup,HG03063,0,,199610
6,107161002,107173816,dup,HG00150,0,,12814
6,107161526,107173271,dup,HG02624,0,,11745
6,107289486,107300334,dup,HG03445,0,,10848
6,107540629,107543901,dup,NA19451,0,,3272
6,108665289,108678230,dup,HG01530,0,,12941
6,108789505,108793079,dup,HG03756,0,,3574
6,109233889,109244375,dup,HG02577,0,,10486
6,109771296,109786244,dup,HG01607,0,,14948
6,110176988,110182627,dup,HG00136,0,,5639
6,110396176,110415063,dup,HG01162,0,,18887
6,110665409,110670144,dup,HG00632,0,,4735
6,110875967,110887889,dup,HG00479,0,,11922
6,111212663,111227024,dup,HG02084,0,,14361
6,112144281,112194135,dup,NA19332,0,,49854
6,112636403,112658703,dup,HG02817,0,,22300
6,112640042,112687946,dup,HG02817,0,,47904
6,113645183,113650168,dup,HG01443,0,,4985
6,113754046,113769139,dup,HG04225,0,,15093
6,113858636,113873904,dup,HG02284,0,,15268
6,114593802,114666267,dup,NA19092,0,,72465
6,114597550,114637523,dup,NA19092,0,,39973
6,114612191,114625686,dup,HG01360,0,,13495
6,114670691,114824929,dup,NA19092,0,,154238
6,115222670,115491537,dup,NA19092,0,,268867
6,115378570,115491750,dup,NA19092,0,,113180
6,116262892,116289849,dup,HG00452,0,,26957
6,117093333,117097739,dup,HG01200,0,,4406
6,117422845,117434225,dup,HG02215,0,,11380
6,117496472,117579456,dup,HG03091,0,,82984
6,117508081,117562634,dup,HG03091,0,,54553
6,118667391,118713443,dup,HG03788,0,,46052
6,118723753,118864963,dup,NA18988,0,,141210
6,118729992,118863286,dup,HG03788,0,,133294
6,118857059,118915082,dup,NA21112,0,,58023
6,118884329,119091473,dup,NA21112,0,,207144
6,119585366,119603212,dup,HG03856,0,,17846
6,120740366,120756291,dup,HG00276,0,,15925
6,120982773,121021227,dup,HG00623,0,,38454
6,122020495,122031989,dup,HG00189,0,,11494
6,123676959,123746363,dup,HG01668,0,,69404
6,123754858,123758297,dup,HG02808,0,,3439
6,124175633,124245374,dup,NA19043,0,,69741
6,124427277,124475801,dup,HG00382,0,,48524
6,124430743,124470950,dup,HG00323,0,,40207
6,124547177,124564168,dup,HG01571,0,,16991
6,124648967,124669010,dup,HG03745,0,,20043
6,125366285,125383295,dup,NA19023,0,,17010
6,125366328,125377898,dup,NA19023,0,,11570
6,125534139,125595908,dup,HG00479,0,,61769
6,125534213,125567428,dup,HG00479,0,,33215
6,125764922,125779214,dup,HG04227,0,,14292
6,125861487,125904424,dup,NA19031,0,,42937
6,126182984,126187328,dup,HG00097,0,,4344
6,126811634,126816687,dup,HG02521,0,,5053
6,127666416,127670047,dup,HG00596,0,,3631
6,128044356,128050150,dup,HG03419,0,,5794
6,128949579,129033539,dup,HG01796,0,,83960
6,129069774,129366135,dup,HG01796,0,,296361
6,129086351,129172233,dup,HG02660,0,,85882
6,129199668,129364829,dup,HG01796,0,,165161
6,129281305,129669766,dup,HG01796,0,,388461
6,129329211,129366385,dup,HG01796,0,,37174
6,129379735,129428189,dup,HG01796,0,,48454
6,129573864,129835294,dup,HG01796,0,,261430
6,129867837,129895827,dup,HG00610,0,,27990
6,129980341,130063399,dup,HG01796,0,,83058
6,130169321,130397723,dup,HG03762,0,,228402
6,130262135,130298802,dup,HG03873,0,,36667
6,130429759,130563231,dup,HG03873,0,,133472
6,131397933,131406392,dup,HG01776,0,,8459
6,131415061,131446898,dup,HG03135,0,,31837
6,131422195,131460314,dup,HG03135,0,,38119
6,131580858,131604113,dup,HG03977,0,,23255
6,131582441,131649026,dup,HG03977,0,,66585
6,131606635,131643469,dup,HG03977,0,,36834
6,132075566,132166076,dup,HG03780,0,,90510
6,132227880,132235057,dup,HG03780,0,,7177
6,132397299,132438972,dup,HG01479,0,,41673
6,132494580,132515925,dup,HG02697,0,,21345
6,133066061,133071519,dup,HG03123,0,,5458
6,133077834,133083308,dup,HG03784,0,,5474
6,133172041,133184707,dup,HG02688,0,,12666
6,134029903,134035556,dup,HG01842,0,,5653
6,134451256,134470177,dup,HG02568,0,,18921
6,135258362,135276277,dup,NA20531,0,,17915
6,135505605,135522682,dup,NA20531,0,,17077
6,135839694,135871222,dup,HG03694,0,,31528
6,136720881,136737620,dup,HG03995,0,,16739
6,136721443,136737776,dup,HG03995,0,,16333
6,136804962,136840211,dup,NA19058,0,,35249
6,136853690,136867167,dup,NA19472,0,,13477
6,137367730,137421223,dup,HG01130,0,,53493
6,137383269,137417036,dup,HG01130,0,,33767
6,137897086,137964150,dup,HG00181,0,,67064
6,137897383,137963501,dup,HG00324,0,,66118
6,138031806,138048060,dup,HG00266,0,,16254
6,138033089,138048129,dup,HG03490,0,,15040
6,138136782,138147393,dup,HG01623,0,,10611
6,139062178,139075540,dup,HG00148,0,,13362
6,139465546,139478998,dup,HG02397,0,,13452
6,140390828,140598548,dup,HG02778,0,,207720
6,140403413,140412151,dup,HG01817,0,,8738
6,140628839,140718988,dup,NA19759,0,,90149
6,140638722,140894926,dup,NA19759,0,,256204
6,140643263,140703911,dup,NA19759,0,,60648
6,140698908,140717795,dup,HG02870,0,,18887
6,140851396,140902212,dup,HG01992,0,,50816
6,140927136,140961702,dup,NA19038,0,,34566
6,140953431,141001071,dup,HG01200,0,,47640
6,141012651,141134254,dup,HG01923,0,,121603
6,141028859,141063393,dup,NA18561,0,,34534
6,141113775,141263065,dup,HG01852,0,,149290
6,141193473,141461494,dup,NA20815,0,,268021
6,141275021,141305391,dup,NA20815,0,,30370
6,141313567,141369948,dup,NA20815,0,,56381
6,141372199,141383591,dup,HG03081,0,,11392
6,141385529,141466284,dup,NA20815,0,,80755
6,141479394,141554641,dup,NA20815,0,,75247
6,141897404,142155150,dup,HG03716,0,,257746
6,142072214,142135787,dup,HG03716,0,,63573
6,142189011,142249923,dup,HG01363,0,,60912
6,143117510,143126961,dup,HG00693,0,,9451
6,143117541,143127544,dup,HG00628,0,,10003
6,144904773,144922521,dup,HG02312,0,,17748
6,145187737,145275235,dup,HG00631,0,,87498
6,145275913,145334750,dup,HG00631,0,,58837
6,147133402,147139615,dup,HG00240,0,,6213
6,147209621,147220879,dup,NA18943,0,,11258
6,147448596,147493783,dup,HG03160,0,,45187
6,147849685,147858077,dup,HG00626,0,,8392
6,149504252,149513319,dup,HG00640,0,,9067
6,151210314,151222629,dup,HG03600,0,,12315
6,151214207,151220774,dup,HG03600,0,,6567
6,151387612,151398061,dup,HG01675,0,,10449
6,151387924,151399031,dup,HG00182,0,,11107
6,151507041,151512489,dup,HG00114,0,,5448
6,151918596,151964154,dup,HG01254,0,,45558
6,152811386,152839116,dup,HG01783,0,,27730
6,153143448,153174988,dup,NA18573,0,,31540
6,153420390,153426221,dup,HG01950,0,,5831
6,153958312,153961510,dup,HG00097,0,,3198
6,154094788,154121290,dup,NA19308,0,,26502
6,154133752,154187388,dup,NA19308,0,,53636
6,155290077,155336274,dup,HG03028,0,,46197
6,157068609,157078739,dup,NA18616,0,,10130
6,158627769,158640355,dup,NA18943,0,,12586
6,159812061,159819007,dup,HG02265,0,,6946
6,160432890,160564713,dup,NA18953,0,,131823
6,160588961,160800892,dup,NA18953,0,,211931
6,160667136,160733984,dup,NA20813,0,,66848
6,160679168,160734313,dup,NA18953,0,,55145
6,160877744,160956591,dup,NA18953,0,,78847
6,160909025,160924908,dup,HG00537,0,,15883
6,161251610,161266183,dup,NA19319,0,,14573
6,161351815,161568053,dup,HG00277,0,,216238
6,161351821,161392464,dup,HG00277,0,,40643
6,161717015,161726234,dup,NA20889,0,,9219
6,161984620,162148838,dup,HG00280,0,,164218
6,161988806,162506567,dup,HG00280,0,,517761
6,161997128,162055560,dup,HG00280,0,,58432
6,162166487,162257382,dup,HG00280,0,,90895
6,162181474,162195996,dup,HG00280,0,,14522
6,162198297,162238956,dup,HG00280,0,,40659
6,162234730,162255365,dup,NA20754,0,,20635
6,162235064,162269577,dup,NA20754,0,,34513
6,162274215,162489106,dup,HG00280,0,,214891
6,162478187,162500215,dup,HG03717,0,,22028
6,162494422,162511711,dup,HG02645,0,,17289
6,162561824,162707658,dup,HG00182,0,,145834
6,162616082,162628023,dup,HG00182,0,,11941
6,162638912,162680877,dup,HG03717,0,,41965
6,162668114,162711975,dup,HG00593,0,,43861
6,162690350,162783652,dup,HG00593,0,,93302
6,162712426,162751899,dup,HG00176,0,,39473
6,162735369,162773464,dup,HG00176,0,,38095
6,162761240,162799311,dup,HG00593,0,,38071
6,162789935,162959315,dup,HG00593,0,,169380
6,162801262,162839620,dup,HG00593,0,,38358
6,162843999,162891532,dup,HG00593,0,,47533
6,162892206,162920384,dup,HG00593,0,,28178
6,162919254,162960561,dup,HG00593,0,,41307
6,162924604,162946412,dup,HG00593,0,,21808
6,162949194,162959850,dup,HG00593,0,,10656
6,162966492,162978361,dup,HG01051,0,,11869
6,162976350,163003637,dup,HG01051,0,,27287
6,162999037,163054047,dup,HG01620,0,,55010
6,163010055,163095654,dup,HG01620,0,,85599
6,163039621,163078036,dup,HG01620,0,,38415
6,163194898,163277643,dup,HG03772,0,,82745
6,163280346,163357957,dup,HG03772,0,,77611
6,164748081,164829593,dup,NA19089,0,,81512
6,165130409,165201870,dup,HG01204,0,,71461
6,165138921,165187900,dup,HG01204,0,,48979
6,165875523,165893735,dup,HG03055,0,,18212
6,165968258,165987833,dup,NA20850,0,,19575
6,167366436,167385546,dup,HG01578,0,,19110
6,167569172,167924324,dup,HG02054,0,,355152
6,167569516,167727185,dup,HG00096,0,,157669
6,167608293,167655957,dup,HG02054,0,,47664
6,167669869,167733990,dup,HG02571,0,,64121
6,167704476,167723317,dup,HG02571,0,,18841
6,167736868,167771785,dup,HG02571,0,,34917
6,167764487,167924494,dup,HG03518,0,,160007
6,167774507,167785306,dup,HG01369,0,,10799
6,167807365,167835459,dup,HG02054,0,,28094
6,167837979,167880907,dup,HG02054,0,,42928
6,167867175,167901476,dup,NA18546,0,,34301
6,167928049,167940297,dup,HG02054,0,,12248
6,167941586,168156763,dup,HG02054,0,,215177
6,168333425,168431521,dup,HG01395,0,,98096
6,168333545,168597751,dup,HG00232,0,,264206
6,168335387,168376711,dup,HG00232,0,,41324
6,168537946,168597160,dup,HG00232,0,,59214
6,168559412,168653136,dup,HG02678,0,,93724
6,168599923,168645656,dup,HG02678,0,,45733
6,169656705,169700799,dup,HG03720,0,,44094
6,170868301,170910378,dup,HG03812,0,,42077
7,62687379,62804100,del,NA18541,0,,116721
7,119218398,119233859,del,NA19463,0,,15461
7,7106976,7108518,del,HG01366,0,,1542
7,4577985,4578994,del,HG01107,0,,1009
7,65589703,65591965,del,NA19072,0,,2262
7,146253853,146254690,del,NA19375,0,,837
7,224466,225772,del,NA19755,0,,1306
7,149714492,149716599,del,NA20294,0,,2107
7,108884718,108884847,del,HG01461,0,,129
7,313769,335009,del,NA18549,0,,21240
7,40055774,40059244,del,NA12045,0,,3470
7,155017686,155018930,del,HG01082,0,,1244
7,157769119,157772007,del,HG00252,0,,2888
7,49173333,49180022,del,NA19463,0,,6689
7,27295352,27297267,del,NA19247,0,,1915
7,127449160,127452538,del,HG00142,0,,3378
7,129141177,129143205,del,NA19704,0,,2028
7,54165693,54165855,del,NA18546,0,,162
7,56800840,56802073,del,NA18868,0,,1233
7,11946465,11946979,del,HG00339,0,,514
7,75379288,75379593,del,HG00663,0,,305
7,111941766,111963145,del,HG01354,0,,21379
7,38388466,38397622,del,HG00553,0,,9156
7,13272097,13313001,del,HG00581,0,,40904
7,131078730,131080850,del,NA19114,0,,2120
7,102081587,102084401,del,NA19901,0,,2814
7,66845530,66846145,del,NA20778,0,,615
7,97655744,97657541,del,HG01051,0,,1797
7,155409817,155409994,del,NA19704,0,,177
7,1232783,1243288,del,NA11892,0,,10505
7,12058800,12058992,del,NA18555,0,,192
7,140582191,140587939,del,HG01350,0,,5748
7,1892218,1892489,del,NA18602,0,,271
7,102595684,102596834,del,NA20803,0,,1150
7,78700636,78701561,del,NA19393,0,,925
7,83750919,83751254,del,NA19700,0,,335
7,14548425,14552032,del,NA18543,0,,3607
7,90478510,90479603,del,NA18517,0,,1093
7,89617235,89619578,del,HG01440,0,,2343
7,129596879,129597891,del,NA19360,0,,1012
7,5149087,5174572,del,NA19713,0,,25485
7,36441168,36441942,del,NA19338,0,,774
7,92146658,92148107,del,NA19920,0,,1449
7,153166001,153166252,del,NA19921,0,,251
7,100533439,100536237,del,NA12155,0,,2798
7,77142677,77142829,del,HG00247,0,,152
7,138300258,138300497,del,NA18947,0,,239
7,62962516,62978922,del,HG01149,0,,16406
7,50993037,51000943,del,NA19449,0,,7906
7,155882437,155886836,del,NA20757,0,,4399
7,17554653,17567633,del,NA11918,0,,12980
7,70619672,70624877,del,NA19819,0,,5205
7,149731959,149733058,del,NA19685,0,,1099
7,80157652,80157796,del,NA19318,0,,144
7,4081264,4082296,del,NA19092,0,,1032
7,148091403,148094213,del,HG00436,0,,2810
7,157116741,157122629,del,HG00331,0,,5888
7,97993624,97993982,del,NA12282,0,,358
7,157388157,157388301,del,NA12751,0,,144
7,135141011,135144041,del,NA06989,0,,3030
7,145268739,145269130,del,NA19093,0,,391
7,158962733,158963044,del,NA19404,0,,311
7,149847642,149849128,del,NA20798,0,,1486
7,115583564,115587799,del,HG00610,0,,4235
7,11252527,11252874,del,NA19383,0,,347
7,133671412,133675615,del,NA19782,0,,4203
7,153124150,153125250,del,HG00705,0,,1100
7,117518212,117520050,del,NA18910,0,,1838
7,158055214,158055415,del,HG00581,0,,201
7,158052416,158052568,del,NA19360,0,,152
7,110581904,110585853,del,HG00427,0,,3949
7,20992258,20994120,del,NA19004,0,,1862
7,127214969,127217981,del,NA18981,0,,3012
7,1300975,1301271,del,HG00613,0,,296
7,96549997,96552026,del,HG01108,0,,2029
7,30481116,30485122,del,HG00663,0,,4006
7,32774866,32777522,del,NA19067,0,,2656
7,54514,59899,del,NA18907,0,,5385
7,16683128,16683586,del,NA19371,0,,458
7,77314159,77321871,del,HG00269,0,,7712
7,61745882,61785112,del,HG01350,0,,39230
7,81920161,81927437,del,NA18536,0,,7276
7,142367392,142367723,del,NA19159,0,,331
7,157602013,157606336,del,NA19391,0,,4323
7,6121266,6145072,del,NA18516,0,,23806
7,104975148,104975479,del,HG01390,0,,331
7,57284606,57284992,del,HG01101,0,,386
7,33177805,33179368,del,HG00464,0,,1563
7,124982595,124987785,del,HG01140,0,,5190
7,68890800,68891316,del,NA19819,0,,516
7,34553595,34563310,del,NA18615,0,,9715
7,93287812,93292560,del,NA19835,0,,4748
7,106268866,106269634,del,NA19116,0,,768
7,40154717,40157596,del,HG00589,0,,2879
7,10834751,10834879,del,NA19328,0,,128
7,42246863,42250390,del,NA20796,0,,3527
7,101081260,101082225,del,HG00271,0,,965
7,682325,683314,del,NA11918,0,,989
7,75664293,75667807,del,HG00245,0,,3514
7,73834930,73838347,del,NA18574,0,,3417
7,62016030,62022326,del,HG00584,0,,6296
7,150718948,150719475,del,NA20543,0,,527
7,62150175,62162863,del,HG01390,0,,12688
7,50019316,50022222,del,HG00250,0,,2906
7,140181729,140190289,del,NA19375,0,,8560
7,55742102,56490610,del,NA19785,0,,748508
7,91333210,91334081,del,NA19381,0,,871
7,73329250,73331249,del,NA20508,0,,1999
7,52204628,52204734,del,NA19466,0,,106
7,16437865,16437993,del,NA11992,0,,128
7,74378516,74480322,del,HG00559,0,,101806
7,136834449,136834751,del,HG01351,0,,302
7,67345838,67353049,del,NA19313,0,,7211
7,156324632,156335515,del,NA19463,0,,10883
7,132457279,132457549,del,NA18637,0,,270
7,136524502,136539275,del,NA19072,0,,14773
7,63586589,63587743,del,NA18941,0,,1154
7,76151330,76669325,del,HG00542,0,,517995
7,152082435,152082910,del,NA19108,0,,475
7,141760227,141786552,del,NA19225,0,,26325
7,147355064,147355378,del,NA19685,0,,314
7,122460586,122460912,del,HG01133,0,,326
7,155179573,155179716,del,NA19138,0,,143
7,110148369,110152311,del,NA20812,0,,3942
7,150295375,150296180,del,NA19916,0,,805
7,137787560,137789929,del,NA19921,0,,2369
7,113236993,113240540,del,NA19056,0,,3547
7,33046864,33048096,del,NA19648,0,,1232
7,61969320,61974058,del,HG00583,0,,4738
7,9191928,9193842,del,NA19376,0,,1914
7,21709250,21717329,del,NA19713,0,,8079
7,158041240,158041357,del,HG00275,0,,117
7,134310482,134312183,del,NA19238,0,,1701
7,6078075,6081584,del,NA19756,0,,3509
7,67045463,67046651,del,HG00346,0,,1188
7,55745526,56494027,del,HG00282,0,,748501
7,111150717,111200713,del,HG00186,0,,49996
7,27948702,27948918,del,NA11829,0,,216
7,158104712,158104991,del,HG00146,0,,279
7,128552688,128553627,del,NA20589,0,,939
7,72809535,72811740,del,HG00111,0,,2205
7,43220848,43221424,del,NA19713,0,,576
7,126915973,126920085,del,HG00418,0,,4112
7,112866138,112869366,del,NA19404,0,,3228
7,121681358,121681554,del,HG01051,0,,196
7,69967846,69969444,del,NA20769,0,,1598
7,4972269,4973276,del,NA18867,0,,1007
7,28574339,28575182,del,HG01190,0,,843
7,152598290,152617850,del,HG00671,0,,19560
7,29415326,29417054,del,HG01488,0,,1728
7,100327716,100342522,del,HG00272,0,,14806
7,119374537,119386614,del,NA19440,0,,12077
7,116594118,116598066,del,NA20757,0,,3948
7,28470988,28476244,del,HG00737,0,,5256
7,157272721,157272958,del,NA19788,0,,237
7,16247638,16330912,del,NA18621,0,,83274
7,93849587,93849792,del,NA19380,0,,205
7,131774463,131780776,del,HG00125,0,,6313
7,111035790,111043110,del,NA18948,0,,7320
7,9366309,9368508,del,NA20512,0,,2199
7,57721416,57721772,del,HG00328,0,,356
7,206515,207187,del,NA18544,0,,672
7,142476316,142486722,del,NA11918,0,,10406
7,109296838,109297408,del,NA18609,0,,570
7,24134110,24155470,del,HG00672,0,,21360
7,48340813,48341388,del,HG00343,0,,575
7,140231374,140231838,del,NA19904,0,,464
7,129786465,129787019,del,NA19399,0,,554
7,47283606,47290341,del,NA19371,0,,6735
7,147011497,147012595,del,NA20813,0,,1098
7,138362604,138376335,del,HG00590,0,,13731
7,61788089,61789995,del,NA19818,0,,1906
7,8118941,8120402,del,NA19452,0,,1461
7,93004711,93007351,del,NA19371,0,,2640
7,80614945,80620915,del,NA19440,0,,5970
7,156137848,156138103,del,NA18980,0,,255
7,151316,159622,del,HG00473,0,,8306
7,119762584,119764810,del,NA19076,0,,2226
7,7096518,7102285,del,NA20753,0,,5767
7,154266170,154267553,del,NA19350,0,,1383
7,96543282,96546681,del,HG00327,0,,3399
7,35721682,35724968,del,NA20805,0,,3286
7,110542683,110543009,del,HG00560,0,,326
7,15154309,15159212,del,HG01461,0,,4903
7,125097406,125097673,del,NA18870,0,,267
7,103266119,103268121,del,NA20534,0,,2002
7,144770355,144775177,del,NA12045,0,,4822
7,67059995,67060219,del,NA19360,0,,224
7,135248060,135249591,del,NA19350,0,,1531
7,144916881,144921398,del,NA12829,0,,4517
7,46829820,46832391,del,NA19440,0,,2571
7,105703605,105706615,del,HG00284,0,,3010
7,107037864,107038048,del,HG00543,0,,184
7,26222039,26222682,del,HG00543,0,,643
7,2428671,2428963,del,NA19703,0,,292
7,100198816,100203022,del,HG00419,0,,4206
7,88953438,88954107,del,NA19093,0,,669
7,55971770,55972134,del,NA19347,0,,364
7,135741440,135742196,del,HG01060,0,,756
7,85357152,85361291,del,NA19439,0,,4139
7,155221301,155224077,del,NA19461,0,,2776
7,101382512,101384035,del,NA18908,0,,1523
7,63523878,63790017,del,HG01462,0,,266139
7,1837449,1839106,del,NA18565,0,,1657
7,23242450,23243850,del,NA20531,0,,1400
7,13022101,13028550,del,NA20516,0,,6449
7,41420412,41423280,del,NA19435,0,,2868
7,159049499,159059524,del,NA19379,0,,10025
7,120021975,120023605,del,HG00353,0,,1630
7,153759211,153759897,del,HG01066,0,,686
7,44390944,44392328,del,NA19437,0,,1384
7,19719088,19721587,del,NA19456,0,,2499
7,38389066,38397422,del,NA19347,0,,8356
7,104440088,104441738,del,HG01198,0,,1650
7,156634614,156635131,del,HG00186,0,,517
7,1704116,1707722,del,NA19439,0,,3606
7,96116378,96117395,del,NA11829,0,,1017
7,62183208,62184076,del,NA19661,0,,868
7,75381919,75384477,del,NA19375,0,,2558
7,26137001,26145495,del,HG01097,0,,8494
7,1110398,1110570,del,NA19703,0,,172
7,55134951,55135857,del,NA18520,0,,906
7,7048150,7053958,del,NA19444,0,,5808
7,153502894,153506452,del,NA19917,0,,3558
7,158580662,158588242,del,NA18498,0,,7580
7,71757000,71757820,del,NA19901,0,,820
7,56891426,56893789,del,NA20342,0,,2363
7,98052506,98053029,del,HG00442,0,,523
7,12003306,12010573,del,NA19431,0,,7267
7,133786766,133797972,del,NA18947,0,,11206
7,137881664,137883395,del,NA18595,0,,1731
7,94997985,95003818,del,NA18538,0,,5833
7,3057421,3057781,del,NA20322,0,,360
7,19463330,19471729,del,HG01052,0,,8399
7,86937460,86949100,del,HG01051,0,,11640
7,141765410,141794442,del,HG01098,0,,29032
7,37693409,37705068,del,NA19359,0,,11659
7,50993028,51000952,del,NA19449,0,,7924
7,66644847,66645412,del,NA19317,0,,565
7,79471617,79481674,del,NA19921,0,,10057
7,110502,110600,del,NA12003,0,,98
7,1944716,1944872,del,NA19725,0,,156
7,78434207,78437197,del,NA20752,0,,2990
7,18798838,18801200,del,NA19012,0,,2362
7,15885449,15885866,del,HG01384,0,,417
7,17160891,17161070,del,HG00671,0,,179
7,61055242,61740992,del,NA20504,0,,685750
7,109514779,109516405,del,HG00684,0,,1626
7,53267356,53267716,del,NA18523,0,,360
7,113715930,113717959,del,NA19453,0,,2029
7,57546090,57552095,del,HG00705,0,,6005
7,65186346,65188042,del,NA19777,0,,1696
7,52520171,52520373,del,HG00368,0,,202
7,1346007,1346187,del,HG00443,0,,180
7,80016355,80017750,del,HG00261,0,,1395
7,158574253,158575086,del,HG01187,0,,833
7,98791804,98797916,del,NA18940,0,,6112
7,100499511,100501922,del,HG00258,0,,2411
7,151671198,151671374,del,NA19789,0,,176
7,157118794,157120624,del,NA19334,0,,1830
7,4317236,4318779,del,NA19065,0,,1543
7,22254621,22255465,del,NA20517,0,,844
7,73784189,73784485,del,HG01390,0,,296
7,151526533,151528247,del,NA20816,0,,1714
7,73577509,73581064,del,HG01073,0,,3555
7,137995515,137996418,del,HG00249,0,,903
7,873971,875209,del,NA19130,0,,1238
7,104608618,104609517,del,NA18635,0,,899
7,712146,713234,del,NA18517,0,,1088
7,124105521,124109152,del,HG01133,0,,3631
7,37726132,37729514,del,NA19901,0,,3382
7,6605044,6605803,del,NA19398,0,,759
7,46113683,46115524,del,HG00472,0,,1841
7,118851277,119033013,del,HG00250,0,,181736
7,25057444,25059853,del,NA19172,0,,2409
7,101002416,101006022,del,NA19346,0,,3606
7,118027495,118037859,del,NA19437,0,,10364
7,65930194,65941953,del,HG00672,0,,11759
7,10788264,10802458,del,HG00125,0,,14194
7,16439218,16439506,del,NA18989,0,,288
7,110821148,110865627,del,HG01491,0,,44479
7,17277305,17277736,del,NA11994,0,,431
7,102351566,102367905,del,NA19213,0,,16339
7,106175064,106175463,del,HG01375,0,,399
7,91358471,91360401,del,NA19385,0,,1930
7,55780852,55785693,del,HG00620,0,,4841
7,5187611,5189422,del,NA20336,0,,1811
7,395898,396054,del,HG00252,0,,156
7,27514335,27514610,del,NA18511,0,,275
7,85079071,85104843,del,HG01198,0,,25772
7,156387077,156394319,del,NA18636,0,,7242
7,88142207,88154443,del,HG00252,0,,12236
7,137455271,137455578,del,HG00684,0,,307
7,98862344,98876461,del,HG00537,0,,14117
7,62965416,62979022,del,HG00698,0,,13606
7,61788274,61789978,del,NA18523,0,,1704
7,110311759,110312583,del,NA19063,0,,824
7,9548565,9575717,del,HG00276,0,,27152
7,155919286,155919733,del,NA19773,0,,447
7,77306302,77316356,del,HG00698,0,,10054
7,51408351,51408515,del,NA18982,0,,164
7,66338276,66356689,del,NA12777,0,,18413
7,154962521,154965326,del,NA19448,0,,2805
7,130800802,130801928,del,NA19324,0,,1126
7,109514904,109516404,del,HG00684,0,,1500
7,149282486,149306145,del,HG00353,0,,23659
7,61745032,61781742,del,NA20515,0,,36710
7,10052773,10095036,del,HG00596,0,,42263
7,132245997,132246930,del,NA19682,0,,933
7,156298576,156313825,del,HG01048,0,,15249
7,145228823,145229313,del,HG00257,0,,490
7,37786603,37789554,del,NA18853,0,,2951
7,157951212,157951830,del,NA18961,0,,618
7,13278111,13280714,del,NA19172,0,,2603
7,306069,306146,del,HG00583,0,,77
7,28816983,28819637,del,NA07051,0,,2654
7,39546362,39551851,del,HG01488,0,,5489
7,119142528,119145773,del,HG00133,0,,3245
7,30024274,30024750,del,NA19704,0,,476
7,4233922,4234084,del,HG01366,0,,162
7,3209134,3209642,del,HG00448,0,,508
7,48653106,48654861,del,HG00740,0,,1755
7,47716106,47719049,del,NA19663,0,,2943
7,99130166,99131240,del,HG00557,0,,1074
7,97655466,97657422,del,NA18959,0,,1956
7,133679069,133684009,del,HG00158,0,,4940
7,158233551,158234176,del,NA19783,0,,625
7,52107107,52107424,del,NA18624,0,,317
7,52171112,52397355,del,NA19463,0,,226243
7,64677153,65187617,del,HG01375,0,,510464
7,3374468,3417662,del,HG00614,0,,43194
7,61665938,61839403,del,NA19734,0,,173465
7,1927345,1928067,del,NA20281,0,,722
7,62059128,62061768,del,NA19190,0,,2640
7,57165255,57173490,del,HG00282,0,,8235
7,7291602,7325268,del,NA11830,0,,33666
7,42319207,42325063,del,NA19682,0,,5856
7,6113727,6115546,del,NA18988,0,,1819
7,71686843,71690056,del,NA18953,0,,3213
7,15413764,15418465,del,NA18502,0,,4701
7,70421216,70426022,del,HG01112,0,,4806
7,70958464,70959771,del,NA20819,0,,1307
7,158052501,158052659,del,HG00449,0,,158
7,129224006,129224650,del,NA18861,0,,644
7,11229265,11229729,del,HG00534,0,,464
7,150719005,150719492,del,NA18502,0,,487
7,68129065,68129198,del,NA19758,0,,133
7,96789401,96792860,del,HG00479,0,,3459
7,111683497,111684131,del,NA19077,0,,634
7,7106853,7108429,del,NA19381,0,,1576
7,64413376,64414034,del,HG00337,0,,658
7,52192847,52192979,del,NA19005,0,,132
7,103731499,103746600,del,HG00737,0,,15101
7,73828495,73831357,del,NA18486,0,,2862
7,62027506,62033499,del,NA20520,0,,5993
7,144556507,144556763,del,NA18910,0,,256
7,148072863,148076323,del,HG01253,0,,3460
7,1076337,1079823,del,NA19463,0,,3486
7,16237132,16238349,del,NA19063,0,,1217
7,142357976,142360306,del,NA19439,0,,2330
7,134709565,134713163,del,NA19004,0,,3598
7,12281703,12282025,del,NA18976,0,,322
7,154172752,154175041,del,NA20589,0,,2289
7,56282874,56287051,del,NA18499,0,,4177
7,66755336,66756600,del,NA19819,0,,1264
7,55388799,55392238,del,HG00589,0,,3439
7,57255956,57258213,del,NA19916,0,,2257
7,119857648,119864360,del,HG00242,0,,6712
7,47089791,47092766,del,NA12283,0,,2975
7,37693450,37705126,del,NA19359,0,,11676
7,67862260,67863100,del,HG00684,0,,840
7,80607965,80610471,del,NA19382,0,,2506
7,22663658,22669964,del,NA19130,0,,6306
7,20707274,20709366,del,NA18634,0,,2092
7,32390165,32393247,del,NA18983,0,,3082
7,119728625,119731087,del,NA19700,0,,2462
7,8546596,8547121,del,NA19374,0,,525
7,155595316,155608622,del,HG00543,0,,13306
7,100676804,100682285,del,NA18623,0,,5481
7,56814937,56826379,del,HG00249,0,,11442
7,113110168,113110932,del,NA19834,0,,764
7,133011766,133014255,del,NA19379,0,,2489
7,24469842,24472733,del,HG00583,0,,2891
7,66397589,66397934,del,HG01456,0,,345
7,64544522,65238652,del,HG00592,0,,694130
7,146268875,146269994,del,NA18964,0,,1119
7,66924598,66924719,del,HG01052,0,,121
7,54484610,54485501,del,NA18624,0,,891
7,139322757,139324415,del,NA18961,0,,1658
7,119155616,119164422,del,NA19317,0,,8806
7,61055741,61744581,del,HG00403,0,,688840
7,133542754,133549295,del,NA19678,0,,6541
7,34553564,34563251,del,NA18615,0,,9687
7,52275049,52275640,del,NA18498,0,,591
7,4384782,4386077,del,NA12400,0,,1295
7,152229573,152230499,del,HG01080,0,,926
7,2417227,2417761,del,NA19439,0,,534
7,149862840,149881960,del,NA19701,0,,19120
7,119952377,119953666,del,HG01489,0,,1289
7,149816,159622,del,NA18975,0,,9806
7,141764743,141793753,del,HG01105,0,,29010
7,26178566,26179369,del,NA19429,0,,803
7,110872038,110963859,del,HG00473,0,,91821
7,104990326,104990719,del,NA12748,0,,393
7,11640798,11642843,del,HG01440,0,,2045
7,100024216,100028422,del,HG00404,0,,4206
7,100682588,100684240,del,HG01137,0,,1652
7,23410444,23411813,del,NA19704,0,,1369
7,127303539,127305319,del,HG00327,0,,1780
7,120310808,120313100,del,HG00543,0,,2292
7,101110590,101110939,del,HG00273,0,,349
7,152419399,152419715,del,NA18565,0,,316
7,5936562,5951173,del,HG00534,0,,14611
7,20748784,20753577,del,NA20341,0,,4793
7,75664630,75667807,del,HG00346,0,,3177
7,67198291,67207006,del,HG01375,0,,8715
7,95862840,95866067,del,NA19707,0,,3227
7,8826497,8866251,del,HG01149,0,,39754
7,107464067,107464739,del,NA12830,0,,672
7,133785000,133798329,del,NA18622,0,,13329
7,151607061,151612020,del,NA20802,0,,4959
7,157719821,157720266,del,NA12827,0,,445
7,122855468,122862045,del,NA19225,0,,6577
7,136073024,136073337,del,NA19700,0,,313
7,16348903,16402199,del,HG00543,0,,53296
7,115498976,115503856,del,NA19002,0,,4880
7,21836904,21837195,del,NA19712,0,,291
7,157375376,157376252,del,HG01334,0,,876
7,158521666,158522772,del,HG00656,0,,1106
7,40293872,40295381,del,HG00284,0,,1509
7,118144710,118154927,del,NA19312,0,,10217
7,148633316,148642022,del,NA20778,0,,8706
7,12778090,12780932,del,NA19449,0,,2842
7,76260788,76263805,del,NA20518,0,,3017
7,149732256,149733047,del,NA19396,0,,791
7,71821203,71823471,del,NA19383,0,,2268
7,65279747,65860269,del,HG00707,0,,580522
7,84215047,84227067,del,HG00262,0,,12020
7,100327572,100340716,del,NA19395,0,,13144
7,21709416,21717268,del,NA19713,0,,7852
7,62305461,62306984,del,NA19661,0,,1523
7,56493688,56496872,del,NA19434,0,,3184
7,1944155,1944961,del,HG00330,0,,806
7,17554711,17570008,del,NA11918,0,,15297
7,150299716,150306672,del,HG01190,0,,6956
7,57063016,57088822,del,HG01351,0,,25806
7,149688980,149689087,del,NA18613,0,,107
7,106846551,106858283,del,HG00683,0,,11732
7,82860537,82917820,del,HG00345,0,,57283
7,44961616,44962622,del,HG01079,0,,1006
7,125102423,125102833,del,HG00284,0,,410
7,63482833,63739364,del,HG01061,0,,256531
7,46365916,46366622,del,HG00315,0,,706
7,99203012,99203174,del,HG00634,0,,162
7,91254618,91260293,del,NA19138,0,,5675
7,64545265,65239353,del,HG01051,0,,694088
7,62016021,62022335,del,NA19057,0,,6314
7,101724546,101728038,del,HG01190,0,,3492
7,63935804,63936788,del,NA12283,0,,984
7,85803965,85863314,del,HG00592,0,,59349
7,23262193,23263638,del,NA19373,0,,1445
7,4809238,4851268,del,NA19711,0,,42030
7,149732967,149734587,del,NA12413,0,,1620
7,100682570,100683996,del,HG00331,0,,1426
7,31712920,31715977,del,NA19471,0,,3057
7,70013047,70013830,del,NA19085,0,,783
7,5293957,5294546,del,HG00578,0,,589
7,14111715,14111847,del,NA19404,0,,132
7,43379821,43384082,del,NA19463,0,,4261
7,33093690,33094653,del,HG01250,0,,963
7,97395282,97402639,del,HG00325,0,,7357
7,111065331,111067260,del,HG00338,0,,1929
7,84969028,84973163,del,NA19473,0,,4135
7,2354959,2355810,del,NA20810,0,,851
7,140193267,140202505,del,NA19920,0,,9238
7,100270916,100273922,del,NA20816,0,,3006
7,157222682,157223386,del,NA19396,0,,704
7,153932550,153932634,del,NA19114,0,,84
7,119372910,119377618,del,HG01134,0,,4708
7,55286743,55289061,del,NA12828,0,,2318
7,125019273,125019551,del,NA20332,0,,278
7,4256242,4259555,del,NA20813,0,,3313
7,76754254,76761144,del,NA19982,0,,6890
7,156153780,156153982,del,NA11919,0,,202
7,18691198,18692187,del,HG01350,0,,989
7,12356140,12356351,del,HG01108,0,,211
7,57459520,57464283,del,NA19904,0,,4763
7,156948655,156950296,del,NA19982,0,,1641
7,50044054,50049012,del,HG01462,0,,4958
7,32774944,32777680,del,NA19717,0,,2736
7,22142948,22544853,del,HG00689,0,,401905
7,10504616,10506322,del,HG00533,0,,1706
7,108349702,108354188,del,NA18541,0,,4486
7,52963199,52964911,del,NA19777,0,,1712
7,9685460,9767515,del,HG00475,0,,82055
7,43624878,43632077,del,NA12400,0,,7199
7,134833857,134841089,del,NA18633,0,,7232
7,53279691,53285722,del,NA12155,0,,6031
7,32168927,32169172,del,NA19920,0,,245
7,5770989,5771545,del,NA19395,0,,556
7,113652641,113659265,del,HG01072,0,,6624
7,89810407,89812599,del,NA20774,0,,2192
7,132273014,132273566,del,NA18537,0,,552
7,5640531,5640666,del,NA18622,0,,135
7,6785466,6788722,del,NA19347,0,,3256
7,138135186,138137594,del,NA19676,0,,2408
7,1885063,1885197,del,NA19138,0,,134
7,138597909,138598744,del,NA19783,0,,835
7,119555580,119625809,del,NA20786,0,,70229
7,25800774,25804354,del,HG00501,0,,3580
7,100499499,100502285,del,HG00258,0,,2786
7,9790993,9793393,del,HG00361,0,,2400
7,12744387,12750049,del,HG01440,0,,5662
7,24038161,24040070,del,NA19771,0,,1909
7,24152173,24154297,del,NA18505,0,,2124
7,62090125,62095095,del,NA11994,0,,4970
7,61529983,61535883,del,HG00653,0,,5900
7,112512991,112520706,del,NA18597,0,,7715
7,137989401,137990700,del,HG01140,0,,1299
7,64677387,64679300,del,HG01350,0,,1913
7,88031133,88031355,del,NA18536,0,,222
7,135527421,135528322,del,HG00319,0,,901
7,142476816,142486922,del,HG01136,0,,10106
7,91031083,91042584,del,HG00449,0,,11501
7,451230,451888,del,NA19116,0,,658
7,155221415,155224195,del,NA19461,0,,2780
7,135362885,135364648,del,NA19914,0,,1763
7,73573594,73575726,del,NA19455,0,,2132
7,16699923,16702238,del,HG00158,0,,2315
7,14251161,14251990,del,HG00537,0,,829
7,78357840,78358180,del,NA18976,0,,340
7,109403043,109404669,del,HG00557,0,,1626
7,151300206,151300686,del,NA18856,0,,480
7,45587932,45589328,del,NA19374,0,,1396
7,15168876,15168937,del,NA18577,0,,61
7,61753798,61789774,del,HG00345,0,,35976
7,5061275,5066799,del,HG00614,0,,5524
7,51414014,51414844,del,NA18871,0,,830
7,54596486,54597433,del,NA20544,0,,947
7,38388466,38394922,del,HG01495,0,,6456
7,142475902,142486440,del,NA19072,0,,10538
7,9399334,9400763,del,NA11918,0,,1429
7,38391916,38397322,del,NA20522,0,,5406
7,92227347,92228400,del,NA20341,0,,1053
7,66100850,66137599,del,NA19722,0,,36749
7,111048185,111083424,del,NA19374,0,,35239
7,121766909,121776281,del,HG00236,0,,9372
7,28214300,28214664,del,HG01354,0,,364
7,157918776,157919386,del,NA18489,0,,610
7,129681963,129685657,del,NA18637,0,,3694
7,158112588,158112862,del,NA18534,0,,274
7,97393618,97418795,del,NA19676,0,,25177
7,30478848,30484914,del,NA19102,0,,6066
7,382809,384064,del,NA12399,0,,1255
7,146133765,146139529,del,NA19382,0,,5764
7,67217490,67222998,del,NA19376,0,,5508
7,47219078,47219174,del,HG00708,0,,96
7,154467978,154468199,del,HG00442,0,,221
7,158810905,158811324,del,HG00684,0,,419
7,146116494,146118079,del,HG00475,0,,1585
7,48041732,48042054,del,NA19900,0,,322
7,152613138,152617703,del,HG00281,0,,4565
7,37216843,37217257,del,NA18621,0,,414
7,3135250,3138111,del,NA19435,0,,2861
7,109436689,109453901,del,HG01107,0,,17212
7,142476466,142483922,del,HG01516,0,,7456
7,109162535,109164018,del,NA19372,0,,1483
7,152023775,152026419,del,NA19625,0,,2644
7,38384216,38397222,del,HG01516,0,,13006
7,93416927,93422991,del,NA19204,0,,6064
7,79471816,79480422,del,NA19982,0,,8606
7,75668010,75668660,del,NA19312,0,,650
7,40051811,40063678,del,NA18907,0,,11867
7,153754353,153755076,del,HG01082,0,,723
7,66697485,66699291,del,NA19381,0,,1806
7,118796324,118802464,del,NA19452,0,,6140
7,87308333,87311102,del,NA18940,0,,2769
7,141765351,141794383,del,NA18534,0,,29032
7,105307850,105308165,del,NA18637,0,,315
7,57879422,57881803,del,NA19138,0,,2381
7,9798419,9798521,del,NA12546,0,,102
7,121059294,121084688,del,NA18624,0,,25394
7,150125726,150128664,del,HG00236,0,,2938
7,30155245,30155372,del,NA18973,0,,127
7,39546516,39553872,del,HG01497,0,,7356
7,148770616,148776722,del,HG00525,0,,6106
7,141760332,141786657,del,NA19701,0,,26325
7,60024,63692,del,NA18541,0,,3668
7,119652184,119662445,del,NA19313,0,,10261
7,61744224,61784791,del,NA18542,0,,40567
7,77725432,77726692,del,NA20819,0,,1260
7,109768234,109771941,del,NA18501,0,,3707
7,93082435,93087299,del,NA19676,0,,4864
7,145148147,145158487,del,NA12383,0,,10340
7,37700165,37701568,del,NA19235,0,,1403
7,3720963,3723137,del,NA20787,0,,2174
7,65490351,65490778,del,NA19147,0,,427
7,152188986,152192361,del,NA20344,0,,3375
7,76145016,76163722,del,HG00181,0,,18706
7,120304087,120314419,del,HG00309,0,,10332
7,141278225,141284192,del,HG00312,0,,5967
7,148730436,148731450,del,HG00111,0,,1014
7,34342543,34346274,del,NA19338,0,,3731
7,1856043,1863576,del,HG01374,0,,7533
7,104464668,104476477,del,NA19703,0,,11809
7,24097148,24114942,del,NA19390,0,,17794
7,11331664,11339392,del,NA18856,0,,7728
7,117940299,117941203,del,HG00437,0,,904
7,43893536,43895918,del,NA18549,0,,2382
7,60155,60345,del,NA18547,0,,190
7,142012406,142044733,del,NA19449,0,,32327
7,24591407,24592787,del,NA18633,0,,1380
7,41438228,41443045,del,NA18984,0,,4817
7,72257068,72262080,del,NA19444,0,,5012
7,47103651,47104478,del,NA19900,0,,827
7,21408388,21410362,del,NA19374,0,,1974
7,134223331,134262100,del,HG00359,0,,38769
7,19534471,19534671,del,HG00335,0,,200
7,67041834,67045225,del,NA19056,0,,3391
7,101021900,101023477,del,NA19909,0,,1577
7,127766414,127766728,del,NA20505,0,,314
7,71232422,71239438,del,NA20589,0,,7016
7,5111315,5111781,del,NA18873,0,,466
7,124299976,124299997,del,HG01366,0,,21
7,131373094,131373957,del,HG00331,0,,863
7,94711696,94721237,del,NA19916,0,,9541
7,110869678,111023757,del,HG01072,0,,154079
7,99648693,99652354,del,HG01125,0,,3661
7,68396107,68398364,del,HG00692,0,,2257
7,100636345,100643191,del,HG00180,0,,6846
7,13049591,13050718,del,HG00369,0,,1127
7,17499682,17501428,del,NA18567,0,,1746
7,155848568,155851130,del,NA19093,0,,2562
7,157734651,157734920,del,NA19238,0,,269
7,54520720,54523626,del,HG00141,0,,2906
7,21813855,21814118,del,NA18571,0,,263
7,22473027,22473077,del,HG01048,0,,50
7,79948922,79949782,del,NA19360,0,,860
7,103772192,103774777,del,NA18508,0,,2585
7,75357948,75366146,del,NA20813,0,,8198
7,112329428,112330377,del,NA19625,0,,949
7,151590795,151599785,del,HG00530,0,,8990
7,88585940,88596071,del,HG00275,0,,10131
7,114449376,114449611,del,NA19093,0,,235
7,153919478,153921965,del,NA12043,0,,2487
7,124634581,124637722,del,HG01075,0,,3141
7,752811,753003,del,NA19172,0,,192
7,158233799,158233882,del,HG00251,0,,83
7,73808132,73809046,del,HG01136,0,,914
7,47089586,47092690,del,HG00262,0,,3104
7,146883956,146884169,del,HG00183,0,,213
7,158574831,158575096,del,NA18874,0,,265
7,4416558,4420221,del,NA19467,0,,3663
7,98971177,98971219,del,NA19443,0,,42
7,149707676,149711438,del,NA18553,0,,3762
7,137528562,137530932,del,NA20808,0,,2370
7,52425584,52428065,del,NA12283,0,,2481
7,43105867,43107783,del,NA20518,0,,1916
7,76083846,76581905,del,NA12058,0,,498059
7,105389552,105391076,del,NA19685,0,,1524
7,58000017,58009831,del,NA19473,0,,9814
7,132246823,132247685,del,NA19901,0,,862
7,86314982,86319829,del,HG01055,0,,4847
7,129231006,129231914,del,NA19360,0,,908
7,93169987,93170104,del,HG00556,0,,117
7,72831553,72833141,del,HG00247,0,,1588
7,101059157,101060266,del,NA18592,0,,1109
7,95364637,95369119,del,NA19373,0,,4482
7,36212944,36219103,del,HG00442,0,,6159
7,25477996,25478310,del,NA19394,0,,314
7,23491232,23492291,del,HG00179,0,,1059
7,141765556,141794588,del,NA12829,0,,29032
7,157694393,157694609,del,NA18619,0,,216
7,33702942,33703035,del,NA18559,0,,93
7,152292243,152297190,del,NA19129,0,,4947
7,142475629,142486205,del,NA18549,0,,10576
7,153299221,153307279,del,NA18543,0,,8058
7,9021036,9021637,del,NA19346,0,,601
7,38389716,38397422,del,NA20291,0,,7706
7,154392073,154399939,del,HG00654,0,,7866
7,97976569,97977080,del,HG00634,0,,511
7,158894751,158894879,del,HG00375,0,,128
7,148607377,148634868,del,HG01516,0,,27491
7,4938344,4939705,del,HG00536,0,,1361
7,121322958,121329352,del,HG00734,0,,6394
7,12841604,12844578,del,HG00249,0,,2974
7,2888265,2890606,del,NA11920,0,,2341
7,349075,349079,del,NA19391,0,,4
7,75391019,75393982,del,NA18595,0,,2963
7,4317305,4318841,del,NA19076,0,,1536
7,154885247,154889495,del,NA19189,0,,4248
7,76804372,76805860,del,NA18933,0,,1488
7,149388393,149390910,del,NA19350,0,,2517
7,213062,213392,del,HG00278,0,,330
7,69960583,69961434,del,HG01550,0,,851
7,126891616,126893722,del,HG00403,0,,2106
7,1795469,1795778,del,NA18563,0,,309
7,1704216,1710822,del,HG01073,0,,6606
7,136996515,136996747,del,NA19371,0,,232
7,6376999,6377681,del,NA19398,0,,682
7,11875804,11878591,del,NA18631,0,,2787
7,119153884,119162545,del,NA19390,0,,8661
7,13585645,13591240,del,NA20754,0,,5595
7,79207671,79208507,del,NA19474,0,,836
7,53702933,53703102,del,HG01389,0,,169
7,5883964,5884584,del,NA18870,0,,620
7,20749716,20752022,del,HG00560,0,,2306
7,93417216,93425122,del,HG00261,0,,7906
7,115953677,115955222,del,NA06986,0,,1545
7,135189199,135189533,del,NA19384,0,,334
7,152574767,152580418,del,NA19456,0,,5651
7,56834970,56835102,del,HG01437,0,,132
7,106068449,106071151,del,NA19904,0,,2702
7,145063221,145063384,del,NA12749,0,,163
7,3654446,3655536,del,NA12046,0,,1090
7,89072642,89815075,del,HG00150,0,,742433
7,15277714,15280522,del,NA19713,0,,2808
7,44600172,44600320,del,NA19374,0,,148
7,49552065,49552383,del,HG00436,0,,318
7,134542098,134543344,del,NA19474,0,,1246
7,158020595,158022699,del,NA20801,0,,2104
7,55409861,55410106,del,NA18504,0,,245
7,53198099,53206354,del,NA19654,0,,8255
7,5881856,5887797,del,NA12761,0,,5941
7,20270796,20278156,del,HG00156,0,,7360
7,3303993,3304234,del,NA20759,0,,241
7,66188705,66188804,del,HG00739,0,,99
7,149732260,149732669,del,NA18501,0,,409
7,9057169,9057550,del,NA18861,0,,381
7,64828137,64829502,del,NA19093,0,,1365
7,28574297,28575146,del,NA19062,0,,849
7,61796236,61796408,del,HG00276,0,,172
7,66786078,66792882,del,HG00442,0,,6804
7,156582546,156583502,del,NA19236,0,,956
7,71068843,71069020,del,HG00335,0,,177
7,80602260,80602868,del,NA19818,0,,608
7,63148352,63149617,del,HG01124,0,,1265
7,34895752,34913775,del,NA18510,0,,18023
7,57239267,57262500,del,NA19835,0,,23233
7,96919211,96919526,del,NA19114,0,,315
7,155930694,155931308,del,NA20766,0,,614
7,17553398,17571246,del,NA20509,0,,17848
7,119077566,119082529,del,NA19236,0,,4963
7,148776932,148810880,del,HG00280,0,,33948
7,18826093,18826427,del,NA19257,0,,334
7,132836178,132836348,del,NA20790,0,,170
7,4629916,4640622,del,HG00151,0,,10706
7,150484366,150485814,del,NA19472,0,,1448
7,100963832,100972084,del,HG00614,0,,8252
7,6742130,6742547,del,NA18565,0,,417
7,153745616,153750622,del,HG00174,0,,5006
7,75455038,75456334,del,NA18553,0,,1296
7,62512944,62514186,del,HG00684,0,,1242
7,76041385,76047734,del,HG00251,0,,6349
7,149863566,149880922,del,NA20127,0,,17356
7,94637737,94642615,del,NA19466,0,,4878
7,96543282,96546598,del,HG00231,0,,3316
7,136936338,136937660,del,NA19239,0,,1322
7,159065030,159077127,del,NA19394,0,,12097
7,56761980,56769947,del,HG00345,0,,7967
7,100680261,100680438,del,NA18555,0,,177
7,73981930,73983378,del,NA07048,0,,1448
7,120850673,120854240,del,NA18596,0,,3567
7,157939660,157940337,del,NA12749,0,,677
7,107173442,107176018,del,NA18933,0,,2576
7,40088194,40088701,del,NA19374,0,,507
7,158708343,158710304,del,NA19056,0,,1961
7,12553345,12554551,del,NA18571,0,,1206
7,152017494,152022394,del,HG00179,0,,4900
7,76607174,76607454,del,NA19084,0,,280
7,100939664,100939978,del,NA19701,0,,314
7,97395282,97402661,del,HG00372,0,,7379
7,148670105,148676765,del,NA20818,0,,6660
7,38976746,38977701,del,NA18867,0,,955
7,22068869,22068892,del,HG00182,0,,23
7,82126295,82131464,del,NA19347,0,,5169
7,55676883,55677788,del,NA11893,0,,905
7,92543328,92555115,del,HG00657,0,,11787
7,118590977,118599043,del,HG01051,0,,8066
7,10444511,10444929,del,HG01188,0,,418
7,123704962,123716844,del,NA19472,0,,11882
7,118677308,118679549,del,HG00123,0,,2241
7,125235727,125238831,del,NA19332,0,,3104
7,66126157,66127097,del,HG01133,0,,940
7,85277177,85290658,del,HG00123,0,,13481
7,12277315,12284160,del,NA19066,0,,6845
7,155610385,155615240,del,NA19404,0,,4855
7,8463548,8465541,del,NA10847,0,,1993
7,144798344,144799061,del,HG00684,0,,717
7,157939716,157940094,del,NA19376,0,,378
7,15102052,15104277,del,NA12778,0,,2225
7,66902564,66902767,del,NA19818,0,,203
7,138869538,138870911,del,NA19359,0,,1373
7,144636621,144642094,del,HG01465,0,,5473
7,56652479,56658515,del,HG00154,0,,6036
7,29688451,29690143,del,NA20513,0,,1692
7,16073558,16074409,del,NA19360,0,,851
7,5583863,5585500,del,HG01079,0,,1637
7,98227766,98231172,del,NA19473,0,,3406
7,110181965,110188432,del,HG00274,0,,6467
7,134210095,134245123,del,NA20533,0,,35028
7,131702923,131704826,del,HG01052,0,,1903
7,119228067,119236059,del,NA19313,0,,7992
7,138107018,138108647,del,NA19360,0,,1629
7,154709785,154713973,del,NA19099,0,,4188
7,57402739,57403352,del,NA19470,0,,613
7,45505543,45507281,del,NA19716,0,,1738
7,65316718,65317187,del,HG00150,0,,469
7,100337915,100340547,del,NA19472,0,,2632
7,50104770,50106074,del,NA12043,0,,1304
7,61148415,61967231,del,NA18582,0,,818816
7,131458237,131460743,del,NA19435,0,,2506
7,133289426,133290219,del,NA19377,0,,793
7,64555329,65249386,del,NA20796,0,,694057
7,109412756,109413978,del,HG01051,0,,1222
7,9754136,9760906,del,HG00183,0,,6770
7,57063916,57086722,del,HG00249,0,,22806
7,56401137,56409585,del,HG00246,0,,8448
7,142259149,142267704,del,NA18545,0,,8555
7,51691895,51692218,del,NA19171,0,,323
7,90022137,90022454,del,HG01101,0,,317
7,62116922,62118899,del,HG01102,0,,1977
7,151230197,151231843,del,NA19371,0,,1646
7,61055788,61746954,del,NA19720,0,,691166
7,64748146,64748521,del,HG00154,0,,375
7,135206501,135218417,del,NA20760,0,,11916
7,99461389,99463562,del,NA19160,0,,2173
7,73549758,73550966,del,NA20809,0,,1208
7,63833135,63833440,del,NA19717,0,,305
7,131335779,131337620,del,NA12058,0,,1841
7,128139573,128639667,del,HG01377,0,,500094
7,15162369,15246663,del,HG00701,0,,84294
7,53322973,53328325,del,NA19819,0,,5352
7,96543516,96546922,del,NA19682,0,,3406
7,128770192,128772324,del,NA12340,0,,2132
7,158233180,158233633,del,NA19385,0,,453
7,152708468,152708845,del,NA19457,0,,377
7,57600632,57610577,del,NA20766,0,,9945
7,78511324,78512729,del,NA19346,0,,1405
7,31590306,31591995,del,HG00246,0,,1689
7,54668973,54669539,del,NA12718,0,,566
7,38388395,38397553,del,HG00187,0,,9158
7,130501944,130505444,del,NA12342,0,,3500
7,111565968,111566703,del,NA18917,0,,735
7,31315716,31320222,del,HG01441,0,,4506
7,70109121,70110600,del,HG00513,0,,1479
7,39387266,39387883,del,NA20513,0,,617
7,93326316,93333822,del,HG00367,0,,7506
7,97952930,97955096,del,NA12413,0,,2166
7,145793330,145799152,del,NA19213,0,,5822
7,146224577,146224982,del,NA19311,0,,405
7,9511555,9530998,del,HG01079,0,,19443
7,157096067,157096893,del,HG01440,0,,826
7,141620465,141626512,del,HG01061,0,,6047
7,33905414,33907730,del,NA18635,0,,2316
7,155120378,155121070,del,HG01551,0,,692
7,126776176,126781414,del,NA19129,0,,5238
7,119443976,119447429,del,HG00543,0,,3453
7,147847173,147851523,del,NA19446,0,,4350
7,23132647,23141455,del,NA19373,0,,8808
7,157196170,157196995,del,NA19719,0,,825
7,100326766,100342872,del,HG00531,0,,16106
7,32222682,32226651,del,NA18990,0,,3969
7,16348922,16402175,del,NA18563,0,,53253
7,151134,160557,del,NA18626,0,,9423
7,148501132,148502722,del,HG00146,0,,1590
7,155054811,155055048,del,NA19376,0,,237
7,2730707,2731296,del,NA19374,0,,589
7,110974893,111286879,del,NA19067,0,,311986
7,100092596,100093721,del,HG01204,0,,1125
7,39190421,39200732,del,NA19921,0,,10311
7,149730534,149732983,del,NA19007,0,,2449
7,120290250,120291387,del,HG01390,0,,1137
7,65563761,65563858,del,NA19360,0,,97
7,107529120,107529239,del,HG00375,0,,119
7,131394335,131396539,del,NA19439,0,,2204
7,51614722,51625618,del,NA18592,0,,10896
7,110960240,110967652,del,NA19065,0,,7412
7,38513006,38513343,del,NA18519,0,,337
7,8230626,8236725,del,NA11995,0,,6099
7,154671056,154671313,del,NA19455,0,,257
7,43607378,43607642,del,NA18517,0,,264
7,26218885,26221303,del,NA18858,0,,2418
7,84841772,84843035,del,NA19701,0,,1263
7,157288238,157298482,del,HG00732,0,,10244
7,64780732,64781004,del,NA19213,0,,272
7,158574557,158574723,del,NA19394,0,,166
7,136152438,136159775,del,NA19347,0,,7337
7,41758612,41759375,del,NA19384,0,,763
7,119395810,119398089,del,NA18951,0,,2279
7,64640549,65151430,del,NA12340,0,,510881
7,138687317,138687479,del,NA18505,0,,162
7,53455191,53466619,del,NA19334,0,,11428
7,6104506,6110251,del,NA20282,0,,5745
7,23139879,23144312,del,NA18868,0,,4433
7,1264467,1264771,del,NA12383,0,,304
7,48391754,48401789,del,NA19189,0,,10035
7,158962843,158963071,del,HG01550,0,,228
7,155056069,155080491,del,HG00156,0,,24422
7,37465624,37468500,del,NA12891,0,,2876
7,151744832,151746193,del,NA19908,0,,1361
7,148638716,148642422,del,HG01083,0,,3706
7,47715996,47718928,del,NA19663,0,,2932
7,65857643,65860104,del,HG00536,0,,2461
7,26939076,26939739,del,HG01069,0,,663
7,158644138,158645355,del,NA06984,0,,1217
7,111356847,111360466,del,HG00372,0,,3619
7,16493167,16493869,del,NA19247,0,,702
7,148438633,148438768,del,HG01440,0,,135
7,53555752,53560897,del,NA19703,0,,5145
7,24359652,24363510,del,NA18508,0,,3858
7,78803914,78854064,del,NA19172,0,,50150
7,139601264,139604187,del,NA19384,0,,2923
7,100327116,100340522,del,NA20589,0,,13406
7,55789403,55793388,del,NA19982,0,,3985
7,86210273,86212266,del,NA19384,0,,1993
7,110391391,110409982,del,NA19655,0,,18591
7,8698628,8698846,del,NA18961,0,,218
7,99878932,99880370,del,NA19788,0,,1438
7,66218944,66219241,del,HG00663,0,,297
7,140693380,140695143,del,HG00732,0,,1763
7,65482993,65485487,del,HG01191,0,,2494
7,114688005,114688161,del,NA18636,0,,156
7,71263927,71264649,del,NA19446,0,,722
7,34927586,34928637,del,HG00536,0,,1051
7,1242052,1242339,del,NA18548,0,,287
7,97145818,97147497,del,HG00737,0,,1679
7,149314228,149316883,del,HG00324,0,,2655
7,125654485,125658119,del,NA20527,0,,3634
7,26509260,26509604,del,NA18577,0,,344
7,138033865,138035073,del,HG00306,0,,1208
7,5532031,5533510,del,HG00525,0,,1479
7,143684866,143690366,del,NA19129,0,,5500
7,102509383,102510154,del,NA19060,0,,771
7,142012754,142045081,del,NA12748,0,,32327
7,56505805,56507284,del,NA18950,0,,1479
7,154468035,154468182,del,NA18611,0,,147
7,21709241,21717338,del,NA19713,0,,8097
7,157734651,157734902,del,HG01052,0,,251
7,149895004,149896754,del,NA19319,0,,1750
7,129602768,129603653,del,NA19725,0,,885
7,102081716,102082590,del,NA19379,0,,874
7,155622140,155623023,del,NA19395,0,,883
7,5574900,5575892,del,HG01083,0,,992
7,20043081,20043289,del,HG00448,0,,208
7,57648360,57648528,del,NA19467,0,,168
7,159001257,159001553,del,HG01066,0,,296
7,75391069,75395013,del,NA18595,0,,3944
7,6196117,6197064,del,HG01197,0,,947
7,15089238,15092188,del,NA19239,0,,2950
7,75377735,75381657,del,NA18487,0,,3922
7,108501444,108501545,del,NA20537,0,,101
7,15127833,15127808,del,NA18570,0,,-25
7,140608586,140608803,del,HG01383,0,,217
7,69489645,69495885,del,HG00472,0,,6240
7,33504631,33517704,del,HG01170,0,,13073
7,4323765,4323909,del,HG01082,0,,144
7,682317,683314,del,NA19371,0,,997
7,26175426,26177022,del,HG00141,0,,1596
7,141670439,141672191,del,HG00543,0,,1752
7,103092922,103096588,del,NA19707,0,,3666
7,61067047,61771802,del,NA19059,0,,704755
7,116033239,116034363,del,HG01047,0,,1124
7,141165145,141168545,del,NA18610,0,,3400
7,89072616,89077422,del,NA12341,0,,4806
7,4601224,4603348,del,NA19359,0,,2124
7,82161459,82165464,del,HG00500,0,,4005
7,110430906,110432334,del,NA19818,0,,1428
7,1495154,1495911,del,HG01060,0,,757
7,51850959,51853846,del,NA19236,0,,2887
7,79469292,79475965,del,NA19900,0,,6673
7,39592057,39592371,del,HG00500,0,,314
7,119931392,119932998,del,HG01070,0,,1606
7,1704216,1706622,del,NA19235,0,,2406
7,9886065,9886322,del,NA18570,0,,257
7,118132762,118163618,del,NA19908,0,,30856
7,97496333,97496665,del,NA18627,0,,332
7,822072,822397,del,NA19380,0,,325
7,6666262,6666660,del,NA18520,0,,398
7,64717616,64724322,del,HG01066,0,,6706
7,82826014,82828113,del,NA19472,0,,2099
7,42319260,42325100,del,NA19682,0,,5840
7,128233255,128234644,del,HG00657,0,,1389
7,158087891,158088086,del,NA19373,0,,195
7,134222943,134261712,del,NA18528,0,,38769
7,69289071,69290517,del,NA12829,0,,1446
7,5140531,5153022,del,HG00236,0,,12491
7,81799985,81800795,del,HG00607,0,,810
7,155876506,155879966,del,NA11919,0,,3460
7,25572194,25579667,del,NA19332,0,,7473
7,100024416,100027522,del,HG00337,0,,3106
7,115546013,115546589,del,HG00277,0,,576
7,39548316,39553672,del,HG00372,0,,5356
7,137208571,137208916,del,NA19385,0,,345
7,48581294,48592638,del,NA20518,0,,11344
7,11437823,11439598,del,NA19355,0,,1775
7,121899858,121900499,del,NA19456,0,,641
7,80478589,80478774,del,HG00427,0,,185
7,23719222,24472076,del,NA18986,0,,752854
7,39597373,39597638,del,NA19461,0,,265
7,124893432,124896685,del,HG00472,0,,3253
7,110686576,110711974,del,NA18539,0,,25398
7,639416,639598,del,HG00331,0,,182
7,76128166,76626952,del,HG00690,0,,498786
7,140189223,140190274,del,HG00635,0,,1051
7,20749966,20752522,del,NA19009,0,,2556
7,142463867,142474761,del,HG00255,0,,10894
7,1271416,1287022,del,HG00136,0,,15606
7,12059530,12063941,del,NA19700,0,,4411
7,38387016,38397322,del,NA18965,0,,10306
7,103874937,103875244,del,HG01187,0,,307
7,152417756,152420831,del,NA19005,0,,3075
7,64718816,64724322,del,HG00542,0,,5506
7,11920550,11922861,del,NA20512,0,,2311
7,8849619,8869691,del,NA19707,0,,20072
7,131180747,131181462,del,NA19346,0,,715
7,102875319,102877879,del,HG01048,0,,2560
7,100678692,100680105,del,NA18567,0,,1413
7,123480508,123484297,del,HG00328,0,,3789
7,12024230,12024499,del,NA12878,0,,269
7,62139586,62141479,del,NA19374,0,,1893
7,159010225,159041450,del,HG00475,0,,31225
7,81006478,81008062,del,NA18558,0,,1584
7,61055808,61753334,del,HG00464,0,,697526
7,135993962,136000757,del,HG00270,0,,6795
7,87864376,87869834,del,NA19399,0,,5458
7,104590132,104590236,del,NA19116,0,,104
7,121062319,121062479,del,HG00663,0,,160
7,7504709,7510775,del,NA18612,0,,6066
7,125471916,125477572,del,NA19346,0,,5656
7,121220522,121225782,del,NA19448,0,,5260
7,32863262,32866758,del,NA18532,0,,3496
7,140236550,140238846,del,NA19449,0,,2296
7,129909549,129910321,del,NA18989,0,,772
7,9676120,9679555,del,HG01489,0,,3435
7,111020907,111022427,del,NA19713,0,,1520
7,153000082,153000228,del,NA06989,0,,146
7,15280746,15285252,del,NA19397,0,,4506
7,30160548,30160686,del,HG00324,0,,138
7,101968917,102022152,del,HG00231,0,,53235
7,39879043,39884814,del,NA19726,0,,5771
7,64497809,64499937,del,NA19707,0,,2128
7,115931640,115941248,del,NA07346,0,,9608
7,100327516,100340622,del,NA07357,0,,13106
7,29024353,29033669,del,NA19461,0,,9316
7,15314892,15322085,del,HG00159,0,,7193
7,4158237,4160316,del,NA07346,0,,2079
7,66991953,66992051,del,HG00282,0,,98
7,83050169,83051195,del,NA11993,0,,1026
7,1191317,1191727,del,NA18486,0,,410
7,7864494,7866161,del,NA19058,0,,1667
7,158954891,158955051,del,NA18621,0,,160
7,111002876,111158100,del,HG00542,0,,155224
7,43734736,43735388,del,HG01067,0,,652
7,102366700,102374330,del,HG00324,0,,7630
7,121161989,121162396,del,NA19457,0,,407
7,85509107,85523269,del,NA19430,0,,14162
7,14451264,14451430,del,NA18987,0,,166
7,108222386,108226108,del,NA19434,0,,3722
7,128371239,128371405,del,NA18973,0,,166
7,33708273,33708407,del,NA19625,0,,134
7,129299970,129301909,del,NA20291,0,,1939
7,89519904,89530436,del,NA19684,0,,10532
7,79165308,79165627,del,NA19731,0,,319
7,1664279,1667563,del,HG00672,0,,3284
7,86615666,86615572,del,NA18560,0,,-94
7,55823273,55828022,del,HG00247,0,,4749
7,83264507,83267184,del,NA19382,0,,2677
7,91357971,91360051,del,NA19468,0,,2080
7,63750007,63750161,del,NA18945,0,,154
7,88677448,88678486,del,NA18517,0,,1038
7,24120455,24125663,del,NA11829,0,,5208
7,157940439,157940975,del,HG01491,0,,536
7,100341237,100343246,del,NA18871,0,,2009
7,17749019,17749329,del,NA19064,0,,310
7,106028282,106030227,del,HG00187,0,,1945
7,75195147,75197081,del,NA19350,0,,1934
7,33176166,33179222,del,NA18983,0,,3056
7,70959128,70959699,del,HG01183,0,,571
7,93892582,93892780,del,HG00608,0,,198
7,81728727,81729064,del,NA20503,0,,337
7,151057981,151058125,del,NA20522,0,,144
7,155200216,155202022,del,NA19655,0,,1806
7,159117444,159122725,del,NA12413,0,,5281
7,7106782,7108429,del,NA19439,0,,1647
7,56005967,56006367,del,NA18539,0,,400
7,157541237,157542312,del,NA20340,0,,1075
7,142134401,142171356,del,HG00421,0,,36955
7,96543282,96549931,del,NA07347,0,,6649
7,35545870,35550646,del,HG00443,0,,4776
7,11561089,11561340,del,NA19449,0,,251
7,75571787,75572309,del,NA19436,0,,522
7,129085630,129086582,del,NA12154,0,,952
7,156241747,156242200,del,HG00699,0,,453
7,3380391,3403835,del,HG00179,0,,23444
7,2246387,2247985,del,NA12003,0,,1598
7,149736263,149739651,del,NA18923,0,,3388
7,37323582,37324871,del,HG00331,0,,1289
7,102726667,102740092,del,HG01465,0,,13425
7,1943461,1943747,del,HG01516,0,,286
7,140003944,140009803,del,HG00479,0,,5859
7,79960954,79966305,del,HG00178,0,,5351
7,110428384,110432505,del,NA18504,0,,4121
7,65616454,65620186,del,HG00607,0,,3732
7,136786458,136788395,del,HG00479,0,,1937
7,125470145,125477476,del,NA19375,0,,7331
7,70723549,70730153,del,NA20503,0,,6604
7,5840913,5856777,del,HG00580,0,,15864
7,25905392,25907645,del,NA19921,0,,2253
7,138135237,138137220,del,NA19676,0,,1983
7,81441636,81442543,del,HG00320,0,,907
7,6900462,6923584,del,NA19346,0,,23122
7,149575929,149576094,del,NA19397,0,,165
7,87668540,87672582,del,HG00323,0,,4042
7,125351009,125355268,del,NA19660,0,,4259
7,61762077,61763418,del,NA19311,0,,1341
7,3610433,3618939,del,HG00313,0,,8506
7,61056229,61759732,del,HG00375,0,,703503
7,145019620,145019970,del,NA19381,0,,350
7,38383665,38418367,del,HG01060,0,,34702
7,5327974,5329684,del,NA19707,0,,1710
7,76870542,76870796,del,NA19066,0,,254
7,130940490,130948448,del,HG01174,0,,7958
7,128470116,128474622,del,HG00268,0,,4506
7,72308829,72310433,del,NA18627,0,,1604
7,56314081,56314401,del,NA19200,0,,320
7,56742267,57178099,del,HG01070,0,,435832
7,115330682,115333831,del,NA19116,0,,3149
7,141491750,141491983,del,HG00180,0,,233
7,32450812,32457896,del,NA20520,0,,7084
7,41819122,41820744,del,NA20536,0,,1622
7,3433676,3439801,del,HG00312,0,,6125
7,158395077,158395259,del,HG00276,0,,182
7,29292175,29292511,del,NA19397,0,,336
7,75391272,75394946,del,NA18595,0,,3674
7,149884633,149890379,del,HG01124,0,,5746
7,120311187,120313087,del,HG00543,0,,1900
7,76702238,76708117,del,HG00181,0,,5879
7,682304,683166,del,NA19457,0,,862
7,140283051,140283984,del,NA19474,0,,933
7,21450313,21450978,del,HG00708,0,,665
7,76146724,76636532,del,HG00689,0,,489808
7,90426008,90427617,del,NA18517,0,,1609
7,149767787,149768130,del,NA19712,0,,343
7,117015463,117019166,del,NA19474,0,,3703
7,156315606,156321847,del,NA12058,0,,6241
7,64280122,64283060,del,NA19311,0,,2938
7,135452761,135453363,del,NA12003,0,,602
7,142824842,142893907,del,NA11892,0,,69065
7,12058816,12059322,del,HG00372,0,,506
7,157498342,157499386,del,NA19651,0,,1044
7,63482832,63739372,del,NA18532,0,,256540
7,157562718,157565126,del,NA18964,0,,2408
7,56217740,56220248,del,HG00320,0,,2508
7,24258087,24258483,del,NA19428,0,,396
7,157746829,157746904,del,HG00475,0,,75
7,82613521,82615897,del,HG01060,0,,2376
7,91562310,91564711,del,NA19371,0,,2401
7,82946462,82946780,del,NA19448,0,,318
7,61968494,61972893,del,HG01440,0,,4399
7,46356015,46362287,del,NA18538,0,,6272
7,157774663,157775067,del,HG00257,0,,404
7,62951739,62955347,del,HG00418,0,,3608
7,135272946,135275131,del,HG01048,0,,2185
7,13104697,13130553,del,HG01124,0,,25856
7,106723768,106729510,del,NA20807,0,,5742
7,34671918,34676617,del,NA19440,0,,4699
7,149732343,149734512,del,HG00282,0,,2169
7,65462188,65482207,del,NA11892,0,,20019
7,137573007,137573829,del,NA11881,0,,822
7,100609073,100609243,del,HG00337,0,,170
7,99115485,99120796,del,NA20819,0,,5311
7,38393118,38403648,del,NA12058,0,,10530
7,63409106,63409586,del,HG00367,0,,480
7,44493705,44494292,del,NA19437,0,,587
7,64828143,64828730,del,NA19398,0,,587
7,158250239,158250403,del,NA19394,0,,164
7,77322305,77324162,del,HG00473,0,,1857
7,64547416,64550322,del,HG00513,0,,2906
7,9093922,9103078,del,HG00270,0,,9156
7,140437,140561,del,HG00701,0,,124
7,118382709,118391228,del,NA19107,0,,8519
7,26616516,26619861,del,NA19704,0,,3345
7,20613097,20615243,del,NA11920,0,,2146
7,40145461,40146145,del,NA19059,0,,684
7,157675845,157676846,del,NA18620,0,,1001
7,139968449,139980347,del,NA20773,0,,11898
7,92994318,93001268,del,HG00267,0,,6950
7,133039959,133040556,del,HG00321,0,,597
7,71692872,71695033,del,HG00261,0,,2161
7,142872255,142883352,del,NA19190,0,,11097
7,134698470,134699065,del,NA19466,0,,595
7,134919328,134920462,del,NA19376,0,,1134
7,102621274,102624528,del,HG01204,0,,3254
7,156633093,156643437,del,NA19711,0,,10344
7,67113327,67113452,del,HG00704,0,,125
7,18396366,18397189,del,HG00260,0,,823
7,778656,778768,del,HG00530,0,,112
7,43169051,43169419,del,NA18622,0,,368
7,103772236,103774799,del,NA20299,0,,2563
7,93338666,93341572,del,NA18536,0,,2906
7,1155204,1155826,del,NA12273,0,,622
7,100326766,100339822,del,HG00264,0,,13056
7,136279944,136280316,del,NA10851,0,,372
7,150607496,150607642,del,HG01389,0,,146
7,109441316,109453722,del,NA12778,0,,12406
7,2899048,2899197,del,NA20524,0,,149
7,14508114,14508397,del,NA18558,0,,283
7,15255825,15326624,del,NA20513,0,,70799
7,1838345,1839097,del,NA19372,0,,752
7,36563312,36563890,del,HG00256,0,,578
7,139714522,139715902,del,NA18908,0,,1380
7,62028466,62051060,del,NA19675,0,,22594
7,115853810,115856689,del,NA19374,0,,2879
7,28596642,28596859,del,HG01187,0,,217
7,152166192,152167034,del,HG00276,0,,842
7,93173228,93175896,del,NA19130,0,,2668
7,118953278,118955478,del,NA19443,0,,2200
7,208424,208606,del,NA12827,0,,182
7,81955925,81956209,del,NA19985,0,,284
7,58004678,58005983,del,NA19452,0,,1305
7,61753568,61791604,del,NA20542,0,,38036
7,62366049,62369767,del,NA18596,0,,3718
7,32822226,32822512,del,NA12383,0,,286
7,121340890,121343025,del,NA19393,0,,2135
7,32549939,32550859,del,HG00274,0,,920
7,148730477,148731410,del,NA19722,0,,933
7,157133451,157135658,del,HG00565,0,,2207
7,55363251,55364229,del,NA19463,0,,978
7,18075648,18080329,del,NA19438,0,,4681
7,86231317,86245283,del,NA19786,0,,13966
7,29942303,29943148,del,NA19347,0,,845
7,98437108,98437242,del,HG01108,0,,134
7,122285250,122286571,del,NA19334,0,,1321
7,64828708,64829541,del,NA19921,0,,833
7,70676357,70678151,del,NA18548,0,,1794
7,70487914,70488240,del,HG00671,0,,326
7,153520742,153525727,del,NA19449,0,,4985
7,16794662,16800497,del,NA19058,0,,5835
7,155409505,155410218,del,NA20760,0,,713
7,98228542,98230750,del,NA19700,0,,2208
7,26305451,26308186,del,NA18874,0,,2735
7,155140627,155141468,del,NA20761,0,,841
7,45481895,45488067,del,HG00353,0,,6172
7,144643393,144651285,del,NA19371,0,,7892
7,72859085,72859913,del,NA19380,0,,828
7,158233541,158234279,del,NA18489,0,,738
7,64273224,64375303,del,NA07347,0,,102079
7,52428310,52429143,del,HG01492,0,,833
7,91994837,91996360,del,NA19338,0,,1523
7,91030016,91042372,del,NA18593,0,,12356
7,62146492,62162867,del,HG01176,0,,16375
7,133916287,133916423,del,HG00702,0,,136
7,113953501,113953813,del,NA19375,0,,312
7,150234020,150243905,del,HG00125,0,,9885
7,29774232,29781984,del,NA19435,0,,7752
7,132541931,132542387,del,NA18542,0,,456
7,53213818,53219784,del,HG01171,0,,5966
7,3836444,3856421,del,NA19381,0,,19977
7,67282528,67285043,del,NA20818,0,,2515
7,5606477,5610745,del,NA19331,0,,4268
7,153262864,153264029,del,NA19908,0,,1165
7,151539162,151539454,del,HG00276,0,,292
7,138232362,138235475,del,HG00245,0,,3113
7,157459692,157459933,del,HG00654,0,,241
7,149689050,149689162,del,NA19391,0,,112
7,70567016,70567622,del,HG00427,0,,606
7,137201519,137202752,del,HG00663,0,,1233
7,32063746,32063976,del,HG00476,0,,230
7,13881871,13886185,del,NA18868,0,,4314
7,45000666,45001400,del,NA12890,0,,734
7,68641490,68642048,del,HG00635,0,,558
7,134584867,134590430,del,NA18910,0,,5563
7,101972776,101973994,del,NA19818,0,,1218
7,54562835,54563697,del,NA19436,0,,862
7,91531032,91532714,del,NA19448,0,,1682
7,61968930,61972990,del,NA20507,0,,4060
7,84943587,84945641,del,HG00732,0,,2054
7,93327616,93332122,del,HG01494,0,,4506
7,73148041,73148537,del,NA19376,0,,496
7,62280778,62291362,del,NA19374,0,,10584
7,4159016,4160422,del,NA19376,0,,1406
7,13109964,13110044,del,HG01066,0,,80
7,65683608,65703378,del,NA19070,0,,19770
7,106584586,106586885,del,NA19704,0,,2299
7,14918489,14919016,del,NA19131,0,,527
7,7451810,7453186,del,NA18489,0,,1376
7,62829600,62835612,del,NA19685,0,,6012
7,146299967,146302642,del,NA20806,0,,2675
7,82402070,82405433,del,NA18606,0,,3363
7,150553033,150562171,del,NA19660,0,,9138
7,46254004,46256135,del,HG00437,0,,2131
7,56586882,56589135,del,HG00155,0,,2253
7,134313808,134325423,del,NA18593,0,,11615
7,101001251,101005488,del,NA06984,0,,4237
7,21587706,21587827,del,NA18605,0,,121
7,34278370,34281622,del,NA19900,0,,3252
7,55745967,56494467,del,HG00236,0,,748500
7,135131653,135131963,del,NA18553,0,,310
7,9886116,9886522,del,HG00325,0,,406
7,25339183,25342130,del,NA19239,0,,2947
7,109856123,109875429,del,HG00596,0,,19306
7,6122022,6143976,del,NA19834,0,,21954
7,49719838,49725897,del,HG01067,0,,6059
7,88848622,88849493,del,NA19466,0,,871
7,157882140,157882796,del,HG00693,0,,656
7,83018646,83018848,del,NA18973,0,,202
7,61742747,61783278,del,HG01342,0,,40531
7,75972478,75972682,del,HG01441,0,,204
7,7489087,7491212,del,HG00309,0,,2125
7,22446742,22453708,del,HG00692,0,,6966
7,66825917,66831935,del,HG00737,0,,6018
7,126045886,126051447,del,NA20322,0,,5561
7,148091394,148094222,del,HG00436,0,,2828
7,75732963,75799125,del,NA19466,0,,66162
7,8750264,8750591,del,NA19430,0,,327
7,119606396,119614335,del,NA19430,0,,7939
7,3374378,3417539,del,HG00614,0,,43161
7,62689016,62805822,del,NA18615,0,,116806
7,4424914,4425665,del,HG00156,0,,751
7,93541816,93542539,del,HG01250,0,,723
7,19576204,19577301,del,NA18613,0,,1097
7,66933130,67890594,del,NA20756,0,,957464
7,6137463,6139087,del,NA19788,0,,1624
7,54087371,54089429,del,HG01149,0,,2058
7,4733285,4737921,del,NA19655,0,,4636
7,322120,323361,del,HG01082,0,,1241
7,155957717,155958612,del,HG00315,0,,895
7,141110875,141110990,del,HG00421,0,,115
7,1742149,1742521,del,NA19462,0,,372
7,30883322,30887924,del,HG00654,0,,4602
7,158068917,158069123,del,NA19075,0,,206
7,25979618,25982548,del,NA11830,0,,2930
7,73344325,73352766,del,NA18988,0,,8441
7,7012332,7053958,del,NA19355,0,,41626
7,32286850,32287119,del,NA12828,0,,269
7,56877588,56879090,del,NA19712,0,,1502
7,61092740,61094924,del,HG00737,0,,2184
7,96185520,96213254,del,NA18984,0,,27734
7,138358751,138359421,del,HG00138,0,,670
7,137872081,137873438,del,NA19908,0,,1357
7,22058942,22060147,del,NA18610,0,,1205
7,38389495,38398650,del,HG00641,0,,9155
7,126799789,126809672,del,HG00158,0,,9883
7,57551502,57556161,del,HG00583,0,,4659
7,31315866,31318822,del,NA20531,0,,2956
7,30897063,30897362,del,HG00651,0,,299
7,70196199,70203035,del,NA10851,0,,6836
7,1970771,1970858,del,NA12829,0,,87
7,96550006,96552017,del,HG01108,0,,2011
7,46188132,46188558,del,NA19448,0,,426
7,50578479,50579202,del,NA19445,0,,723
7,25740343,25744673,del,NA19435,0,,4330
7,119228076,119236050,del,NA19313,0,,7974
7,37829814,37830078,del,NA18989,0,,264
7,5841080,5843962,del,NA19448,0,,2882
7,39119,75937,dup,HG00118,0,,36818
7,73841,134997,dup,HG01879,0,,61156
7,78321,231876,dup,HG01797,0,,153555
7,82951,110309,dup,HG04107,0,,27358
7,109065,180542,dup,HG00183,0,,71477
7,129252,148325,dup,HG01797,0,,19073
7,136433,445468,dup,HG01797,0,,309035
7,151255,160130,dup,HG00106,0,,8875
7,159005,191283,dup,HG01797,0,,32278
7,183003,202814,dup,HG00239,0,,19811
7,209759,229225,dup,NA12272,0,,19466
7,284827,445915,dup,HG01797,0,,161088
7,290041,301086,dup,HG00112,0,,11045
7,311970,335055,dup,NA18543,0,,23085
7,345372,424485,dup,HG00129,0,,79113
7,408286,445075,dup,HG01797,0,,36789
7,478288,501892,dup,NA19038,0,,23604
7,943860,961909,dup,HG00705,0,,18049
7,1468653,1473705,dup,HG00355,0,,5052
7,1596682,1607460,dup,HG03636,0,,10778
7,1788876,1805051,dup,HG02131,0,,16175
7,1933259,1937545,dup,HG00473,0,,4286
7,2727927,2733862,dup,NA18591,0,,5935
7,2961317,3314341,dup,HG00653,0,,353024
7,3116133,3180474,dup,HG00653,0,,64341
7,3184388,3338423,dup,HG00653,0,,154035
7,3291983,3430104,dup,NA18560,0,,138121
7,3342657,3373067,dup,HG04238,0,,30410
7,3384178,3461700,dup,NA19222,0,,77522
7,3442079,3468549,dup,NA19913,0,,26470
7,3442381,3486729,dup,NA19913,0,,44348
7,3464088,3589034,dup,NA18560,0,,124946
7,3470363,3553181,dup,NA18560,0,,82818
7,3580673,3609264,dup,HG03897,0,,28591
7,3623510,3722053,dup,NA18560,0,,98543
7,3852459,3872417,dup,HG02724,0,,19958
7,4082180,4210214,dup,HG03636,0,,128034
7,4269021,4360508,dup,HG03636,0,,91487
7,4287822,4403956,dup,HG03636,0,,116134
7,4289014,4406007,dup,HG03729,0,,116993
7,4352457,4539602,dup,HG03652,0,,187145
7,4354460,4368549,dup,HG01383,0,,14089
7,4365279,4424982,dup,HG01566,0,,59703
7,4418737,4449157,dup,HG01566,0,,30420
7,4437426,4475583,dup,HG01566,0,,38157
7,4526543,4553417,dup,HG03604,0,,26874
7,4547423,4596852,dup,HG03652,0,,49429
7,4605289,4647633,dup,HG03636,0,,42344
7,4650079,4664334,dup,HG01586,0,,14255
7,4672970,4684399,dup,HG03636,0,,11429
7,4691077,4697581,dup,NA19431,0,,6504
7,4694827,4702137,dup,HG02614,0,,7310
7,4708013,4721449,dup,HG03636,0,,13436
7,4901194,5013506,dup,HG01491,0,,112312
7,4989008,4998209,dup,HG01491,0,,9201
7,5141445,5159132,dup,NA19713,0,,17687
7,5784560,5900974,dup,HG01531,0,,116414
7,5785685,5788935,dup,HG01531,0,,3250
7,5792026,5831975,dup,HG01531,0,,39949
7,5833137,5846993,dup,HG02772,0,,13856
7,5840745,5854593,dup,HG00580,0,,13848
7,5862765,5874511,dup,HG02491,0,,11746
7,5881715,5903881,dup,HG02772,0,,22166
7,5900754,5912294,dup,HG01882,0,,11540
7,5918437,5936106,dup,HG02772,0,,17669
7,6031005,6039619,dup,HG00451,0,,8614
7,6055017,6059938,dup,HG01107,0,,4921
7,6490943,6496606,dup,HG00472,0,,5663
7,6742092,6764532,dup,HG02555,0,,22440
7,6747349,6791707,dup,HG02555,0,,44358
7,6867884,6883026,dup,HG01773,0,,15142
7,6900776,6923240,dup,HG00097,0,,22464
7,6925149,6960787,dup,HG00346,0,,35638
7,6973377,7021302,dup,HG00346,0,,47925
7,7000559,7089273,dup,HG00346,0,,88714
7,7043017,7186937,dup,HG01773,0,,143920
7,7077688,7143265,dup,HG01773,0,,65577
7,7152008,7245603,dup,HG01773,0,,93595
7,7267995,7286507,dup,HG01773,0,,18512
7,7292686,7322556,dup,NA11830,0,,29870
7,7320084,7384254,dup,HG02255,0,,64170
7,7328405,7435465,dup,HG02255,0,,107060
7,7444813,7528127,dup,HG01618,0,,83314
7,7445492,7483842,dup,HG01618,0,,38350
7,7502757,7514360,dup,HG00171,0,,11603
7,7514283,7606251,dup,HG00109,0,,91968
7,7949540,7968875,dup,HG01630,0,,19335
7,8436011,8441168,dup,NA18534,0,,5157
7,8459086,8472122,dup,NA18534,0,,13036
7,8577063,8601264,dup,HG03882,0,,24201
7,8579562,8601199,dup,HG03882,0,,21637
7,8899095,8933482,dup,HG01965,0,,34387
7,8899826,8935944,dup,HG03027,0,,36118
7,8919900,8950652,dup,HG03793,0,,30752
7,9124596,9231637,dup,NA12234,0,,107041
7,9437987,9471937,dup,NA18988,0,,33950
7,9445497,9466197,dup,HG02385,0,,20700
7,9676506,9733172,dup,HG00475,0,,56666
7,9805753,9912611,dup,HG01860,0,,106858
7,9806124,9909024,dup,HG01860,0,,102900
7,10848277,10856557,dup,HG02166,0,,8280
7,11306285,11309585,dup,HG01626,0,,3300
7,11309437,11365130,dup,HG01536,0,,55693
7,11712491,11746892,dup,HG01110,0,,34401
7,12235462,12284797,dup,HG00556,0,,49335
7,12251510,12274803,dup,HG00556,0,,23293
7,12371748,12396591,dup,HG01950,0,,24843
7,12434285,12445983,dup,HG00246,0,,11698
7,12453471,12494246,dup,HG04185,0,,40775
7,12453648,12496103,dup,HG04185,0,,42455
7,12516313,12568745,dup,HG03366,0,,52432
7,12521478,12564911,dup,HG03366,0,,43433
7,12585065,12616133,dup,HG03978,0,,31068
7,12588563,12613277,dup,HG03742,0,,24714
7,12807303,12829465,dup,NA20807,0,,22162
7,12929231,12991928,dup,NA20911,0,,62697
7,13180943,13232066,dup,HG01284,0,,51123
7,13213088,13232564,dup,HG03729,0,,19476
7,13401480,13442353,dup,HG01860,0,,40873
7,13792280,13855263,dup,NA19782,0,,62983
7,14061369,14277015,dup,NA18634,0,,215646
7,14109278,14178846,dup,NA20832,0,,69568
7,14186572,14338662,dup,NA18634,0,,152090
7,14280046,14416669,dup,NA18634,0,,136623
7,14441426,14591827,dup,NA18634,0,,150401
7,14595814,14733096,dup,NA18634,0,,137282
7,14753373,14827583,dup,NA18634,0,,74210
7,15012893,15035228,dup,HG01462,0,,22335
7,15032655,15073140,dup,HG01462,0,,40485
7,15036527,15121552,dup,NA12813,0,,85025
7,15078291,15164898,dup,NA12813,0,,86607
7,15147988,15249305,dup,HG01462,0,,101317
7,15162159,15230976,dup,HG00701,0,,68817
7,15242218,15327550,dup,HG01462,0,,85332
7,15249962,15324272,dup,NA20513,0,,74310
7,15285714,15534529,dup,HG01632,0,,248815
7,15384287,15391214,dup,HG01632,0,,6927
7,15391498,15408475,dup,NA18864,0,,16977
7,15393877,15415363,dup,NA18864,0,,21486
7,15405260,15526434,dup,HG01632,0,,121174
7,15747153,15804783,dup,HG00243,0,,57630
7,16015811,16029331,dup,HG00148,0,,13520
7,16356537,16404084,dup,HG00448,0,,47547
7,16394882,16440330,dup,HG03446,0,,45448
7,16431344,16481594,dup,HG03446,0,,50250
7,16913868,17048758,dup,HG01673,0,,134890
7,16914165,17035750,dup,HG01673,0,,121585
7,17070214,17094996,dup,HG01673,0,,24782
7,17106584,17193229,dup,HG01673,0,,86645
7,17115399,17279397,dup,HG01762,0,,163998
7,17195617,17266587,dup,HG01762,0,,70970
7,17247539,17420926,dup,NA18988,0,,173387
7,17282708,17331074,dup,HG01673,0,,48366
7,17403258,17463319,dup,HG00379,0,,60061
7,17556546,17573218,dup,NA20509,0,,16672
7,18087244,18113701,dup,HG03991,0,,26457
7,18127212,18153868,dup,HG03991,0,,26656
7,18395607,18406294,dup,NA06986,0,,10687
7,19510663,19528973,dup,HG02277,0,,18310
7,19984608,19988434,dup,HG03057,0,,3826
7,20162177,20165763,dup,NA19316,0,,3586
7,20748751,20753448,dup,HG00100,0,,4697
7,22136974,22352003,dup,HG00689,0,,215029
7,22362796,22429992,dup,HG00689,0,,67196
7,22441433,22513606,dup,HG00689,0,,72173
7,22810763,22815234,dup,NA19038,0,,4471
7,22911649,22982904,dup,HG02968,0,,71255
7,23306520,23341209,dup,HG04094,0,,34689
7,23538915,23542205,dup,NA18616,0,,3290
7,24234029,24240778,dup,NA19678,0,,6749
7,24369012,24407547,dup,HG03472,0,,38535
7,24372400,24395301,dup,HG02697,0,,22901
7,24393619,24405744,dup,HG03472,0,,12125
7,25625819,25642484,dup,NA19375,0,,16665
7,25626814,25649229,dup,NA19375,0,,22415
7,25702942,25783051,dup,NA20853,0,,80109
7,25997981,26240339,dup,HG02006,0,,242358
7,26004435,26111117,dup,HG02006,0,,106682
7,26137220,26145486,dup,HG00097,0,,8266
7,26144487,26199248,dup,HG02006,0,,54761
7,26188931,26222808,dup,HG02006,0,,33877
7,26340833,26349482,dup,HG01948,0,,8649
7,26590722,26606578,dup,HG03905,0,,15856
7,28119378,28131418,dup,HG03854,0,,12040
7,29010598,29028199,dup,HG02654,0,,17601
7,29036752,29249070,dup,HG02654,0,,212318
7,29254351,29359375,dup,HG02654,0,,105024
7,29359376,29591930,dup,HG02654,0,,232554
7,29672432,29836608,dup,HG02654,0,,164176
7,30138795,30147392,dup,HG01139,0,,8597
7,31686147,31927714,dup,HG00457,0,,241567
7,31686442,31761408,dup,HG00457,0,,74966
7,32725787,32737270,dup,HG01817,0,,11483
7,32746101,32774417,dup,HG03698,0,,28316
7,32784009,32828795,dup,NA18511,0,,44786
7,32937109,32941742,dup,HG02604,0,,4633
7,33130611,33185627,dup,HG00155,0,,55016
7,33131061,33189010,dup,HG00155,0,,57949
7,33771819,33893584,dup,HG00148,0,,121765
7,33772127,33816811,dup,HG00148,0,,44684
7,33901393,33982484,dup,HG00148,0,,81091
7,33992769,34063123,dup,HG00148,0,,70354
7,34072148,34230788,dup,HG00148,0,,158640
7,34089375,34116660,dup,HG00148,0,,27285
7,34217427,34392713,dup,HG00148,0,,175286
7,34403025,34470897,dup,HG00148,0,,67872
7,35921993,35993414,dup,HG02470,0,,71421
7,35976254,36014238,dup,HG02470,0,,37984
7,37240100,37253367,dup,HG02763,0,,13267
7,37770892,37893239,dup,NA19025,0,,122347
7,37930939,37937094,dup,HG02012,0,,6155
7,38282544,38304267,dup,HG02491,0,,21723
7,38388214,38397225,dup,HG00097,0,,9011
7,38397918,38404216,dup,HG01060,0,,6298
7,38730639,38802738,dup,HG03598,0,,72099
7,38741114,38766222,dup,HG03598,0,,25108
7,39191686,39249023,dup,NA20320,0,,57337
7,39237767,39244626,dup,NA20320,0,,6859
7,39252829,39269125,dup,HG02221,0,,16296
7,40074683,40198161,dup,HG00457,0,,123478
7,40131223,40160568,dup,HG00457,0,,29345
7,40177146,40199772,dup,HG00245,0,,22626
7,40177535,40216993,dup,HG00245,0,,39458
7,40265684,40320977,dup,HG02009,0,,55293
7,40393251,40426663,dup,NA12872,0,,33412
7,42135747,42168866,dup,HG03770,0,,33119
7,42142163,42168786,dup,HG03770,0,,26623
7,42793458,42853462,dup,NA19726,0,,60004
7,43478142,43649125,dup,NA19376,0,,170983
7,43478322,43554625,dup,NA19376,0,,76303
7,43577384,43695955,dup,NA19376,0,,118571
7,44036371,44058178,dup,HG03442,0,,21807
7,44582134,44588035,dup,HG03121,0,,5901
7,45288711,45309770,dup,HG03117,0,,21059
7,46278176,46283514,dup,HG02702,0,,5338
7,46532294,46537193,dup,HG01510,0,,4899
7,46535944,46554569,dup,HG00351,0,,18625
7,46707144,46721009,dup,HG00107,0,,13865
7,46968987,47033039,dup,HG03300,0,,64052
7,47070504,47429321,dup,HG03300,0,,358817
7,47402857,47426677,dup,HG03300,0,,23820
7,47613323,47732931,dup,HG04153,0,,119608
7,47635793,48072120,dup,HG04153,0,,436327
7,47747600,47938297,dup,HG04153,0,,190697
7,47942670,48092680,dup,HG04153,0,,150010
7,48550246,48555431,dup,HG03006,0,,5185
7,48555263,48582472,dup,HG01893,0,,27209
7,48780148,48807180,dup,HG03539,0,,27032
7,48823368,48879113,dup,HG01805,0,,55745
7,49003981,49009425,dup,HG01507,0,,5444
7,49926291,49950332,dup,HG02433,0,,24041
7,50043762,50049006,dup,HG01431,0,,5244
7,50553091,50653502,dup,HG02470,0,,100411
7,50553232,50581917,dup,NA19020,0,,28685
7,50553578,50642867,dup,NA20528,0,,89289
7,51403596,51421006,dup,HG00672,0,,17410
7,51454010,51484347,dup,HG03511,0,,30337
7,51741134,51750806,dup,HG01311,0,,9672
7,51850861,51853880,dup,HG00189,0,,3019
7,52728506,52744539,dup,HG00263,0,,16033
7,53034070,53044261,dup,HG04062,0,,10191
7,53460521,53602210,dup,HG01491,0,,141689
7,54168095,54213644,dup,HG03823,0,,45549
7,54185512,54191721,dup,HG01125,0,,6209
7,54410078,54556352,dup,HG02271,0,,146274
7,54427141,54510273,dup,HG02271,0,,83132
7,55353180,55408132,dup,NA12828,0,,54952
7,55353909,55458580,dup,NA12828,0,,104671
7,55618296,55745843,dup,NA12828,0,,127547
7,55734773,56483244,dup,NA12828,0,,748471
7,55914459,55936926,dup,HG00599,0,,22467
7,55925866,55979052,dup,NA12828,0,,53186
7,56031072,56186821,dup,NA12828,0,,155749
7,56117100,56397217,dup,NA12828,0,,280117
7,56476543,56508832,dup,HG03977,0,,32289
7,56506765,56513132,dup,HG00115,0,,6367
7,56524889,56697684,dup,HG03977,0,,172795
7,56710214,56759416,dup,NA12347,0,,49202
7,56786397,56801409,dup,NA12347,0,,15012
7,56804315,56822416,dup,HG01459,0,,18101
7,56828340,56848830,dup,HG01459,0,,20490
7,56895186,56979972,dup,HG01459,0,,84786
7,57511473,57596135,dup,HG03731,0,,84662
7,57591520,57624566,dup,HG03911,0,,33046
7,57622481,57698836,dup,HG01125,0,,76355
7,57698617,57725185,dup,HG02610,0,,26568
7,57729553,57807369,dup,NA12347,0,,77816
7,57837506,57886283,dup,HG01802,0,,48777
7,57914574,57935686,dup,HG00592,0,,21112
7,61057989,61077633,dup,HG02061,0,,19644
7,61658170,61672736,dup,HG01890,0,,14566
7,61759527,61836016,dup,HG00551,0,,76489
7,62373819,62487000,dup,HG00177,0,,113181
7,62520358,62565654,dup,HG00177,0,,45296
7,62632545,62667177,dup,HG00177,0,,34632
7,62687405,62723597,dup,HG00403,0,,36192
7,62711984,62747338,dup,HG00403,0,,35354
7,62829494,62835043,dup,HG00239,0,,5549
7,62918687,62932549,dup,HG01885,0,,13862
7,63257478,63275071,dup,HG01459,0,,17593
7,63292861,63302299,dup,HG02048,0,,9438
7,63480475,63494546,dup,NA20342,0,,14071
7,64637073,64654971,dup,HG00115,0,,17898
7,64685139,64711571,dup,HG00115,0,,26432
7,64695322,64838588,dup,HG01438,0,,143266
7,64718383,64722248,dup,HG00108,0,,3865
7,64722749,64756087,dup,HG00115,0,,33338
7,64765522,64811960,dup,HG00115,0,,46438
7,64832797,64850432,dup,HG00115,0,,17635
7,64843883,64888031,dup,HG00115,0,,44148
7,64894565,64934366,dup,HG00115,0,,39801
7,64940539,64974354,dup,HG00115,0,,33815
7,65056024,65095305,dup,HG00115,0,,39281
7,65148752,65167267,dup,HG01618,0,,18515
7,65182620,65206389,dup,HG01618,0,,23769
7,65214057,65226123,dup,HG01618,0,,12066
7,65263665,65275068,dup,HG01618,0,,11403
7,65287771,65307288,dup,HG01618,0,,19517
7,65299420,65323146,dup,HG01618,0,,23726
7,65411564,65466460,dup,HG00759,0,,54896
7,65414607,65440649,dup,HG00759,0,,26042
7,65451388,65461212,dup,HG00978,0,,9824
7,65543987,65567328,dup,HG02573,0,,23341
7,65545303,65560799,dup,HG02573,0,,15496
7,65627175,65638357,dup,NA19091,0,,11182
7,65929234,66046609,dup,NA18634,0,,117375
7,65930105,65942806,dup,HG00531,0,,12701
7,65998801,66009683,dup,NA18634,0,,10882
7,66100353,66122458,dup,HG01413,0,,22105
7,66101969,66138761,dup,HG01272,0,,36792
7,66126645,66135061,dup,HG00556,0,,8416
7,66213758,66361299,dup,HG01140,0,,147541
7,66220205,66303065,dup,HG01140,0,,82860
7,66340171,66359829,dup,HG01708,0,,19658
7,66419204,66429275,dup,HG00442,0,,10071
7,66435067,66447986,dup,HG03808,0,,12919
7,66462147,66582158,dup,HG00096,0,,120011
7,66581036,66732917,dup,HG00096,0,,151881
7,67042076,67045141,dup,NA18945,0,,3065
7,67044142,67059810,dup,HG01885,0,,15668
7,67551375,67555428,dup,HG01102,0,,4053
7,67590007,67597127,dup,HG00674,0,,7120
7,67620264,67627396,dup,HG00739,0,,7132
7,68543953,68559532,dup,NA20768,0,,15579
7,68568928,68588366,dup,NA12413,0,,19438
7,69508427,69530210,dup,HG03163,0,,21783
7,69516598,69535751,dup,HG03163,0,,19153
7,70086517,70182123,dup,NA20528,0,,95606
7,70210846,70300943,dup,NA20528,0,,90097
7,70316520,70370488,dup,HG03743,0,,53968
7,70319986,70365073,dup,HG01174,0,,45087
7,70388772,70422070,dup,NA20528,0,,33298
7,70425016,70470855,dup,NA20528,0,,45839
7,70855785,70870401,dup,HG02694,0,,14616
7,71243983,71267493,dup,HG02489,0,,23510
7,71999314,72050140,dup,HG00096,0,,50826
7,72042173,72089706,dup,HG03832,0,,47533
7,72140491,72212820,dup,HG03832,0,,72329
7,72275918,72313198,dup,HG03832,0,,37280
7,72303035,72342939,dup,HG01247,0,,39904
7,72332716,72420536,dup,HG01247,0,,87820
7,72652796,72704748,dup,HG00281,0,,51952
7,72726800,72740359,dup,HG00407,0,,13559
7,73055007,73067523,dup,NA19332,0,,12516
7,73504792,73813060,dup,HG00342,0,,308268
7,73865803,73898481,dup,HG00342,0,,32678
7,74474164,74493726,dup,HG01840,0,,19562
7,75328373,75425731,dup,NA20519,0,,97358
7,75339606,75355573,dup,NA20519,0,,15967
7,75353540,75364757,dup,NA12413,0,,11217
7,75375133,75391397,dup,HG03559,0,,16264
7,75398588,75415901,dup,NA20519,0,,17313
7,75542102,75665848,dup,HG02219,0,,123746
7,75674992,75689503,dup,HG04042,0,,14511
7,75761008,75791107,dup,HG01111,0,,30099
7,75761074,75803519,dup,HG01111,0,,42445
7,76130043,76145287,dup,HG02860,0,,15244
7,76144788,76157013,dup,HG00096,0,,12225
7,76173056,76224552,dup,HG01325,0,,51496
7,76294921,76442150,dup,HG01325,0,,147229
7,76461355,76592164,dup,HG01325,0,,130809
7,77291034,77300109,dup,HG02445,0,,9075
7,77924638,78062063,dup,NA12748,0,,137425
7,77927733,77973281,dup,NA12748,0,,45548
7,78066163,78195682,dup,NA12748,0,,129519
7,78200080,78335333,dup,NA12748,0,,135253
7,78740682,78756181,dup,HG01536,0,,15499
7,79318189,79409613,dup,HG00115,0,,91424
7,79501267,79606118,dup,HG01861,0,,104851
7,79604308,79647077,dup,HG03585,0,,42769
7,79610008,79633884,dup,HG03585,0,,23876
7,79919720,80017082,dup,HG01861,0,,97362
7,80018647,80031161,dup,HG03695,0,,12514
7,80030789,80079645,dup,HG02658,0,,48856
7,80083054,80214220,dup,HG02658,0,,131166
7,80999653,81041772,dup,HG04118,0,,42119
7,81852723,81856847,dup,HG00404,0,,4124
7,82806084,82821107,dup,HG02089,0,,15023
7,83128210,83184894,dup,HG02025,0,,56684
7,83353437,83416544,dup,HG04054,0,,63107
7,83360918,83422955,dup,HG03598,0,,62037
7,83917069,83936885,dup,HG02977,0,,19816
7,84756257,84794890,dup,HG02681,0,,38633
7,85038678,85145513,dup,HG00239,0,,106835
7,85081192,85104724,dup,HG01311,0,,23532
7,85418829,85531682,dup,HG04239,0,,112853
7,85728792,85743950,dup,HG01848,0,,15158
7,86437354,86458214,dup,NA19654,0,,20860
7,86440659,86461360,dup,HG00657,0,,20701
7,86685168,86778535,dup,NA19982,0,,93367
7,88136649,88258165,dup,HG02968,0,,121516
7,88849624,89012169,dup,NA19756,0,,162545
7,88851953,88936436,dup,NA19756,0,,84483
7,88941951,89108765,dup,HG01939,0,,166814
7,89018042,89081840,dup,HG01939,0,,63798
7,89099436,89202042,dup,NA19756,0,,102606
7,89222820,89251469,dup,HG00325,0,,28649
7,89256259,89429955,dup,NA19756,0,,173696
7,89267936,89308476,dup,NA18988,0,,40540
7,89269076,89300789,dup,NA18533,0,,31713
7,89313592,89346048,dup,HG02057,0,,32456
7,89354220,89390011,dup,HG02922,0,,35791
7,89464413,89512194,dup,NA19923,0,,47781
7,89472161,89492981,dup,HG01183,0,,20820
7,89619270,89727661,dup,HG03040,0,,108391
7,89698018,89741838,dup,HG03040,0,,43820
7,89791147,89815582,dup,HG02813,0,,24435
7,90184525,90222758,dup,HG00445,0,,38233
7,92321021,92352493,dup,NA19043,0,,31472
7,92480616,92530379,dup,NA11840,0,,49763
7,93432478,93467425,dup,HG02887,0,,34947
7,95039371,95050937,dup,HG01583,0,,11566
7,95331793,95377808,dup,HG00956,0,,46015
7,95337066,95364831,dup,HG00533,0,,27765
7,95978120,95989747,dup,HG02772,0,,11627
7,97017121,97022035,dup,HG03604,0,,4914
7,97177716,97204268,dup,HG00345,0,,26552
7,97177861,97203582,dup,HG00272,0,,25721
7,97451057,97455771,dup,HG02839,0,,4714
7,97828392,97844858,dup,NA18630,0,,16466
7,98150062,98163273,dup,NA20805,0,,13211
7,98389107,98439349,dup,HG01980,0,,50242
7,98390728,98415443,dup,HG01980,0,,24715
7,98625263,98634084,dup,HG02971,0,,8821
7,98799451,98804055,dup,HG00131,0,,4604
7,98904100,98916522,dup,NA18531,0,,12422
7,99811456,99839019,dup,HG03861,0,,27563
7,99813490,99940508,dup,HG03861,0,,127018
7,99860739,99892278,dup,HG03861,0,,31539
7,99895446,99939678,dup,HG03861,0,,44232
7,100610894,100674574,dup,HG01864,0,,63680
7,100850076,100908823,dup,HG01684,0,,58747
7,100853355,100866274,dup,NA07347,0,,12919
7,100874850,100891519,dup,HG01684,0,,16669
7,100891064,100904623,dup,HG03559,0,,13559
7,100991082,100999086,dup,HG00251,0,,8004
7,101008517,101023173,dup,HG00251,0,,14656
7,101036302,101060744,dup,HG01684,0,,24442
7,101099980,101123894,dup,HG00251,0,,23914
7,101436385,101450590,dup,HG01684,0,,14205
7,101969557,102023185,dup,NA19437,0,,53628
7,102398969,102420499,dup,HG01384,0,,21530
7,102435374,102493746,dup,HG03629,0,,58372
7,103309367,103380377,dup,NA18933,0,,71010
7,103418828,103553080,dup,NA18933,0,,134252
7,103559407,103693579,dup,NA18933,0,,134172
7,103736925,103826614,dup,NA19783,0,,89689
7,103850085,103924077,dup,HG02888,0,,73992
7,103970694,104000725,dup,HG02067,0,,30031
7,104220429,104250050,dup,HG03755,0,,29621
7,104501492,104505009,dup,NA20881,0,,3517
7,105011434,105190391,dup,HG02017,0,,178957
7,105017368,105035230,dup,HG02017,0,,17862
7,105029791,105035230,dup,HG02017,0,,5439
7,105047057,105056098,dup,HG01756,0,,9041
7,105059076,105071304,dup,HG02017,0,,12228
7,105086790,105098026,dup,HG02017,0,,11236
7,105127678,105145003,dup,HG02017,0,,17325
7,105162532,105176472,dup,HG02017,0,,13940
7,105169863,105184477,dup,HG02017,0,,14614
7,105927743,105945367,dup,HG01583,0,,17624
7,105929686,105945352,dup,HG01583,0,,15666
7,106272372,106294989,dup,HG03703,0,,22617
7,107207026,107300093,dup,NA21116,0,,93067
7,108438757,108475888,dup,HG02085,0,,37131
7,108594993,108640800,dup,HG00446,0,,45807
7,108595809,108644495,dup,HG00446,0,,48686
7,109990778,110010043,dup,HG01816,0,,19265
7,110203855,110274970,dup,HG04003,0,,71115
7,110204470,110340810,dup,HG04003,0,,136340
7,110337140,110355992,dup,HG03778,0,,18852
7,110382068,110405301,dup,NA18571,0,,23233
7,110441935,110445236,dup,HG01069,0,,3301
7,110581979,110585812,dup,HG00436,0,,3833
7,110764713,110900567,dup,NA12286,0,,135854
7,110821800,110868254,dup,HG01260,0,,46454
7,111024794,111042522,dup,HG00542,0,,17728
7,111075070,111128413,dup,HG00542,0,,53343
7,111083671,111112594,dup,HG03629,0,,28923
7,111096681,111150169,dup,HG03629,0,,53488
7,111105513,111274979,dup,HG00186,0,,169466
7,111290397,111308228,dup,HG03736,0,,17831
7,111302630,111331774,dup,HG03886,0,,29144
7,111854425,111891933,dup,HG03733,0,,37508
7,112433005,112473494,dup,HG00271,0,,40489
7,112434926,112482430,dup,HG00271,0,,47504
7,112569699,112599355,dup,NA19098,0,,29656
7,112570378,112617223,dup,NA19098,0,,46845
7,112970683,113062194,dup,HG04153,0,,91511
7,115637576,115641575,dup,NA19350,0,,3999
7,116545459,116663453,dup,HG03928,0,,117994
7,116545554,116696383,dup,HG03805,0,,150829
7,116560692,116603871,dup,HG00542,0,,43179
7,116587131,116686277,dup,HG03805,0,,99146
7,116667074,116695786,dup,HG03928,0,,28712
7,117153917,117202561,dup,HG04131,0,,48644
7,117251496,117265168,dup,HG02461,0,,13672
7,117291835,117306678,dup,NA20847,0,,14843
7,117353462,117382755,dup,HG02442,0,,29293
7,117906929,118126354,dup,HG03460,0,,219425
7,118134710,118309707,dup,HG03460,0,,174997
7,118437942,118501736,dup,HG03705,0,,63794
7,118463639,118504151,dup,HG03705,0,,40512
7,118545502,118554314,dup,HG02973,0,,8812
7,118658069,118688467,dup,HG03054,0,,30398
7,118769472,118822758,dup,NA18636,0,,53286
7,119291491,119515883,dup,HG01988,0,,224392
7,119403898,119442012,dup,HG02554,0,,38114
7,119515496,119585161,dup,HG01988,0,,69665
7,119709520,119724177,dup,HG02394,0,,14657
7,120303961,120319327,dup,HG00252,0,,15366
7,120528346,120580892,dup,HG01578,0,,52546
7,121077201,121107002,dup,HG03789,0,,29801
7,121168903,121181291,dup,HG00608,0,,12388
7,122430826,122457755,dup,NA19171,0,,26929
7,122791532,122889538,dup,HG03100,0,,98006
7,122797512,122870478,dup,HG01874,0,,72966
7,123455140,123475037,dup,NA19819,0,,19897
7,123480669,123484307,dup,HG00115,0,,3638
7,123876023,123881736,dup,HG00240,0,,5713
7,124358372,124367133,dup,HG03773,0,,8761
7,125584267,125601695,dup,HG02580,0,,17428
7,125974950,126174751,dup,NA18988,0,,199801
7,125996763,126030479,dup,HG01951,0,,33716
7,126357229,126367873,dup,HG02397,0,,10644
7,126631401,126684685,dup,HG03727,0,,53284
7,127580053,127612521,dup,HG01167,0,,32468
7,127928336,127948158,dup,HG01130,0,,19822
7,128214926,128244159,dup,HG01849,0,,29233
7,129383971,129411481,dup,HG02512,0,,27510
7,129641728,129651999,dup,HG00103,0,,10271
7,129682377,129685626,dup,HG00407,0,,3249
7,132321868,132339158,dup,NA19684,0,,17290
7,133524495,133531934,dup,HG03775,0,,7439
7,133623157,133940410,dup,HG03875,0,,317253
7,133624664,133713380,dup,HG03875,0,,88716
7,133625291,134209548,dup,HG03875,0,,584257
7,133798741,133834561,dup,HG03875,0,,35820
7,133949793,134209489,dup,HG03875,0,,259696
7,135141061,135144136,dup,HG00369,0,,3075
7,135749022,135767358,dup,HG03746,0,,18336
7,135782445,135795975,dup,HG01845,0,,13530
7,137158334,137295061,dup,HG01365,0,,136727
7,137160335,137225752,dup,HG01365,0,,65417
7,138013724,138052835,dup,HG02537,0,,39111
7,138477963,138508366,dup,HG02491,0,,30403
7,138478850,138521124,dup,HG02491,0,,42274
7,139178626,139193396,dup,NA19732,0,,14770
7,139182442,139216501,dup,HG02890,0,,34059
7,139190053,139230099,dup,HG02890,0,,40046
7,140021657,140076543,dup,NA19663,0,,54886
7,140029334,140062454,dup,NA19663,0,,33120
7,140267204,140345214,dup,HG03124,0,,78010
7,140283464,140307895,dup,HG03124,0,,24431
7,141760438,141765623,dup,HG00145,0,,5185
7,141765307,141792849,dup,HG00099,0,,27542
7,142493957,142498206,dup,NA20340,0,,4249
7,142794530,142897402,dup,HG00122,0,,102872
7,143425339,143440640,dup,HG00181,0,,15301
7,143583592,143640094,dup,NA18941,0,,56502
7,143623637,143657653,dup,HG03894,0,,34016
7,144435875,144456987,dup,HG03436,0,,21112
7,144481654,144486219,dup,NA19451,0,,4565
7,145158372,145169524,dup,HG01058,0,,11152
7,146133803,146139689,dup,HG00551,0,,5886
7,146194539,146292517,dup,HG03705,0,,97978
7,146218586,146255453,dup,HG03705,0,,36867
7,146230504,146348795,dup,HG03705,0,,118291
7,146358302,146454161,dup,HG03814,0,,95859
7,146458118,146496056,dup,HG03814,0,,37938
7,146570229,146588807,dup,HG01708,0,,18578
7,147103571,147142386,dup,HG00353,0,,38815
7,148187562,148202295,dup,HG03781,0,,14733
7,148594558,148621328,dup,HG01516,0,,26770
7,149418118,149433868,dup,NA20291,0,,15750
7,149487134,149736289,dup,HG00269,0,,249155
7,149570753,149732413,dup,HG00277,0,,161660
7,149751144,149824083,dup,HG00479,0,,72939
7,149823077,149846465,dup,NA18968,0,,23388
7,149862878,149883330,dup,HG00551,0,,20452
7,149882283,149938861,dup,HG02681,0,,56578
7,149961203,149992032,dup,HG00096,0,,30829
7,149971419,149984231,dup,HG03652,0,,12812
7,150553512,150575752,dup,HG01086,0,,22240
7,150979201,151073398,dup,NA19307,0,,94197
7,150983862,151025274,dup,NA19307,0,,41412
7,151149962,151170840,dup,HG01119,0,,20878
7,151339830,151346589,dup,HG04206,0,,6759
7,151612672,151624362,dup,HG01190,0,,11690
7,151813927,151930049,dup,HG01813,0,,116122
7,151818885,151903278,dup,HG01813,0,,84393
7,151946734,151971554,dup,HG01813,0,,24820
7,152000274,152053024,dup,HG02337,0,,52750
7,152064321,152251219,dup,HG03882,0,,186898
7,152109162,152268149,dup,HG01679,0,,158987
7,152116568,152144032,dup,HG03882,0,,27464
7,152169419,152189919,dup,HG00290,0,,20500
7,152198152,152221356,dup,HG03882,0,,23204
7,152233438,152250487,dup,HG00693,0,,17049
7,152246780,152264503,dup,HG00693,0,,17723
7,152261511,152277337,dup,HG01362,0,,15826
7,152414851,152467208,dup,HG02360,0,,52357
7,152438278,152459976,dup,HG02360,0,,21698
7,152511400,152546465,dup,HG00096,0,,35065
7,152517386,152582502,dup,HG00851,0,,65116
7,152534693,152573254,dup,HG00851,0,,38561
7,152596322,152618519,dup,HG00419,0,,22197
7,152597688,152618735,dup,HG00419,0,,21047
7,152608925,152770040,dup,HG00851,0,,161115
7,152728778,152900984,dup,HG00851,0,,172206
7,152916486,152947393,dup,HG03452,0,,30907
7,152921272,153080337,dup,HG01459,0,,159065
7,152940600,153062343,dup,HG01459,0,,121743
7,152960832,153455227,dup,HG01459,0,,494395
7,153098879,153245100,dup,HG01459,0,,146221
7,153151310,153209682,dup,NA18870,0,,58372
7,153218599,153282223,dup,HG01459,0,,63624
7,153249574,153401348,dup,HG01459,0,,151774
7,153295440,153301289,dup,HG03224,0,,5849
7,153298990,153356959,dup,HG01459,0,,57969
7,153352227,153380343,dup,HG01459,0,,28116
7,153374581,153402587,dup,HG01459,0,,28006
7,153395321,153410387,dup,HG01459,0,,15066
7,153413949,153482612,dup,HG02681,0,,68663
7,153479955,153702587,dup,HG00479,0,,222632
7,153525743,153627953,dup,HG00277,0,,102210
7,153687939,153707607,dup,HG00277,0,,19668
7,153707779,153732533,dup,HG00277,0,,24754
7,153763164,153784872,dup,HG02481,0,,21708
7,153805338,153937617,dup,HG03652,0,,132279
7,153975785,154002620,dup,HG03965,0,,26835
7,153977803,154029690,dup,HG02953,0,,51887
7,153997275,154040534,dup,HG02953,0,,43259
7,154372177,154414118,dup,NA12829,0,,41941
7,156895491,156913744,dup,NA19213,0,,18253
7,157055225,157067962,dup,HG00629,0,,12737
7,157055407,157068109,dup,HG01841,0,,12702
7,157081210,157196178,dup,HG03132,0,,114968
7,157089785,157112970,dup,HG03132,0,,23185
7,157139774,157168469,dup,HG03132,0,,28695
7,157316727,157334633,dup,HG00631,0,,17906
7,157718524,157722819,dup,HG00524,0,,4295
7,158150532,158190378,dup,HG01612,0,,39846
7,158317822,158530875,dup,HG03706,0,,213053
7,158318028,158330563,dup,HG01771,0,,12535
7,158326696,158373350,dup,HG03706,0,,46654
7,158385624,158415386,dup,HG02420,0,,29762
7,158392523,158416789,dup,HG01182,0,,24266
7,158428062,158498013,dup,HG03706,0,,69951
7,158507992,158530925,dup,HG03706,0,,22933
7,158565492,158615983,dup,HG03851,0,,50491
7,158566838,159040688,dup,HG03851,0,,473850
7,158580189,158588181,dup,NA18498,0,,7992
7,158597150,158644105,dup,HG03851,0,,46955
7,158620044,158727079,dup,HG03851,0,,107035
7,158677391,158698844,dup,HG02694,0,,21453
7,158691564,158713312,dup,HG01620,0,,21748
7,158726781,158814618,dup,HG02694,0,,87837
7,158921322,159042447,dup,HG01435,0,,121125
7,158924088,158990384,dup,HG01435,0,,66296
7,159005329,159040420,dup,HG00475,0,,35091
7,159097343,159119056,dup,HG02026,0,,21713
7,159117307,159122701,dup,HG00101,0,,5394
8,142681429,142681703,del,NA10851,0,,274
8,123995688,123997360,del,HG01342,0,,1672
8,134965110,134965220,del,HG01083,0,,110
8,126284872,126285170,del,NA20289,0,,298
8,117591469,117591764,del,NA18867,0,,295
8,138837274,138842695,del,HG00251,0,,5421
8,126569122,126573963,del,NA19236,0,,4841
8,19533650,19534239,del,NA20517,0,,589
8,16262051,16274684,del,NA19472,0,,12633
8,11871000,12515275,del,HG00566,0,,644275
8,50634979,50639738,del,NA19920,0,,4759
8,42305205,42305754,del,NA19716,0,,549
8,24145308,24151084,del,NA18924,0,,5776
8,47336057,47336724,del,HG01095,0,,667
8,104111770,104115573,del,NA18608,0,,3803
8,29923655,29924292,del,NA20528,0,,637
8,6187595,6190277,del,NA18565,0,,2682
8,15410977,15411074,del,NA12891,0,,97
8,131465704,131470269,del,NA19657,0,,4565
8,92115505,92185627,del,HG00190,0,,70122
8,27005033,27005270,del,NA19819,0,,237
8,66759491,66760347,del,NA12154,0,,856
8,99289210,99291344,del,NA12272,0,,2134
8,37389886,37395587,del,NA19390,0,,5701
8,6790871,6791193,del,HG00472,0,,322
8,35056123,35059284,del,NA18504,0,,3161
8,12781491,12788140,del,NA19474,0,,6649
8,144700484,144714692,del,HG00254,0,,14208
8,16878863,16881480,del,NA07051,0,,2617
8,143825063,143825999,del,HG00118,0,,936
8,100599552,100601935,del,NA18873,0,,2383
8,83005233,83005682,del,HG00473,0,,449
8,42298934,42299581,del,NA19904,0,,647
8,30258373,30259622,del,HG01171,0,,1249
8,2002997,2003138,del,HG00375,0,,141
8,63215349,63225227,del,NA18508,0,,9878
8,39304037,39308277,del,NA19779,0,,4240
8,68156642,68161903,del,HG00537,0,,5261
8,102635654,102635886,del,HG00331,0,,232
8,14038539,14064471,del,NA20504,0,,25932
8,9331957,9343857,del,HG00442,0,,11900
8,30534828,30536581,del,HG00500,0,,1753
8,119688050,119695222,del,NA19373,0,,7172
8,77832807,77835938,del,HG01462,0,,3131
8,109463537,109463903,del,NA19317,0,,366
8,54122551,54123647,del,NA19381,0,,1096
8,17749416,17752422,del,NA19189,0,,3006
8,129859324,129862421,del,NA20515,0,,3097
8,65225611,65227727,del,NA19399,0,,2116
8,108504818,108506363,del,NA18908,0,,1545
8,35308874,35310063,del,HG00620,0,,1189
8,134360000,134360206,del,NA19818,0,,206
8,11826937,11827242,del,HG00537,0,,305
8,129132327,129135063,del,HG00533,0,,2736
8,61245085,61245362,del,NA19819,0,,277
8,16454740,16476082,del,HG00534,0,,21342
8,3996934,4004486,del,NA19467,0,,7552
8,89699016,89704222,del,HG00427,0,,5206
8,47768050,47769813,del,HG01353,0,,1763
8,96390855,96391087,del,HG00133,0,,232
8,25120396,25124399,del,NA19818,0,,4003
8,81871493,81872927,del,NA19701,0,,1434
8,24798816,24801122,del,NA19446,0,,2306
8,76414046,76414151,del,NA19079,0,,105
8,140014070,140014187,del,NA06986,0,,117
8,28455148,28466562,del,HG00325,0,,11414
8,136699712,136708092,del,HG00693,0,,8380
8,66990188,67011544,del,HG00334,0,,21356
8,136002638,136009019,del,HG00260,0,,6381
8,4906326,4914965,del,HG00124,0,,8639
8,57595024,57595826,del,NA18501,0,,802
8,58122640,58126994,del,NA20795,0,,4354
8,112798058,112803238,del,NA19462,0,,5180
8,115151715,115177704,del,HG00116,0,,25989
8,111494204,111499662,del,HG01060,0,,5458
8,95741783,95742015,del,NA19394,0,,232
8,32014816,32016922,del,HG01066,0,,2106
8,132919572,132920466,del,NA19779,0,,894
8,40946414,40946838,del,NA19707,0,,424
8,5439700,5442913,del,NA19334,0,,3213
8,120300236,120300388,del,NA19190,0,,152
8,33231581,33233825,del,NA20589,0,,2244
8,115079315,115080676,del,NA07037,0,,1361
8,51224416,51228122,del,NA18909,0,,3706
8,145912676,145913456,del,HG00268,0,,780
8,80315849,80321867,del,NA19190,0,,6018
8,2250754,2266479,del,NA19435,0,,15725
8,97348246,97351789,del,NA19247,0,,3543
8,74811935,74812043,del,HG00284,0,,108
8,52446022,52448303,del,NA19373,0,,2281
8,71409415,71414337,del,NA18606,0,,4922
8,145005448,145005561,del,HG01366,0,,113
8,38452287,38452468,del,NA19102,0,,181
8,48892716,48896522,del,HG00650,0,,3806
8,70200718,70208290,del,NA19347,0,,7572
8,117241909,117243103,del,NA19443,0,,1194
8,144056454,144056950,del,NA19138,0,,496
8,11184243,11197511,del,NA19247,0,,13268
8,122213436,122213435,del,HG01440,0,,-1
8,87433616,87437322,del,HG01383,0,,3706
8,39769590,39776167,del,HG01170,0,,6577
8,47062975,47068985,del,NA19443,0,,6010
8,86278413,86290930,del,NA18608,0,,12517
8,1631736,1633353,del,NA19901,0,,1617
8,96836348,96836586,del,HG01101,0,,238
8,81991089,81992531,del,HG00472,0,,1442
8,83072572,83072666,del,HG00254,0,,94
8,138143635,138144038,del,NA18553,0,,403
8,50189291,50189556,del,NA19377,0,,265
8,1051637,1051766,del,HG00448,0,,129
8,87187716,87195672,del,NA12761,0,,7956
8,143075987,143076234,del,NA19704,0,,247
8,128716492,128729923,del,HG01357,0,,13431
8,20937779,20938267,del,HG01498,0,,488
8,20056798,20057871,del,NA19429,0,,1073
8,15777383,15787161,del,HG00271,0,,9778
8,111939978,111944183,del,NA19371,0,,4205
8,141289485,141290738,del,NA20819,0,,1253
8,65345099,65349575,del,HG01134,0,,4476
8,92541812,92544455,del,NA20753,0,,2643
8,145525589,145527164,del,NA19067,0,,1575
8,142268665,142269249,del,HG00442,0,,584
8,38113161,38117314,del,HG00252,0,,4153
8,5070985,5076309,del,NA19312,0,,5324
8,131688720,131689047,del,NA19088,0,,327
8,98862065,98863312,del,NA19240,0,,1247
8,51031091,51038329,del,HG00114,0,,7238
8,10075784,10094150,del,HG00437,0,,18366
8,1630734,1632241,del,HG00263,0,,1507
8,77182378,77183652,del,NA19382,0,,1274
8,57386036,57386431,del,NA19384,0,,395
8,24089279,24095465,del,NA18907,0,,6186
8,20943403,20943806,del,NA12400,0,,403
8,144197388,144198001,del,HG01070,0,,613
8,8063916,8087622,del,NA19664,0,,23706
8,4027379,4029264,del,NA19818,0,,1885
8,24974216,24990622,del,NA20294,0,,16406
8,138800900,138802457,del,NA18868,0,,1557
8,123058034,123059865,del,HG00271,0,,1831
8,38953621,38953881,del,HG01052,0,,260
8,134168230,134180481,del,HG01462,0,,12251
8,24593551,24595563,del,NA19437,0,,2012
8,2739874,2740099,del,HG00501,0,,225
8,107857328,107862159,del,NA19114,0,,4831
8,129751225,129764830,del,NA12827,0,,13605
8,42476522,42480003,del,NA19434,0,,3481
8,91225889,91227062,del,HG01377,0,,1173
8,29471179,29472644,del,NA20348,0,,1465
8,1294815,1296137,del,NA11932,0,,1322
8,14588053,14588828,del,NA19382,0,,775
8,62150345,62150487,del,NA18965,0,,142
8,100698571,100701565,del,NA19346,0,,2994
8,17622842,17626014,del,HG01133,0,,3172
8,32152229,32154992,del,HG00693,0,,2763
8,1939695,1942461,del,NA19108,0,,2766
8,143274125,143274289,del,HG00108,0,,164
8,16733739,16737029,del,NA12283,0,,3290
8,60843331,60868436,del,NA20772,0,,25105
8,1788145,1788533,del,NA19467,0,,388
8,38406018,38407664,del,HG00734,0,,1646
8,12427258,12485359,del,HG00334,0,,58101
8,138749630,138751431,del,NA18579,0,,1801
8,107298442,107298711,del,NA19247,0,,269
8,115634116,115644122,del,NA19783,0,,10006
8,101633350,101634857,del,HG00262,0,,1507
8,7153816,7157822,del,NA18517,0,,4006
8,97262527,97262768,del,HG00321,0,,241
8,120019620,120027782,del,NA18523,0,,8162
8,140884608,140884772,del,HG01350,0,,164
8,19114294,19115313,del,NA19920,0,,1019
8,60449926,60454673,del,NA19449,0,,4747
8,91545305,91546011,del,NA19235,0,,706
8,12537143,12557580,del,NA19786,0,,20437
8,3982366,4024185,del,NA18611,0,,41819
8,41865387,41869131,del,HG01072,0,,3744
8,144632316,144635922,del,HG01187,0,,3606
8,13773465,13773897,del,NA18635,0,,432
8,144006607,144012648,del,NA19457,0,,6041
8,60326239,60329511,del,HG00117,0,,3272
8,99283896,99291183,del,NA12272,0,,7287
8,11228359,11229272,del,NA20281,0,,913
8,18850881,18865272,del,HG00142,0,,14391
8,95213427,95215883,del,NA18606,0,,2456
8,70334171,70334976,del,NA19908,0,,805
8,104906381,104912697,del,NA18873,0,,6316
8,15142499,15143896,del,NA19312,0,,1397
8,143397458,143398728,del,HG00375,0,,1270
8,7799116,7870622,del,HG00690,0,,71506
8,56988745,56989825,del,NA19397,0,,1080
8,95638460,95639798,del,NA19247,0,,1338
8,15286822,15289167,del,NA19469,0,,2345
8,33730689,33731517,del,NA20509,0,,828
8,121872604,121874417,del,NA19448,0,,1813
8,110707023,110763641,del,HG00367,0,,56618
8,81251892,81252492,del,NA19445,0,,600
8,290884,291479,del,HG01133,0,,595
8,128001189,128001865,del,NA20502,0,,676
8,16800729,16804184,del,HG00189,0,,3455
8,11895516,11973422,del,NA18612,0,,77906
8,106703448,106703774,del,NA12383,0,,326
8,19885073,19893931,del,HG00650,0,,8858
8,82378453,82382488,del,NA19700,0,,4035
8,64017435,64018231,del,HG01190,0,,796
8,1563684,1563874,del,NA18536,0,,190
8,134879779,135664603,del,HG00134,0,,784824
8,62897194,62900227,del,NA19010,0,,3033
8,33158780,33160376,del,NA19394,0,,1596
8,8997885,8998112,del,NA20278,0,,227
8,114310886,114324605,del,HG00581,0,,13719
8,130141031,130145194,del,NA18910,0,,4163
8,83709973,83710095,del,HG01082,0,,122
8,49093385,49093978,del,HG01107,0,,593
8,21210549,21210989,del,NA18868,0,,440
8,790407,790725,del,NA19129,0,,318
8,98119776,98120097,del,HG01440,0,,321
8,143164087,143164607,del,NA19172,0,,520
8,93352154,93352320,del,HG01124,0,,166
8,126569161,126573650,del,NA19236,0,,4489
8,115997805,115998366,del,HG00671,0,,561
8,1205527,1205681,del,HG01350,0,,154
8,1867165,1868198,del,NA19311,0,,1033
8,125495073,125497522,del,NA19444,0,,2449
8,56376731,56392656,del,HG00148,0,,15925
8,72747965,72749425,del,NA19075,0,,1460
8,5623095,5623391,del,HG00472,0,,296
8,133060637,133061580,del,NA18520,0,,943
8,6745206,6754924,del,NA19474,0,,9718
8,100636920,100640241,del,NA19007,0,,3321
8,86084377,86088248,del,NA19452,0,,3871
8,144386313,144388227,del,NA19383,0,,1914
8,23929925,23937171,del,NA19376,0,,7246
8,39511653,39512031,del,NA19171,0,,378
8,4218248,4219286,del,HG01082,0,,1038
8,8836437,8837086,del,NA19920,0,,649
8,140257341,140259185,del,NA19471,0,,1844
8,103830313,103835571,del,HG00689,0,,5258
8,30766641,30768362,del,NA19904,0,,1721
8,67042735,67045206,del,NA19065,0,,2471
8,46841333,46848789,del,HG00276,0,,7456
8,28785275,28789680,del,NA19399,0,,4405
8,1298776,1300492,del,NA19054,0,,1716
8,102017186,102017371,del,HG00318,0,,185
8,120306627,120321371,del,NA18999,0,,14744
8,8634152,8637741,del,NA19920,0,,3589
8,30595905,30596789,del,NA19009,0,,884
8,62676687,62676840,del,NA18861,0,,153
8,5410426,5411400,del,NA19108,0,,974
8,88267784,88272951,del,HG01168,0,,5167
8,143337689,144016829,del,NA18907,0,,679140
8,69097918,69098337,del,NA19397,0,,419
8,59651299,59652430,del,NA19701,0,,1131
8,9628876,9628967,del,HG00313,0,,91
8,51374713,51375031,del,HG00421,0,,318
8,124767728,124774635,del,NA18622,0,,6907
8,48180916,48214122,del,HG01455,0,,33206
8,2430855,2434796,del,HG00148,0,,3941
8,103397111,103406866,del,HG00637,0,,9755
8,5802929,5819647,del,NA18602,0,,16718
8,36434911,36438581,del,NA18546,0,,3670
8,2003083,2003249,del,NA20336,0,,166
8,106247753,106248023,del,NA18486,0,,270
8,2122082,2122346,del,NA19403,0,,264
8,97520666,97521772,del,NA07056,0,,1106
8,99465140,99465468,del,NA19083,0,,328
8,40919662,40923693,del,HG00273,0,,4031
8,89759497,89759760,del,HG01462,0,,263
8,30472424,30481489,del,NA19213,0,,9065
8,13599229,13609207,del,NA19376,0,,9978
8,42210873,42212803,del,NA20512,0,,1930
8,8063316,8085122,del,NA18959,0,,21806
8,11218484,11222076,del,HG00404,0,,3592
8,127192205,127194571,del,NA19137,0,,2366
8,60401493,60401987,del,NA07051,0,,494
8,14452018,14452620,del,NA19904,0,,602
8,94657720,94659343,del,NA18542,0,,1623
8,16262216,16273022,del,NA19347,0,,10806
8,144096935,144097063,del,HG00581,0,,128
8,42455595,42455954,del,NA18498,0,,359
8,82044316,82046472,del,NA12489,0,,2156
8,119421984,119422229,del,NA18613,0,,245
8,19299043,19301996,del,NA19313,0,,2953
8,11774552,11774717,del,HG01356,0,,165
8,50529007,50534562,del,HG01102,0,,5555
8,140689867,140690265,del,NA19197,0,,398
8,125747389,125748835,del,NA19436,0,,1446
8,124415814,124416944,del,HG00323,0,,1130
8,42585910,42586256,del,NA12889,0,,346
8,15231349,15231736,del,HG01188,0,,387
8,137965805,137965918,del,HG00628,0,,113
8,5562098,5591324,del,HG00178,0,,29226
8,53895696,53897180,del,NA19660,0,,1484
8,51217693,51219001,del,NA07051,0,,1308
8,56676277,56676407,del,NA12717,0,,130
8,70357613,70357926,del,HG00328,0,,313
8,78831599,78840320,del,NA18502,0,,8721
8,58357093,58368503,del,HG01108,0,,11410
8,535087,536507,del,HG00625,0,,1420
8,94618757,94619086,del,NA18549,0,,329
8,144066833,144068342,del,NA19347,0,,1509
8,39231616,39386822,del,HG00672,0,,155206
8,112995659,112995892,del,HG00475,0,,233
8,6790870,6798039,del,NA19373,0,,7169
8,71583555,71584643,del,HG01079,0,,1088
8,18129482,18130847,del,NA19056,0,,1365
8,8063916,8086722,del,HG00327,0,,22806
8,141499061,141499360,del,NA18909,0,,299
8,111560053,111573059,del,NA19835,0,,13006
8,74833763,74837462,del,NA20818,0,,3699
8,66775709,66776778,del,HG00148,0,,1069
8,1519875,1520314,del,NA19985,0,,439
8,103120221,103120950,del,NA20752,0,,729
8,75112425,75113733,del,NA18555,0,,1308
8,68478174,68478411,del,NA10851,0,,237
8,95558182,95561003,del,NA18867,0,,2821
8,143707560,143707897,del,HG00237,0,,337
8,28091154,28105251,del,HG00443,0,,14097
8,40469734,40470383,del,NA12827,0,,649
8,1156309,1156441,del,NA19785,0,,132
8,145719938,145721066,del,NA19074,0,,1128
8,13901712,13901912,del,NA18546,0,,200
8,78125109,78126242,del,NA12749,0,,1133
8,144709805,144710234,del,NA19390,0,,429
8,71656992,71657460,del,NA19701,0,,468
8,140885166,140885422,del,HG00233,0,,256
8,117399872,117399921,del,HG00335,0,,49
8,120154542,120161215,del,NA19788,0,,6673
8,129007055,129008264,del,NA18965,0,,1209
8,57490323,57491979,del,NA19909,0,,1656
8,37552116,37554822,del,HG00335,0,,2706
8,75311432,75330080,del,NA19093,0,,18648
8,63846745,63851162,del,NA20342,0,,4417
8,139910574,139912355,del,NA18603,0,,1781
8,62512859,62515432,del,NA19355,0,,2573
8,16797394,16799727,del,NA19373,0,,2333
8,9358681,9362341,del,HG00310,0,,3660
8,30596303,30596891,del,HG00140,0,,588
8,47391414,47404056,del,NA19066,0,,12642
8,16992822,16998015,del,HG01354,0,,5193
8,123536509,123544462,del,NA18510,0,,7953
8,32242473,32248073,del,NA18959,0,,5600
8,11492334,11494873,del,NA19346,0,,2539
8,101793802,101795418,del,NA20790,0,,1616
8,25550480,25551552,del,NA19235,0,,1072
8,35633294,35643002,del,HG00475,0,,9708
8,109276934,109284582,del,HG00731,0,,7648
8,104408694,104411969,del,NA19717,0,,3275
8,95725167,95728224,del,NA20759,0,,3057
8,15742753,15745570,del,HG00578,0,,2817
8,2149114,2149599,del,HG00536,0,,485
8,134629660,134631567,del,NA12718,0,,1907
8,34554575,34556460,del,HG00421,0,,1885
8,1137814,1138210,del,HG00672,0,,396
8,1836213,1836822,del,NA19002,0,,609
8,3581600,3581655,del,HG00319,0,,55
8,83224580,83225254,del,NA20785,0,,674
8,39232066,39387022,del,NA20818,0,,154956
8,92762505,92763694,del,NA19338,0,,1189
8,71719882,71722872,del,NA18614,0,,2990
8,12893016,12893222,del,NA18530,0,,206
8,127533017,127533733,del,HG01356,0,,716
8,20081819,20083014,del,NA19213,0,,1195
8,56083982,56093142,del,HG00684,0,,9160
8,35104816,35107322,del,HG00328,0,,2506
8,11787496,11892545,del,HG00378,0,,105049
8,57779821,57779928,del,NA19779,0,,107
8,28621813,28623012,del,NA19776,0,,1199
8,136621798,136627594,del,NA18868,0,,5796
8,104014167,104014513,del,NA19404,0,,346
8,65112839,65119978,del,NA11994,0,,7139
8,39832739,39833395,del,NA19920,0,,656
8,48818951,48819928,del,HG01080,0,,977
8,79851267,79863393,del,HG00650,0,,12126
8,52520170,52521173,del,HG01465,0,,1003
8,99079904,99081600,del,NA18553,0,,1696
8,84959372,84959555,del,NA18973,0,,183
8,114934392,114934682,del,NA20797,0,,290
8,16201310,16207533,del,HG00608,0,,6223
8,135059598,135068083,del,NA18977,0,,8485
8,107055451,107055637,del,NA18517,0,,186
8,22870571,22871145,del,NA19379,0,,574
8,16321243,16326591,del,NA19099,0,,5348
8,36273625,36279616,del,NA12763,0,,5991
8,89926775,89929921,del,NA19685,0,,3146
8,143259987,143261446,del,NA18522,0,,1459
8,60644924,60652528,del,HG00634,0,,7604
8,139531089,139533773,del,NA18572,0,,2684
8,1296434,1296632,del,NA20299,0,,198
8,142635277,142639175,del,HG01389,0,,3898
8,3581716,3581522,del,HG00328,0,,-194
8,68218090,68244541,del,NA12399,0,,26451
8,11895516,11904422,del,HG00683,0,,8906
8,6991662,6995402,del,NA18637,0,,3740
8,19055258,19055530,del,NA18975,0,,272
8,70906912,70907356,del,NA19318,0,,444
8,146171939,146172651,del,NA19055,0,,712
8,145573887,145579873,del,HG00152,0,,5986
8,2251326,2267068,del,NA19469,0,,15742
8,69417667,69417989,del,HG00419,0,,322
8,103053958,103056716,del,NA19685,0,,2758
8,58292332,58299593,del,HG00318,0,,7261
8,40567437,40569125,del,HG01167,0,,1688
8,120323865,120328354,del,NA19435,0,,4489
8,36273634,36279607,del,NA12044,0,,5973
8,12427313,12485414,del,HG01351,0,,58101
8,17750926,17752416,del,NA19056,0,,1490
8,61204986,61205303,del,NA18520,0,,317
8,8583056,8589030,del,NA10851,0,,5974
8,88867963,88869437,del,NA19453,0,,1474
8,6230027,6230878,del,NA18934,0,,851
8,126305707,126305910,del,NA18907,0,,203
8,79021628,79022069,del,NA19469,0,,441
8,128702902,128703623,del,NA18874,0,,721
8,118873738,118875593,del,HG00183,0,,1855
8,74419347,74419685,del,HG00366,0,,338
8,130435189,130442878,del,NA19901,0,,7689
8,68351687,68352527,del,NA18563,0,,840
8,39141084,39157463,del,HG00273,0,,16379
8,125279967,125280235,del,NA18912,0,,268
8,43662148,43666819,del,NA19711,0,,4671
8,120019620,120027776,del,NA19239,0,,8156
8,111614843,111620761,del,NA19707,0,,5918
8,14833116,14833772,del,HG00589,0,,656
8,19786158,19792315,del,NA18582,0,,6157
8,100605874,100607843,del,NA19916,0,,1969
8,4050908,4052536,del,NA18516,0,,1628
8,67120747,67121715,del,HG00108,0,,968
8,141852060,141853580,del,HG00268,0,,1520
8,36517486,36519307,del,HG00464,0,,1821
8,82596266,82598172,del,HG00428,0,,1906
8,21729848,21731840,del,NA19380,0,,1992
8,140161364,140161557,del,NA18595,0,,193
8,9358733,9359418,del,NA19909,0,,685
8,67126897,67129585,del,HG01198,0,,2688
8,39632535,39643436,del,NA18597,0,,10901
8,96854583,96857495,del,NA18870,0,,2912
8,87099724,87100811,del,NA19439,0,,1087
8,47334303,47335893,del,HG00148,0,,1590
8,9054974,9062720,del,NA19684,0,,7746
8,23898463,23898598,del,NA19920,0,,135
8,16455128,16530975,del,HG00578,0,,75847
8,115865063,115867498,del,NA20536,0,,2435
8,135477021,135478027,del,NA19455,0,,1006
8,40250581,40255144,del,NA19777,0,,4563
8,63215316,63226522,del,NA18923,0,,11206
8,3994936,3995264,del,NA20278,0,,328
8,30603940,30605548,del,HG00740,0,,1608
8,131519149,131521893,del,NA19085,0,,2744
8,60642197,60685813,del,NA18628,0,,43616
8,12541181,12560092,del,HG00705,0,,18911
8,6708386,6708709,del,HG00272,0,,323
8,13649011,13719707,del,HG00156,0,,70696
8,46889847,46899289,del,NA18536,0,,9442
8,144634064,144636239,del,NA18562,0,,2175
8,66091792,66094654,del,NA18910,0,,2862
8,38211049,38213233,del,NA18910,0,,2184
8,128066147,128076871,del,NA19390,0,,10724
8,4222049,4222389,del,NA18871,0,,340
8,20560176,20582879,del,HG00692,0,,22703
8,324880,325829,del,NA18868,0,,949
8,10291566,10292936,del,NA19443,0,,1370
8,324916,325758,del,HG01461,0,,842
8,25068221,25079350,del,NA19213,0,,11129
8,11736679,11738960,del,HG01048,0,,2281
8,34472532,34473149,del,NA19315,0,,617
8,53739396,53740930,del,NA20344,0,,1534
8,29818284,29818407,del,HG01334,0,,123
8,91201442,91202668,del,NA19473,0,,1226
8,109683001,109683584,del,NA07000,0,,583
8,1836480,1837038,del,NA19818,0,,558
8,29462471,29462545,del,NA19102,0,,74
8,18042477,18044459,del,NA18530,0,,1982
8,42569470,42573613,del,NA19428,0,,4143
8,33418186,33420174,del,HG00270,0,,1988
8,144301989,144302153,del,HG00422,0,,164
8,111029888,111031833,del,NA19338,0,,1945
8,48290714,48291684,del,NA18487,0,,970
8,3367626,3369256,del,NA18870,0,,1630
8,1232183,1232273,del,NA19190,0,,90
8,23949908,23963646,del,HG00251,0,,13738
8,21017581,21017844,del,NA19660,0,,263
8,84035309,84036861,del,NA18963,0,,1552
8,138822753,138825739,del,HG01137,0,,2986
8,51402351,51405314,del,HG00671,0,,2963
8,49391272,49393813,del,NA19457,0,,2541
8,11787793,11892842,del,NA19657,0,,105049
8,141344510,141347962,del,NA19359,0,,3452
8,893547,893705,del,HG00475,0,,158
8,24972432,24990943,del,HG01354,0,,18511
8,72563684,72566498,del,NA18536,0,,2814
8,34422466,34426572,del,NA19007,0,,4106
8,114141314,114151600,del,NA19700,0,,10286
8,140759830,140760659,del,NA19434,0,,829
8,108781412,108782421,del,NA18530,0,,1009
8,88423516,88423822,del,HG01075,0,,306
8,11767459,11792351,del,NA20756,0,,24892
8,125224206,125224336,del,HG00237,0,,130
8,47021618,47024144,del,NA20778,0,,2526
8,25410674,25416635,del,NA19452,0,,5961
8,28344005,28345040,del,HG00114,0,,1035
8,39232074,39387228,del,HG01204,0,,155154
8,52143840,52143970,del,HG00740,0,,130
8,28769072,28771577,del,HG00436,0,,2505
8,49655147,49667274,del,HG01140,0,,12127
8,915340,915513,del,HG00250,0,,173
8,145782011,145783021,del,HG00443,0,,1010
8,107783272,107787936,del,HG00274,0,,4664
8,83359444,83363609,del,NA19901,0,,4165
8,133578910,133579355,del,NA18520,0,,445
8,103994768,103996595,del,HG01190,0,,1827
8,84897933,84898499,del,NA20527,0,,566
8,145864938,145869106,del,NA19703,0,,4168
8,34836287,34854746,del,HG01390,0,,18459
8,10085608,10087259,del,NA19072,0,,1651
8,17364205,17364391,del,HG00641,0,,186
8,127220156,127225177,del,HG01171,0,,5021
8,5163962,5167802,del,NA19461,0,,3840
8,80869822,80870856,del,NA19056,0,,1034
8,98808606,98809841,del,NA20582,0,,1235
8,58110318,58113293,del,NA19190,0,,2975
8,137680282,137862378,del,HG01350,0,,182096
8,2078104,2078363,del,NA20287,0,,259
8,130113679,130132801,del,HG00650,0,,19122
8,103441466,103441875,del,NA18630,0,,409
8,107234215,107235974,del,NA19473,0,,1759
8,112501962,112506673,del,NA19446,0,,4711
8,145828132,145828432,del,NA07347,0,,300
8,13331088,13332629,del,NA19700,0,,1541
8,75245394,75255355,del,NA19225,0,,9961
8,39684838,39694957,del,NA19391,0,,10119
8,68546238,68553684,del,NA19444,0,,7446
8,96079402,96082179,del,NA19471,0,,2777
8,11767481,11792373,del,NA19474,0,,24892
8,10987196,10992602,del,NA19448,0,,5406
8,57918313,57930273,del,HG00274,0,,11960
8,54971849,54972163,del,NA19328,0,,314
8,71451624,71452491,del,NA18522,0,,867
8,123048406,123048736,del,NA20754,0,,330
8,40224645,40225645,del,NA20810,0,,1000
8,97514680,97514786,del,HG00331,0,,106
8,143303520,143303715,del,HG01083,0,,195
8,579622,580301,del,NA19429,0,,679
8,2138576,2160302,del,HG00271,0,,21726
8,23679094,23682741,del,NA19661,0,,3647
8,1798149,1798458,del,HG00336,0,,309
8,34022524,34022805,del,HG01437,0,,281
8,4131926,4139688,del,HG00310,0,,7762
8,26792700,26803709,del,HG00448,0,,11009
8,62732324,62735805,del,HG00692,0,,3481
8,6022640,6036147,del,NA18982,0,,13507
8,115740645,115740808,del,HG00536,0,,163
8,101979886,101997948,del,NA19107,0,,18062
8,60996549,61007774,del,NA18487,0,,11225
8,25630981,25631094,del,NA20512,0,,113
8,73426075,73426168,del,HG00672,0,,93
8,2150546,2161598,del,HG00592,0,,11052
8,136966774,136967721,del,HG01167,0,,947
8,4904334,4906496,del,HG00607,0,,2162
8,106796716,106797172,del,NA20346,0,,456
8,9663848,9669865,del,NA18574,0,,6017
8,8286301,8290830,del,HG00268,0,,4529
8,1451442,1452375,del,NA19819,0,,933
8,129762519,129766026,del,NA12778,0,,3507
8,139426071,139432707,del,HG00734,0,,6636
8,109252325,109254001,del,NA18519,0,,1676
8,53700964,53701633,del,NA20798,0,,669
8,50339347,50347791,del,NA20503,0,,8444
8,65334685,65335185,del,NA19093,0,,500
8,134772000,134772568,del,NA20322,0,,568
8,126766007,126766894,del,HG01171,0,,887
8,123113511,123115071,del,NA19453,0,,1560
8,127469461,127476187,del,NA19717,0,,6726
8,56988705,56997914,del,NA19818,0,,9209
8,1835926,1838288,del,NA19065,0,,2362
8,42920642,42921654,del,NA19985,0,,1012
8,143215008,143215150,del,HG01048,0,,142
8,28923607,28924216,del,NA18523,0,,609
8,103396980,103406734,del,HG00637,0,,9754
8,15945388,16023866,del,HG00337,0,,78478
8,74898847,74904171,del,NA19471,0,,5324
8,51033516,51038122,del,NA20508,0,,4606
8,50220147,50221310,del,HG00740,0,,1163
8,27684045,27684331,del,HG00620,0,,286
8,99067214,99076148,del,NA19107,0,,8934
8,33158416,33160172,del,NA19908,0,,1756
8,47199508,47202871,del,NA19190,0,,3363
8,122030408,122033137,del,NA11893,0,,2729
8,42572246,42584253,del,HG00252,0,,12007
8,11699423,11701343,del,NA19384,0,,1920
8,3783891,3785147,del,NA12272,0,,1256
8,128946953,128947957,del,NA19914,0,,1004
8,64144864,64145115,del,NA18973,0,,251
8,111938016,111943472,del,NA19371,0,,5456
8,144510716,144513322,del,NA19383,0,,2606
8,108135016,108136599,del,NA18486,0,,1583
8,76902237,76909859,del,HG00512,0,,7622
8,28238804,28246288,del,NA19661,0,,7484
8,1205314,1205763,del,NA19394,0,,449
8,3912979,3921356,del,NA11893,0,,8377
8,143582851,143583230,del,NA18523,0,,379
8,18203040,18208095,del,HG01359,0,,5055
8,30448481,30451272,del,NA18867,0,,2791
8,120323910,120328417,del,HG01101,0,,4507
8,40289687,40296197,del,NA19707,0,,6510
8,138084037,138099266,del,NA19396,0,,15229
8,101376676,101377635,del,NA20803,0,,959
8,32786069,32789168,del,HG01198,0,,3099
8,94073366,94077072,del,NA20348,0,,3706
8,6280450,6280792,del,NA19398,0,,342
8,30596329,30596920,del,NA19081,0,,591
8,97520705,97521915,del,NA20769,0,,1210
8,120645678,120646195,del,NA19982,0,,517
8,1321025,1327148,del,NA19002,0,,6123
8,56658598,56658734,del,NA18542,0,,136
8,56107697,56108054,del,NA19066,0,,357
8,127401172,127404940,del,NA18517,0,,3768
8,15210416,15211372,del,NA18548,0,,956
8,24115435,24118534,del,NA19397,0,,3099
8,104758509,104764131,del,NA19118,0,,5622
8,29282120,29286419,del,NA12718,0,,4299
8,120108663,120111890,del,HG00640,0,,3227
8,142498042,142498162,del,HG00473,0,,120
8,119007847,119012539,del,NA20768,0,,4692
8,63494376,63494535,del,NA19725,0,,159
8,42190431,42194394,del,HG00188,0,,3963
8,62930143,62930455,del,NA19204,0,,312
8,30808505,30808785,del,NA19401,0,,280
8,20597299,20600778,del,HG00313,0,,3479
8,140123966,140127053,del,NA20790,0,,3087
8,103570932,103572521,del,NA19396,0,,1589
8,47854479,47859032,del,NA19072,0,,4553
8,2322141,2322250,del,HG01171,0,,109
8,107087471,107090796,del,HG00250,0,,3325
8,143204045,143204250,del,HG00281,0,,205
8,10465329,10466031,del,NA18535,0,,702
8,146167795,146169460,del,NA20543,0,,1665
8,137319207,137320175,del,NA20582,0,,968
8,15392010,15396483,del,HG00513,0,,4473
8,8581340,8581568,del,HG01073,0,,228
8,144056584,144057158,del,NA18965,0,,574
8,98562324,98567274,del,HG00672,0,,4950
8,128268006,128271652,del,HG01334,0,,3646
8,79545315,79548489,del,NA19385,0,,3174
8,16545407,16545732,del,NA19225,0,,325
8,47372547,47377815,del,HG01170,0,,5268
8,28463602,28464277,del,NA18522,0,,675
8,146293552,146294114,del,HG01342,0,,562
8,39413517,39414124,del,NA19453,0,,607
8,92093298,92093894,del,NA20544,0,,596
8,25038916,25041407,del,NA19328,0,,2491
8,125369276,125377174,del,NA18988,0,,7898
8,125492366,125495672,del,NA18597,0,,3306
8,22202932,22205568,del,NA20760,0,,2636
8,84568960,84570744,del,NA19703,0,,1784
8,108599376,108600137,del,HG00125,0,,761
8,1305160,1307080,del,HG00159,0,,1920
8,37867967,37872476,del,HG00684,0,,4509
8,144187778,144209150,del,HG01124,0,,21372
8,35732304,35732450,del,NA19384,0,,146
8,1611023,1611254,del,NA18486,0,,231
8,71623976,71624054,del,NA19083,0,,78
8,33501572,33530485,del,HG01061,0,,28913
8,131850916,131853022,del,NA18593,0,,2106
8,12993654,13004295,del,NA18606,0,,10641
8,143158452,143159392,del,NA18617,0,,940
8,99256566,99256922,del,NA19453,0,,356
8,26883019,26883850,del,HG00553,0,,831
8,138821266,138824772,del,NA12413,0,,3506
8,109632500,109633965,del,NA19060,0,,1465
8,88214903,88221219,del,NA19213,0,,6316
8,86342952,86349008,del,NA18565,0,,6056
8,65063400,65063492,del,HG00108,0,,92
8,85736679,85740260,del,NA19235,0,,3581
8,16531510,16805364,del,HG01124,0,,273854
8,116880329,116880684,del,NA19448,0,,355
8,94072327,94077211,del,HG00403,0,,4884
8,89098177,89100254,del,NA19347,0,,2077
8,55617713,55622075,del,HG00160,0,,4362
8,76278892,76288719,del,NA18873,0,,9827
8,4318583,4319108,del,NA18507,0,,525
8,117973604,117975183,del,HG00189,0,,1579
8,120155816,120161072,del,HG00273,0,,5256
8,12467116,12469022,del,HG00578,0,,1906
8,69488482,69488905,del,NA19138,0,,423
8,145826384,145826499,del,HG00139,0,,115
8,70897545,70898101,del,HG00187,0,,556
8,72532246,72533704,del,NA18951,0,,1458
8,116912233,116913743,del,NA18545,0,,1510
8,36369986,36371862,del,NA18907,0,,1876
8,579804,581009,del,NA06986,0,,1205
8,97427069,97430528,del,NA12272,0,,3459
8,17480571,17481632,del,NA18999,0,,1061
8,92187079,92190677,del,NA19375,0,,3598
8,5352877,5353435,del,NA19403,0,,558
8,10176760,10206513,del,HG00614,0,,29753
8,141916778,141920479,del,HG01359,0,,3701
8,11787687,11892739,del,NA18634,0,,105052
8,106579650,106580624,del,NA19225,0,,974
8,453856,454016,del,HG00111,0,,160
8,145181899,145182647,del,NA19471,0,,748
8,74593861,74598176,del,HG01176,0,,4315
8,95646975,95648922,del,NA19350,0,,1947
8,82045018,82046198,del,NA20819,0,,1180
8,34327267,34328892,del,NA20581,0,,1625
8,2778563,2778787,del,HG01101,0,,224
8,131597079,131602154,del,HG01342,0,,5075
8,43789403,43790427,del,HG00154,0,,1024
8,94072816,94078222,del,NA18985,0,,5406
8,144117952,144122016,del,NA19920,0,,4064
8,6230002,6231036,del,NA19130,0,,1034
8,4122884,4124972,del,HG00501,0,,2088
8,59421856,59424426,del,NA18516,0,,2570
8,108579516,108579606,del,NA19257,0,,90
8,21210046,21210313,del,NA12144,0,,267
8,117452122,117454366,del,NA19904,0,,2244
8,60829771,60834316,del,NA18616,0,,4545
8,126631686,126631888,del,NA19834,0,,202
8,19587311,19591034,del,NA07051,0,,3723
8,126108929,126112837,del,HG00553,0,,3908
8,139425925,139432602,del,HG01191,0,,6677
8,132482148,132482310,del,HG01067,0,,162
8,114056492,114058772,del,NA12489,0,,2280
8,124017405,124018930,del,NA19701,0,,1525
8,142927592,142934269,del,NA18595,0,,6677
8,6648210,6648317,del,HG00589,0,,107
8,68156416,68161822,del,NA20282,0,,5406
8,54954452,54954946,del,HG01133,0,,494
8,11875110,12461417,del,NA19734,0,,586307
8,127277252,127279620,del,HG00403,0,,2368
8,16280996,16283229,del,NA20502,0,,2233
8,97077945,97079998,del,NA19462,0,,2053
8,26796367,26919273,del,HG00160,0,,122906
8,5595516,5605779,del,NA20760,0,,10263
8,9331848,9332980,del,NA19003,0,,1132
8,109532692,109535493,del,NA19437,0,,2801
8,37935109,37938268,del,NA19056,0,,3159
8,118005402,118008174,del,NA19473,0,,2772
8,91776509,91777959,del,NA11893,0,,1450
8,146287913,146296604,del,NA19469,0,,8691
8,67595319,67599105,del,NA19657,0,,3786
8,64697546,64699298,del,NA20803,0,,1752
8,594397,599414,del,NA19055,0,,5017
8,89248981,89249106,del,HG00448,0,,125
8,20378836,20378965,del,NA18632,0,,129
8,30535616,30536022,del,HG00533,0,,406
8,5728020,5729353,del,NA18989,0,,1333
8,2887152,2891216,del,NA20530,0,,4064
8,126453441,126453749,del,HG00123,0,,308
8,53811907,53814174,del,NA20533,0,,2267
8,137694246,137705698,del,NA18907,0,,11452
8,3415554,3415995,del,NA19114,0,,441
8,144435924,144436673,del,NA19223,0,,749
8,106053329,106060828,del,HG00159,0,,7499
8,9729696,9731208,del,NA18563,0,,1512
8,141477673,141479706,del,HG00537,0,,2033
8,90713640,90713970,del,NA19190,0,,330
8,145717969,145721070,del,NA12283,0,,3101
8,72214745,72217808,del,NA20524,0,,3063
8,88522801,88529049,del,NA19908,0,,6248
8,74345464,74348845,del,NA19223,0,,3381
8,3786013,3790747,del,NA18511,0,,4734
8,110072230,110074097,del,NA19440,0,,1867
8,6230028,6231044,del,HG01083,0,,1016
8,22914565,22914968,del,NA19313,0,,403
8,43416476,43418547,del,HG00443,0,,2071
8,28736767,28737664,del,HG00328,0,,897
8,114862620,114862753,del,HG00580,0,,133
8,8065516,8085122,del,HG00427,0,,19606
8,26879406,26880929,del,HG01173,0,,1523
8,97520760,97521850,del,NA19130,0,,1090
8,128248276,128250068,del,NA18523,0,,1792
8,1836466,1837722,del,NA19225,0,,1256
8,29450043,29451285,del,NA18909,0,,1242
8,21329785,21336392,del,NA19238,0,,6607
8,146221208,146238447,del,HG01375,0,,17239
8,15496463,15496754,del,NA18990,0,,291
8,59433527,59434013,del,NA19901,0,,486
8,4510403,4514184,del,NA19399,0,,3781
8,63961086,63965893,del,NA19455,0,,4807
8,115633901,115645898,del,NA19318,0,,11997
8,86520645,86521943,del,NA19467,0,,1298
8,115634116,115643522,del,NA18945,0,,9406
8,61857864,61869741,del,HG01359,0,,11877
8,107408556,107411167,del,NA19360,0,,2611
8,122519232,122524510,del,NA19439,0,,5278
8,145865022,145869205,del,NA19703,0,,4183
8,15219341,15219428,del,NA12891,0,,87
8,16824871,16825039,del,HG00320,0,,168
8,40808079,40812518,del,NA18560,0,,4439
8,138200162,138200407,del,HG01437,0,,245
8,55488634,55489611,del,HG01134,0,,977
8,134329444,134329766,del,HG00342,0,,322
8,63904462,63905392,del,NA18923,0,,930
8,24442378,24447067,del,NA19467,0,,4689
8,27427267,27427716,del,HG00422,0,,449
8,48428575,48431401,del,NA19078,0,,2826
8,64154439,64156009,del,HG00525,0,,1570
8,25764167,25764820,del,HG00277,0,,653
8,89592388,89593209,del,HG00637,0,,821
8,76379906,76380811,del,HG01389,0,,905
8,126336792,126337114,del,HG00160,0,,322
8,75313316,75329822,del,NA19399,0,,16506
8,15723508,15752572,del,NA18541,0,,29064
8,139704039,139704357,del,NA20521,0,,318
8,52254672,52260675,del,NA19904,0,,6003
8,1431637,1431780,del,NA19093,0,,143
8,61945872,61946021,del,HG01521,0,,149
8,104408494,104410889,del,NA18499,0,,2395
8,113078610,113089330,del,NA19159,0,,10720
8,111247867,111256263,del,NA19782,0,,8396
8,12202716,12251022,del,HG01519,0,,48306
8,35105416,35107322,del,HG00578,0,,1906
8,112294051,112297139,del,NA19398,0,,3088
8,19980262,19980577,del,NA20344,0,,315
8,65980868,65982580,del,NA19075,0,,1712
8,1390330,1390551,del,HG00327,0,,221
8,141040483,141042880,del,NA19074,0,,2397
8,75180308,75181299,del,NA19908,0,,991
8,40774622,40779778,del,NA20342,0,,5156
8,29742295,29745247,del,NA19834,0,,2952
8,53016540,53018629,del,NA19685,0,,2089
8,1205839,1206012,del,NA19381,0,,173
8,127712670,127719054,del,NA12761,0,,6384
8,24322333,24322392,del,HG00284,0,,59
8,133764949,133765557,del,NA19397,0,,608
8,21170892,21171696,del,NA19393,0,,804
8,1836337,1837920,del,NA19818,0,,1583
8,24206871,24207567,del,NA18571,0,,696
8,50009190,50009334,del,HG00137,0,,144
8,1047077,1047859,del,HG01174,0,,782
8,135409086,135410754,del,NA19443,0,,1668
8,58199364,58200203,del,NA19311,0,,839
8,145845611,145845851,del,HG00273,0,,240
8,64627865,64641433,del,NA18634,0,,13568
8,30711701,30714387,del,HG01173,0,,2686
8,11787003,11892052,del,NA18541,0,,105049
8,80434559,80444569,del,HG01095,0,,10010
8,131004169,131007174,del,NA18579,0,,3005
8,58071891,58077305,del,HG00270,0,,5414
8,48514079,48518748,del,HG00684,0,,4669
8,4452002,4463653,del,NA20795,0,,11651
8,88243078,88246343,del,NA18951,0,,3265
8,114912821,114913530,del,NA18577,0,,709
8,70319887,70325190,del,HG00264,0,,5303
8,57300201,57300318,del,NA19371,0,,117
8,62107443,62112665,del,NA19360,0,,5222
8,143397458,143398512,del,HG01073,0,,1054
8,144531970,144534818,del,HG00237,0,,2848
8,143960068,143998088,del,HG01048,0,,38020
8,47391451,47405758,del,NA19077,0,,14307
8,65813281,65813457,del,HG00246,0,,176
8,36075142,36079600,del,HG01191,0,,4458
8,55208971,55211121,del,NA19359,0,,2150
8,125145061,125146911,del,NA11992,0,,1850
8,140480275,140480935,del,NA18907,0,,660
8,125493016,125497139,del,NA19070,0,,4123
8,2124528,2126268,del,NA11930,0,,1740
8,83043728,83044658,del,NA19338,0,,930
8,14506984,14515234,del,NA19098,0,,8250
8,68299441,68300650,del,HG00427,0,,1209
8,2588564,2592428,del,HG00252,0,,3864
8,144309092,144318513,del,NA18622,0,,9421
8,135194240,135195901,del,NA18870,0,,1661
8,15717688,15718767,del,HG00372,0,,1079
8,79178179,79187762,del,NA07037,0,,9583
8,29179968,29180240,del,HG00422,0,,272
8,117630204,117633001,del,NA19002,0,,2797
8,8062516,8087722,del,HG01140,0,,25206
8,27259726,27262813,del,NA19401,0,,3087
8,33027999,33028910,del,HG00590,0,,911
8,48901648,48911282,del,NA19446,0,,9634
8,9497823,9500956,del,NA12763,0,,3133
8,136959176,136959420,del,NA19379,0,,244
8,73710317,73712916,del,HG01191,0,,2599
8,95785695,95786645,del,NA18563,0,,950
8,16428502,16434489,del,HG00620,0,,5987
8,41930248,41930563,del,NA19171,0,,315
8,144976293,144979343,del,HG00559,0,,3050
8,114040465,114046767,del,HG00178,0,,6302
8,15092194,15093168,del,HG01101,0,,974
8,108121524,108122343,del,HG00557,0,,819
8,11596929,11597266,del,HG00473,0,,337
8,33656781,33658281,del,HG00672,0,,1500
8,118005424,118008174,del,NA19900,0,,2750
8,48066059,48072449,del,HG01390,0,,6390
8,17580639,17581766,del,NA20538,0,,1127
8,92532377,92540936,del,HG00178,0,,8559
8,111988153,111993710,del,NA18988,0,,5557
8,11495077,11495253,del,HG00186,0,,176
8,13786312,13787013,del,NA19463,0,,701
8,145787235,145788148,del,NA19093,0,,913
8,106374026,106374765,del,NA19397,0,,739
8,107972156,107973834,del,NA20518,0,,1678
8,9791439,9803636,del,NA18530,0,,12197
8,146057030,146057842,del,NA12749,0,,812
8,70785278,70787200,del,HG00252,0,,1922
8,136073324,136076804,del,NA19391,0,,3480
8,99054106,99054839,del,NA12830,0,,733
8,81374069,81376654,del,NA18602,0,,2585
8,79256480,79270921,del,HG00123,0,,14441
8,58122394,58126783,del,HG00306,0,,4389
8,102387583,102403785,del,NA18910,0,,16202
8,136218377,136220118,del,NA19438,0,,1741
8,58115057,58115700,del,NA19443,0,,643
8,138742965,138743861,del,NA20516,0,,896
8,137692243,137862363,del,HG01080,0,,170120
8,9312656,9317058,del,HG00373,0,,4402
8,27662500,27662830,del,HG00421,0,,330
8,4322847,4334539,del,NA20806,0,,11692
8,79151402,79151507,del,NA18593,0,,105
8,66871980,66874576,del,NA20582,0,,2596
8,50873421,50964906,del,NA19093,0,,91485
8,87200212,87203315,del,NA19213,0,,3103
8,56377729,56393641,del,NA20282,0,,15912
8,96875225,96879590,del,NA18917,0,,4365
8,15028445,15029310,del,NA12399,0,,865
8,43033722,43036379,del,NA20346,0,,2657
8,64835602,64851583,del,NA18510,0,,15981
8,63034946,63040392,del,HG01102,0,,5446
8,144699766,144714422,del,NA19247,0,,14656
8,95023193,95025873,del,NA18560,0,,2680
8,100354688,100355545,del,NA12342,0,,857
8,120081016,120083122,del,HG00620,0,,2106
8,1658904,1659432,del,HG00613,0,,528
8,14508566,14515072,del,NA19453,0,,6506
8,81990637,81994021,del,HG01060,0,,3384
8,31102398,31103588,del,NA18595,0,,1190
8,143100624,143114687,del,HG00650,0,,14063
8,219791,221051,del,HG00437,0,,1260
8,67661480,67662971,del,NA19679,0,,1491
8,20025242,20026190,del,HG01187,0,,948
8,128722929,128725374,del,NA19982,0,,2445
8,7158416,7189622,del,NA19160,0,,31206
8,24974816,24985422,del,HG00524,0,,10606
8,39244254,39387228,del,HG00418,0,,142974
8,123059028,123061005,del,NA18486,0,,1977
8,35195349,35201532,del,NA19225,0,,6183
8,145505061,145505276,del,NA19380,0,,215
8,142447103,142447399,del,HG01170,0,,296
8,28753899,28754231,del,HG00335,0,,332
8,122058225,122058582,del,NA19328,0,,357
8,49027397,49028430,del,NA19455,0,,1033
8,130139216,130145922,del,NA19346,0,,6706
8,18475690,18476153,del,HG00133,0,,463
8,43071633,43074957,del,NA11893,0,,3324
8,68084847,68085933,del,NA19381,0,,1086
8,52316914,52317074,del,NA19436,0,,160
8,48458724,48460210,del,NA19703,0,,1486
8,144390113,144390510,del,HG00187,0,,397
8,89675055,89676962,del,NA19717,0,,1907
8,96086642,96086786,del,NA19197,0,,144
8,66311348,66311469,del,NA20826,0,,121
8,13614123,13651410,del,NA19470,0,,37287
8,38221750,38236115,del,HG01133,0,,14365
8,100026444,100027435,del,HG01170,0,,991
8,143365094,143365479,del,NA19675,0,,385
8,18340761,18342996,del,NA19399,0,,2235
8,11492463,11494909,del,NA19818,0,,2446
8,30072448,30072624,del,HG00584,0,,176
8,240556,240947,del,NA19700,0,,391
8,61027289,61027367,del,NA18861,0,,78
8,30534796,30535172,del,NA19451,0,,376
8,58412467,58413848,del,HG00427,0,,1381
8,104132138,104135654,del,NA19703,0,,3516
8,131850749,131852738,del,HG00421,0,,1989
8,51031091,51038347,del,NA12348,0,,7256
8,21625216,21638322,del,HG00657,0,,13106
8,103718389,103728429,del,NA20533,0,,10040
8,53365077,53367160,del,HG00267,0,,2083
8,6205351,6207171,del,NA19444,0,,1820
8,130141031,130145156,del,HG01066,0,,4125
8,65244446,65257185,del,NA19921,0,,12739
8,129472416,129484743,del,NA19399,0,,12327
8,106796666,106798122,del,NA19331,0,,1456
8,24705474,24708440,del,NA12751,0,,2966
8,76840799,76841260,del,NA19347,0,,461
8,127630642,127634220,del,NA19355,0,,3578
8,138817139,138819442,del,NA19703,0,,2303
8,66598542,66601080,del,HG00614,0,,2538
8,82975088,82980669,del,NA19099,0,,5581
8,119932761,119933522,del,NA19399,0,,761
8,51224982,51228314,del,HG01061,0,,3332
8,126365932,126367714,del,HG00589,0,,1782
8,132091625,132093524,del,NA19404,0,,1899
8,13194234,13198215,del,HG00106,0,,3981
8,90737016,90740920,del,HG01375,0,,3904
8,69818343,69819212,del,NA19108,0,,869
8,5061716,5074043,del,NA18984,0,,12327
8,143885511,143886123,del,NA20541,0,,612
8,17852223,17853258,del,NA19901,0,,1035
8,41540859,41542015,del,NA18559,0,,1156
8,4162913,4169487,del,HG01350,0,,6574
8,17436447,17446625,del,NA19835,0,,10178
8,39737280,39737510,del,HG00186,0,,230
8,76248436,76257371,del,NA19334,0,,8935
8,40182853,40189814,del,NA18907,0,,6961
8,27264037,27266307,del,NA12489,0,,2270
8,34360012,34360385,del,NA18637,0,,373
8,73325716,73330695,del,NA19147,0,,4979
8,36070128,36077355,del,NA12842,0,,7227
8,62035360,62035892,del,HG01197,0,,532
8,1939695,1942458,del,NA19129,0,,2763
8,63307309,63307565,del,HG00236,0,,256
8,54756914,54757735,del,NA19457,0,,821
8,8066416,8087722,del,NA18630,0,,21306
8,91515414,91515683,del,HG01551,0,,269
8,43215531,43215713,del,NA10847,0,,182
8,25204075,25204300,del,NA19819,0,,225
8,28895258,28896257,del,HG00421,0,,999
8,6958541,6980246,del,HG00334,0,,21705
8,76809373,76812441,del,NA20524,0,,3068
8,18853593,18858985,del,NA19703,0,,5392
8,140014097,140014181,del,HG01070,0,,84
8,94072343,94077192,del,NA20332,0,,4849
8,138125855,138127581,del,NA19082,0,,1726
8,132277653,132280534,del,NA19057,0,,2881
8,82045018,82046624,del,HG01072,0,,1606
8,43791503,43793180,del,NA20535,0,,1677
8,15048147,15051234,del,NA19347,0,,3087
8,1598840,1598991,del,NA19398,0,,151
8,60085574,60087732,del,NA19377,0,,2158
8,143363718,143363945,del,HG00125,0,,227
8,39857107,39859376,del,NA18610,0,,2269
8,78214707,78221293,del,HG00584,0,,6586
8,56390273,56392237,del,NA19079,0,,1964
8,47111895,47114649,del,NA19916,0,,2754
8,15937534,15945238,del,NA19311,0,,7704
8,1295292,1296125,del,NA11932,0,,833
8,94237416,94243603,del,NA18910,0,,6187
8,111721402,111727870,del,NA18986,0,,6468
8,56738465,56739924,del,HG00736,0,,1459
8,109235950,109238156,del,NA19435,0,,2206
8,144316259,144317552,del,NA18499,0,,1293
8,37050879,37051853,del,NA19468,0,,974
8,1798001,1798227,del,NA18510,0,,226
8,120460796,120463091,del,NA19394,0,,2295
8,87188248,87193743,del,NA19719,0,,5495
8,579739,579891,del,NA19390,0,,152
8,2129557,2134969,del,NA19457,0,,5412
8,12542742,12560633,del,NA19007,0,,17891
8,22982296,22988246,del,HG00418,0,,5950
8,101985124,101993044,del,HG00683,0,,7920
8,102620946,102626791,del,NA19347,0,,5845
8,111428828,111468296,del,NA19347,0,,39468
8,6120493,6125052,del,NA19776,0,,4559
8,25681885,25683603,del,NA19474,0,,1718
8,478390,478667,del,NA19774,0,,277
8,290849,291453,del,NA19404,0,,604
8,140689926,140690200,del,NA19404,0,,274
8,31648364,31650820,del,NA12342,0,,2456
8,135477685,135478901,del,NA19380,0,,1216
8,47160493,47161132,del,NA19462,0,,639
8,144058196,144058354,del,HG00701,0,,158
8,47391706,47407785,del,NA19072,0,,16079
8,106181395,106181723,del,NA12058,0,,328
8,95646879,95648942,del,NA18853,0,,2063
8,9701652,9739539,del,NA18539,0,,37887
8,40774216,40779622,del,HG00473,0,,5406
8,88512266,88512794,del,NA19099,0,,528
8,4980320,4980992,del,NA20775,0,,672
8,50213954,50216572,del,NA19455,0,,2618
8,64115286,64117050,del,NA20509,0,,1764
8,27871329,27873738,del,HG00637,0,,2409
8,34988776,34990403,del,NA12058,0,,1627
8,100094573,100105427,del,HG01083,0,,10854
8,36434418,36438587,del,NA18546,0,,4169
8,19159626,19159766,del,HG00684,0,,140
8,15309998,15310525,del,HG00343,0,,527
8,118980757,118981108,del,HG00123,0,,351
8,112604197,112608748,del,NA18547,0,,4551
8,20783594,20784740,del,NA19316,0,,1146
8,104217812,104219955,del,HG00418,0,,2143
8,41328710,41330718,del,NA19399,0,,2008
8,7805416,7870622,del,HG01383,0,,65206
8,81703621,81710576,del,HG00589,0,,6955
8,16384217,16384448,del,NA19712,0,,231
8,144424366,144425422,del,HG01067,0,,1056
8,86536298,86545693,del,NA18985,0,,9395
8,47033514,47033945,del,HG01052,0,,431
8,120785113,120786347,del,HG00328,0,,1234
8,95066457,95067365,del,NA20538,0,,908
8,6230047,6230674,del,NA18549,0,,627
8,101610698,101610951,del,NA18504,0,,253
8,86342990,86348835,del,NA18565,0,,5845
8,33000924,33001538,del,HG00699,0,,614
8,28310718,28312513,del,NA19431,0,,1795
8,39163947,39168643,del,NA18577,0,,4696
8,141206072,141206877,del,NA19380,0,,805
8,125241544,125241886,del,NA19403,0,,342
8,66091801,66094658,del,NA18910,0,,2857
8,145645355,145647481,del,HG01070,0,,2126
8,4012374,4014088,del,NA19462,0,,1714
8,141468027,141468207,del,NA20517,0,,180
8,6230067,6230724,del,NA12341,0,,657
8,60768770,60768937,del,NA19108,0,,167
8,26979331,26981654,del,NA11992,0,,2323
8,1298983,1300383,del,NA19081,0,,1400
8,23933979,23934081,del,NA18530,0,,102
8,116620772,116621187,del,NA18908,0,,415
8,55987618,56005100,del,NA20586,0,,17482
8,110364518,110365870,del,NA18963,0,,1352
8,85260966,85269169,del,HG00143,0,,8203
8,12186516,12199722,del,HG00543,0,,13206
8,74771114,74771226,del,HG01052,0,,112
8,143065187,143065253,del,HG00705,0,,66
8,120926325,120926719,del,HG00328,0,,394
8,93311555,93324711,del,NA12058,0,,13156
8,9555071,9556288,del,NA18950,0,,1217
8,128012253,128012925,del,NA19359,0,,672
8,143177154,143177607,del,HG01051,0,,453
8,2364500,2364609,del,HG01125,0,,109
8,30477013,30483151,del,NA19440,0,,6138
8,98200142,98200464,del,NA19236,0,,322
8,3974026,3974926,del,NA19684,0,,900
8,107496268,107499492,del,NA18606,0,,3224
8,8679963,8680354,del,HG00111,0,,391
8,175362,245376,dup,HG02010,0,,70014
8,187850,243610,dup,HG00367,0,,55760
8,196767,690082,dup,HG00367,0,,493315
8,208716,322006,dup,HG02010,0,,113290
8,240959,265829,dup,HG02010,0,,24870
8,258125,285428,dup,HG01107,0,,27303
8,282429,311068,dup,HG02010,0,,28639
8,283678,341240,dup,HG02010,0,,57562
8,312873,334365,dup,HG02449,0,,21492
8,329703,384511,dup,HG02010,0,,54808
8,374430,414668,dup,HG02010,0,,40238
8,410473,445944,dup,NA20520,0,,35471
8,442362,512421,dup,HG03898,0,,70059
8,449276,504913,dup,HG03898,0,,55637
8,593902,751246,dup,NA20520,0,,157344
8,620152,681595,dup,HG00266,0,,61443
8,653312,831713,dup,NA20894,0,,178401
8,730918,753494,dup,HG02589,0,,22576
8,754495,851794,dup,NA20334,0,,97299
8,854089,897480,dup,NA20894,0,,43391
8,915621,923677,dup,HG04182,0,,8056
8,920862,949289,dup,HG04023,0,,28427
8,924906,1106071,dup,NA20894,0,,181165
8,953913,972811,dup,NA19431,0,,18898
8,991593,1181916,dup,NA20894,0,,190323
8,1114396,1311684,dup,HG00254,0,,197288
8,1179130,1206112,dup,HG00536,0,,26982
8,1218803,1227714,dup,HG01894,0,,8911
8,1252759,1282056,dup,NA20894,0,,29297
8,1320310,1340923,dup,NA12272,0,,20613
8,1340389,1411997,dup,HG03720,0,,71608
8,1357367,1397183,dup,HG03720,0,,39816
8,1518588,1651595,dup,NA19058,0,,133007
8,1653693,1770395,dup,HG01054,0,,116702
8,1682918,1704204,dup,HG01054,0,,21286
8,1774288,1871958,dup,NA19058,0,,97670
8,2021298,2064282,dup,HG02691,0,,42984
8,2057828,2137426,dup,HG00701,0,,79598
8,2091214,2140720,dup,HG02691,0,,49506
8,2132773,2270819,dup,HG00096,0,,138046
8,2147962,2181526,dup,HG00242,0,,33564
8,2375045,2532277,dup,HG00701,0,,157232
8,2459729,2487179,dup,HG01513,0,,27450
8,2492166,2518152,dup,HG01513,0,,25986
8,2552065,2580111,dup,HG00701,0,,28046
8,2588598,2592297,dup,HG00112,0,,3699
8,2596748,2738006,dup,HG00701,0,,141258
8,2668990,2804767,dup,HG02028,0,,135777
8,2753124,2920569,dup,HG03136,0,,167445
8,2798061,2923374,dup,HG03136,0,,125313
8,2809790,2827392,dup,HG03136,0,,17602
8,3106689,3136705,dup,HG02142,0,,30016
8,3644946,3699880,dup,HG03826,0,,54934
8,3687462,3911590,dup,HG03616,0,,224128
8,3688396,3756553,dup,HG03945,0,,68157
8,3759579,3783144,dup,HG03616,0,,23565
8,3786311,3790617,dup,HG00112,0,,4306
8,3789368,3819742,dup,HG03616,0,,30374
8,3811577,3842900,dup,HG03616,0,,31323
8,3829774,3946195,dup,NA19007,0,,116421
8,3948839,3978734,dup,HG03777,0,,29895
8,3996836,4004485,dup,HG00637,0,,7649
8,4003586,4026274,dup,HG03777,0,,22688
8,4009016,4170808,dup,HG00403,0,,161792
8,4025391,4033797,dup,HG03385,0,,8406
8,4037987,4057203,dup,HG03777,0,,19216
8,4066416,4139885,dup,HG03777,0,,73469
8,4130900,4310533,dup,NA19007,0,,179633
8,4189407,4437928,dup,NA18972,0,,248521
8,4285896,4305866,dup,HG01781,0,,19970
8,4318508,4350648,dup,HG01786,0,,32140
8,4351649,4388883,dup,HG02836,0,,37234
8,4405850,4435591,dup,NA19007,0,,29741
8,4432676,4471763,dup,NA18941,0,,39087
8,4460711,4525904,dup,NA19007,0,,65193
8,4461050,4488552,dup,HG00231,0,,27502
8,4502578,4537830,dup,NA18972,0,,35252
8,4529817,4599154,dup,HG02364,0,,69337
8,4592747,4659854,dup,HG02364,0,,67107
8,4632716,4710684,dup,HG03989,0,,77968
8,4718265,4762568,dup,HG01956,0,,44303
8,4795505,5163019,dup,NA19007,0,,367514
8,4807910,5060247,dup,NA18972,0,,252337
8,4950889,4965695,dup,HG04042,0,,14806
8,5195845,5286086,dup,HG02558,0,,90241
8,5310869,5420428,dup,NA19007,0,,109559
8,5394344,5551386,dup,NA18972,0,,157042
8,5464957,5596162,dup,NA19007,0,,131205
8,5595438,5605648,dup,HG00106,0,,10210
8,5632078,5667265,dup,NA19007,0,,35187
8,5653716,5727347,dup,NA18962,0,,73631
8,5743647,5804017,dup,NA19007,0,,60370
8,5799938,5951850,dup,HG03432,0,,151912
8,5803018,5830524,dup,HG01872,0,,27506
8,5844866,5901866,dup,NA19007,0,,57000
8,6000160,6019029,dup,HG03432,0,,18869
8,6035596,6239092,dup,HG00114,0,,203496
8,6120481,6263325,dup,HG01254,0,,142844
8,6154292,6175196,dup,HG01254,0,,20904
8,6176795,6231889,dup,HG01254,0,,55094
8,6277072,6289396,dup,HG03805,0,,12324
8,6405696,6496373,dup,NA19331,0,,90677
8,6437463,6456145,dup,HG01707,0,,18682
8,6879829,6920559,dup,HG02143,0,,40730
8,6919029,6951913,dup,HG02143,0,,32884
8,6940601,6977370,dup,HG01353,0,,36769
8,6980573,6991302,dup,HG00422,0,,10729
8,6991759,6995386,dup,HG00096,0,,3627
8,7001243,7012355,dup,HG01947,0,,11112
8,7212582,7227421,dup,HG00188,0,,14839
8,7774146,7782327,dup,HG00096,0,,8181
8,8072609,8077628,dup,HG00096,0,,5019
8,8091854,8131334,dup,HG01083,0,,39480
8,8369984,8388565,dup,HG02494,0,,18581
8,8634414,8637836,dup,HG02439,0,,3422
8,8709483,8756625,dup,HG01107,0,,47142
8,8716369,8751152,dup,NA18965,0,,34783
8,8759173,9022613,dup,NA20761,0,,263440
8,9007192,9192085,dup,HG02274,0,,184893
8,9013670,9234399,dup,NA20761,0,,220729
8,9041260,9054071,dup,HG02274,0,,12811
8,9070147,9110559,dup,HG02274,0,,40412
8,9193739,9299033,dup,NA20761,0,,105294
8,9253535,9324275,dup,HG04106,0,,70740
8,10110022,10120863,dup,NA19043,0,,10841
8,10142002,10145167,dup,HG01323,0,,3165
8,10302803,10352708,dup,HG03971,0,,49905
8,11392137,11443083,dup,HG01176,0,,50946
8,11397009,11491903,dup,HG01176,0,,94894
8,11397243,11491225,dup,HG01176,0,,93982
8,11480900,11516758,dup,HG03234,0,,35858
8,11863303,11892340,dup,HG02314,0,,29037
8,11996081,12012945,dup,HG00099,0,,16864
8,12237311,12251515,dup,HG00097,0,,14204
8,12469192,12502901,dup,HG00117,0,,33709
8,12542776,12560664,dup,HG00705,0,,17888
8,12840600,12865095,dup,HG01776,0,,24495
8,13037346,13051160,dup,HG01776,0,,13814
8,13088037,13207381,dup,HG02494,0,,119344
8,13098410,13141360,dup,HG01776,0,,42950
8,13170250,13252479,dup,HG02819,0,,82229
8,13213901,13333567,dup,HG02494,0,,119666
8,13234404,13249446,dup,HG02819,0,,15042
8,13255697,13305071,dup,HG01776,0,,49374
8,13333914,13394785,dup,HG01776,0,,60871
8,13424868,13825883,dup,NA19428,0,,401015
8,13434094,13526567,dup,NA19428,0,,92473
8,13505427,13521786,dup,NA19428,0,,16359
8,13515685,13576802,dup,HG03913,0,,61117
8,13541297,13567994,dup,HG03913,0,,26697
8,13560747,13583792,dup,NA19428,0,,23045
8,13599418,13609281,dup,HG00742,0,,9863
8,13613298,13650857,dup,HG00698,0,,37559
8,13626465,13652740,dup,HG00698,0,,26275
8,13649808,13726973,dup,NA18542,0,,77165
8,13745637,13839045,dup,NA19428,0,,93408
8,13828144,13962564,dup,NA19428,0,,134420
8,13902125,14044459,dup,NA19428,0,,142334
8,14041140,14066630,dup,NA20504,0,,25490
8,14054820,14366809,dup,HG03280,0,,311989
8,14225643,14330573,dup,HG03280,0,,104930
8,14258650,14274884,dup,NA19144,0,,16234
8,14585149,14593059,dup,HG01848,0,,7910
8,14628894,14749820,dup,NA12234,0,,120926
8,14772352,14920260,dup,NA12234,0,,147908
8,14927663,14954666,dup,NA12234,0,,27003
8,14962195,15099408,dup,NA12234,0,,137213
8,15106385,15145950,dup,NA12234,0,,39565
8,15121805,15227603,dup,HG03006,0,,105798
8,15264797,15344752,dup,HG02086,0,,79955
8,15386289,15457772,dup,NA12234,0,,71483
8,15629181,15658368,dup,NA12234,0,,29187
8,15748702,15764047,dup,HG03757,0,,15345
8,15878929,15997034,dup,HG00337,0,,118105
8,15881377,16356154,dup,HG03788,0,,474777
8,15883476,15934892,dup,HG00262,0,,51416
8,15931456,15946119,dup,NA19027,0,,14663
8,15937757,15945102,dup,NA19027,0,,7345
8,15947114,16021867,dup,HG00337,0,,74753
8,16074503,16154060,dup,HG03788,0,,79557
8,16127754,16286241,dup,HG03788,0,,158487
8,16159202,16195766,dup,HG03788,0,,36564
8,16211032,16245171,dup,HG02442,0,,34139
8,16246547,16250546,dup,HG03589,0,,3999
8,16262082,16274699,dup,HG00121,0,,12617
8,16271627,16304792,dup,HG02442,0,,33165
8,16293453,16402782,dup,HG03788,0,,109329
8,16433084,16469704,dup,NA20902,0,,36620
8,16448580,16478543,dup,HG00407,0,,29963
8,16492077,16535945,dup,NA18647,0,,43868
8,17317636,17343283,dup,HG02090,0,,25647
8,17348041,17444611,dup,NA19012,0,,96570
8,17455656,17593078,dup,NA19012,0,,137422
8,17628519,17653212,dup,NA12843,0,,24693
8,17628520,17816526,dup,NA12843,0,,188006
8,17734787,17755236,dup,NA20858,0,,20449
8,17913778,17971866,dup,HG03740,0,,58088
8,17979330,18145257,dup,HG03740,0,,165927
8,18125199,18167719,dup,HG00246,0,,42520
8,18832311,19341621,dup,HG00116,0,,509310
8,18832817,18909723,dup,HG00116,0,,76906
8,19049553,19103160,dup,HG01182,0,,53607
8,19520288,19540865,dup,HG03660,0,,20577
8,19520450,19543703,dup,NA19399,0,,23253
8,19625123,19660012,dup,HG02727,0,,34889
8,19625360,19670937,dup,HG01951,0,,45577
8,19769060,19942412,dup,HG01668,0,,173352
8,19984631,20024142,dup,HG02081,0,,39511
8,20200833,20441209,dup,NA19917,0,,240376
8,20200897,20275830,dup,NA19401,0,,74933
8,20270949,20400108,dup,NA20774,0,,129159
8,20406954,20434435,dup,NA20774,0,,27481
8,20597308,20600817,dup,HG00304,0,,3509
8,20643801,20658297,dup,HG00707,0,,14496
8,21126310,21129578,dup,HG01462,0,,3268
8,22994015,23004015,dup,HG00553,0,,10000
8,23009688,23016890,dup,HG00553,0,,7202
8,23020403,23054711,dup,HG02371,0,,34308
8,24442344,24446863,dup,HG01286,0,,4519
8,24881878,24937747,dup,HG00705,0,,55869
8,25411336,25416596,dup,HG00105,0,,5260
8,25511993,25596018,dup,NA19625,0,,84025
8,25551662,25588605,dup,NA19625,0,,36943
8,26333957,26342514,dup,HG01075,0,,8557
8,27112333,27115512,dup,HG00127,0,,3179
8,27134607,27217510,dup,HG01596,0,,82903
8,27161491,27216913,dup,HG01596,0,,55422
8,27161578,27217357,dup,HG03479,0,,55779
8,27233419,27301401,dup,HG01596,0,,67982
8,30671347,30678396,dup,HG00244,0,,7049
8,31530472,31544445,dup,HG00705,0,,13973
8,32297527,32301308,dup,HG03788,0,,3781
8,34706337,34716569,dup,HG03212,0,,10232
8,34779955,34796631,dup,HG01973,0,,16676
8,36252448,36439288,dup,NA20785,0,,186840
8,37425377,37476863,dup,NA11931,0,,51486
8,37936153,38018191,dup,NA18910,0,,82038
8,37938258,37976722,dup,NA18910,0,,38464
8,39054579,39106695,dup,HG00533,0,,52116
8,39100134,39123212,dup,HG00356,0,,23078
8,39195825,39389230,dup,HG00096,0,,193405
8,39873327,39909726,dup,HG03040,0,,36399
8,41104588,41110281,dup,HG03199,0,,5693
8,41942028,41948126,dup,HG03745,0,,6098
8,42941073,43107047,dup,HG00120,0,,165974
8,42948776,42979320,dup,HG00120,0,,30544
8,43166488,43183266,dup,HG01342,0,,16778
8,43185150,43245404,dup,HG00120,0,,60254
8,43218219,43349462,dup,HG00120,0,,131243
8,43739968,43749936,dup,NA19323,0,,9968
8,47534545,47621334,dup,HG02479,0,,86789
8,48058799,48065020,dup,NA21127,0,,6221
8,48154852,48238284,dup,HG00117,0,,83432
8,48166364,48224224,dup,HG00117,0,,57860
8,48982548,49020287,dup,NA12144,0,,37739
8,49851182,49922807,dup,HG02658,0,,71625
8,49860352,49907031,dup,HG02658,0,,46679
8,49864631,49880177,dup,HG01894,0,,15546
8,49875020,49887572,dup,HG01894,0,,12552
8,49895337,49910059,dup,HG02121,0,,14722
8,49904859,49919543,dup,HG02390,0,,14684
8,50434506,50539321,dup,HG00404,0,,104815
8,50437139,50543399,dup,NA18570,0,,106260
8,50695411,50724988,dup,HG02259,0,,29577
8,51152391,51198293,dup,HG01131,0,,45902
8,51264799,51285918,dup,HG02756,0,,21119
8,51730098,51884195,dup,NA18602,0,,154097
8,51760378,51886689,dup,NA12750,0,,126311
8,51905282,51911621,dup,HG01372,0,,6339
8,52191358,52205075,dup,HG01873,0,,13717
8,52565424,52576256,dup,HG02557,0,,10832
8,52593051,52607637,dup,HG01874,0,,14586
8,53263899,53395261,dup,HG00559,0,,131362
8,53264003,53290928,dup,HG00559,0,,26925
8,53330721,53379779,dup,HG00559,0,,49058
8,53425894,53561534,dup,HG00559,0,,135640
8,53461671,53533933,dup,HG00559,0,,72262
8,53537920,53597107,dup,NA20806,0,,59187
8,53634988,53706744,dup,NA20806,0,,71756
8,53742951,53842970,dup,NA18997,0,,100019
8,53823189,53880207,dup,HG03461,0,,57018
8,53851007,53943853,dup,HG01124,0,,92846
8,53855395,53865007,dup,HG03461,0,,9612
8,53870048,53921630,dup,HG01124,0,,51582
8,54251728,54279558,dup,HG02343,0,,27830
8,54868382,54873436,dup,HG03046,0,,5054
8,55481983,55497125,dup,HG01992,0,,15142
8,55713985,55874906,dup,HG02410,0,,160921
8,55714867,55756578,dup,HG02410,0,,41711
8,55983888,56006945,dup,NA19461,0,,23057
8,56717478,56881498,dup,HG00107,0,,164020
8,56777472,56824419,dup,HG00107,0,,46947
8,56821501,56852301,dup,HG00107,0,,30800
8,57048632,57098412,dup,HG00243,0,,49780
8,57253287,57263920,dup,HG04035,0,,10633
8,57963633,57968686,dup,HG00273,0,,5053
8,58110147,58113349,dup,HG01375,0,,3202
8,58641934,58646210,dup,HG01500,0,,4276
8,59302776,59316263,dup,NA18940,0,,13487
8,59478951,59534210,dup,HG02356,0,,55259
8,60133328,60138612,dup,HG00097,0,,5284
8,62194526,62278532,dup,NA20906,0,,84006
8,62366309,62507467,dup,NA20906,0,,141158
8,62369828,62569022,dup,NA20906,0,,199194
8,62532037,62713006,dup,NA20906,0,,180969
8,62714524,62765017,dup,NA20906,0,,50493
8,62778433,62818746,dup,HG03511,0,,40313
8,62808195,62839359,dup,HG03511,0,,31164
8,63320878,63358007,dup,HG03039,0,,37129
8,63425748,63433076,dup,HG02681,0,,7328
8,64115491,64127693,dup,NA19338,0,,12202
8,64680449,64696369,dup,HG02819,0,,15920
8,64835924,64848040,dup,HG03172,0,,12116
8,65079152,65139813,dup,NA20339,0,,60661
8,65240112,65258586,dup,HG01108,0,,18474
8,66434964,66439059,dup,HG03792,0,,4095
8,66701947,66719057,dup,NA21126,0,,17110
8,67440544,67453730,dup,HG01323,0,,13186
8,67492833,67526627,dup,HG01868,0,,33794
8,67972108,68055271,dup,HG01868,0,,83163
8,68644757,68686513,dup,HG01968,0,,41756
8,68646003,68712001,dup,HG01968,0,,65998
8,68780756,68784709,dup,HG02541,0,,3953
8,69182590,69306949,dup,HG02406,0,,124359
8,69184249,69193316,dup,HG00553,0,,9067
8,69227752,69304002,dup,HG02406,0,,76250
8,69834109,69875723,dup,NA18939,0,,41614
8,70010531,70030317,dup,NA19184,0,,19786
8,70431214,70465842,dup,HG02133,0,,34628
8,70800763,70815841,dup,NA18542,0,,15078
8,70858413,70865770,dup,HG00244,0,,7357
8,70912009,70916547,dup,HG02651,0,,4538
8,70919281,70928362,dup,HG02651,0,,9081
8,71288888,71292957,dup,HG02284,0,,4069
8,71704908,71774368,dup,NA19042,0,,69460
8,71720600,71753946,dup,NA19042,0,,33346
8,71902891,72024609,dup,HG03558,0,,121718
8,71903287,71941010,dup,HG03558,0,,37723
8,72313236,72360484,dup,NA11920,0,,47248
8,72913987,72923955,dup,HG02570,0,,9968
8,73595983,73639951,dup,HG00100,0,,43968
8,73728384,73748175,dup,NA19735,0,,19791
8,74030349,74049886,dup,HG03240,0,,19537
8,74345462,74348518,dup,HG01342,0,,3056
8,74372026,74380016,dup,HG02512,0,,7990
8,74803958,74812551,dup,HG02805,0,,8593
8,74986709,75004105,dup,HG00692,0,,17396
8,75423651,75600052,dup,HG02399,0,,176401
8,75622749,75718494,dup,HG02399,0,,95745
8,75894879,75912789,dup,HG02490,0,,17910
8,76759638,76777091,dup,HG00362,0,,17453
8,76781807,76818115,dup,HG02716,0,,36308
8,77009663,77028658,dup,HG01061,0,,18995
8,78256937,78260237,dup,HG02946,0,,3300
8,79280041,79298585,dup,NA19904,0,,18544
8,79901488,79907787,dup,HG00146,0,,6299
8,80206036,80215480,dup,NA19027,0,,9444
8,80880353,80919145,dup,NA19213,0,,38792
8,81181107,81184503,dup,HG00179,0,,3396
8,81457820,81469169,dup,HG01259,0,,11349
8,83996266,84062735,dup,NA20904,0,,66469
8,84118309,84137835,dup,HG02389,0,,19526
8,84343014,84350820,dup,NA20870,0,,7806
8,85022833,85032253,dup,HG02419,0,,9420
8,85294117,85343490,dup,HG02757,0,,49373
8,86278671,86291635,dup,HG00684,0,,12964
8,86499890,86516074,dup,HG02410,0,,16184
8,86516076,86550165,dup,HG01801,0,,34089
8,86519982,86539622,dup,HG02410,0,,19640
8,86852562,86871327,dup,HG02050,0,,18765
8,86875592,86901349,dup,HG02050,0,,25757
8,86913361,86931980,dup,NA20808,0,,18619
8,87173274,87190343,dup,NA20752,0,,17069
8,87201331,87335547,dup,NA20752,0,,134216
8,87957765,87990653,dup,HG02144,0,,32888
8,88164520,88171764,dup,NA20766,0,,7244
8,89037565,89055656,dup,HG01162,0,,18091
8,89389959,89393465,dup,HG02054,0,,3506
8,89513383,89659125,dup,HG00566,0,,145742
8,89541609,89585437,dup,HG00566,0,,43828
8,89668429,89719451,dup,HG00566,0,,51022
8,89764867,89833490,dup,HG00566,0,,68623
8,89844256,89996860,dup,HG00566,0,,152604
8,89953087,90140752,dup,HG03575,0,,187665
8,90379734,90425184,dup,NA19795,0,,45450
8,90430239,90592121,dup,NA18988,0,,161882
8,90526456,90555643,dup,NA19795,0,,29187
8,90572148,90686262,dup,HG01444,0,,114114
8,91144724,91185759,dup,NA18971,0,,41035
8,91706576,91733304,dup,NA12890,0,,26728
8,92294254,92297647,dup,HG02355,0,,3393
8,94481244,94497121,dup,HG00743,0,,15877
8,94907382,94918787,dup,HG01970,0,,11405
8,95163868,95196020,dup,HG02648,0,,32152
8,95627121,95636537,dup,HG01843,0,,9416
8,95646074,95682235,dup,HG02808,0,,36161
8,95655795,95678386,dup,HG02808,0,,22591
8,98186728,98220496,dup,HG03943,0,,33768
8,98615392,98631271,dup,HG02667,0,,15879
8,100014130,100047108,dup,HG00122,0,,32978
8,100062817,100088194,dup,NA20505,0,,25377
8,100123291,100151656,dup,HG00116,0,,28365
8,100213795,100227863,dup,HG00130,0,,14068
8,100273487,100278520,dup,HG00321,0,,5033
8,101849765,101869958,dup,NA20753,0,,20193
8,102999555,103020068,dup,HG02854,0,,20513
8,103212597,103331254,dup,NA20542,0,,118657
8,103544833,103584821,dup,HG03021,0,,39988
8,103721773,103728246,dup,NA20507,0,,6473
8,103824923,103833124,dup,HG01345,0,,8201
8,104132075,104135580,dup,HG02332,0,,3505
8,104529869,104695081,dup,NA18915,0,,165212
8,104758620,104764479,dup,HG01389,0,,5859
8,104943514,104986535,dup,NA19060,0,,43021
8,105016648,105025637,dup,NA19190,0,,8989
8,106860087,106884040,dup,NA20755,0,,23953
8,107536213,107547321,dup,HG00178,0,,11108
8,107984864,107996799,dup,NA19239,0,,11935
8,109339712,109354880,dup,NA19141,0,,15168
8,110210309,110236447,dup,HG02855,0,,26138
8,110270931,110328556,dup,HG02558,0,,57625
8,110492974,110496960,dup,HG00380,0,,3986
8,111532620,111596168,dup,HG01302,0,,63548
8,111588471,111608995,dup,NA18757,0,,20524
8,111626578,111664233,dup,HG03295,0,,37655
8,111636121,111660829,dup,HG03295,0,,24708
8,111659339,111729944,dup,HG01302,0,,70605
8,111666593,111860964,dup,HG01302,0,,194371
8,111951143,111958865,dup,HG01551,0,,7722
8,112005896,112156035,dup,NA18986,0,,150139
8,112170611,112408021,dup,NA18986,0,,237410
8,112228690,112335076,dup,NA18986,0,,106386
8,112229639,112295171,dup,NA18986,0,,65532
8,112570447,112722358,dup,HG02855,0,,151911
8,114618157,114621655,dup,HG03521,0,,3498
8,115284434,115414465,dup,HG01369,0,,130031
8,115290104,115313604,dup,HG01369,0,,23500
8,115306855,115376337,dup,NA20810,0,,69482
8,115555608,115584902,dup,HG02323,0,,29294
8,115591177,115621083,dup,HG02323,0,,29906
8,115867350,115874168,dup,NA19057,0,,6818
8,116912949,117101826,dup,NA18582,0,,188877
8,117194103,117204161,dup,NA19446,0,,10058
8,117249288,117260387,dup,HG00351,0,,11099
8,118271200,118335002,dup,HG01997,0,,63802
8,118316249,118337570,dup,HG01997,0,,21321
8,118382032,118416300,dup,NA19328,0,,34268
8,119760940,119766700,dup,HG02481,0,,5760
8,120123374,120131773,dup,HG01583,0,,8399
8,120471538,120488285,dup,NA18989,0,,16747
8,122317428,122340766,dup,HG01369,0,,23338
8,122398398,122430206,dup,HG01369,0,,31808
8,122702371,122714811,dup,HG00108,0,,12440
8,123496773,123563457,dup,HG00273,0,,66684
8,123500028,123531969,dup,HG00273,0,,31941
8,124311125,124321517,dup,HG00637,0,,10392
8,124881970,124885669,dup,HG00350,0,,3699
8,125431254,125485534,dup,HG02450,0,,54280
8,125436003,125483208,dup,HG02450,0,,47205
8,125651423,125693782,dup,HG03781,0,,42359
8,125654984,125693070,dup,HG03781,0,,38086
8,125749494,125764813,dup,HG03099,0,,15319
8,125867249,125971942,dup,HG00123,0,,104693
8,125868816,125958893,dup,HG00123,0,,90077
8,126159848,126167070,dup,HG03836,0,,7222
8,126293615,126313657,dup,HG02047,0,,20042
8,126308400,126326366,dup,HG02355,0,,17966
8,126309556,126340489,dup,HG02355,0,,30933
8,126346296,126575731,dup,HG02047,0,,229435
8,128497047,128530717,dup,HG03488,0,,33670
8,128750285,128758970,dup,NA20508,0,,8685
8,129762482,129765999,dup,HG00099,0,,3517
8,130114439,130148903,dup,HG00623,0,,34464
8,131537276,131574015,dup,HG02780,0,,36739
8,131931048,131971333,dup,NA19921,0,,40285
8,132068649,132142706,dup,NA19921,0,,74057
8,132387937,133149164,dup,NA19921,0,,761227
8,132661218,132732013,dup,NA19921,0,,70795
8,132672412,132738792,dup,NA20294,0,,66380
8,132729133,132880916,dup,NA19921,0,,151783
8,133061855,133080000,dup,HG02678,0,,18145
8,134622528,134630609,dup,NA19372,0,,8081
8,134626890,134645198,dup,NA20276,0,,18308
8,135111204,135121385,dup,NA18577,0,,10181
8,135922874,135927409,dup,NA20757,0,,4535
8,136668780,136724338,dup,HG01326,0,,55558
8,136682448,136721536,dup,HG01183,0,,39088
8,137160271,137163814,dup,HG00096,0,,3543
8,138143642,138161257,dup,NA12890,0,,17615
8,138467448,138582802,dup,HG02408,0,,115354
8,138475895,138797271,dup,HG02408,0,,321376
8,138787884,138857307,dup,HG02408,0,,69423
8,138806123,138922793,dup,HG02408,0,,116670
8,138923109,139076996,dup,HG02408,0,,153887
8,138928321,139031510,dup,HG02408,0,,103189
8,139037381,139126417,dup,HG02953,0,,89036
8,139090762,139134845,dup,HG02953,0,,44083
8,139784706,139788545,dup,HG00610,0,,3839
8,139790258,139803585,dup,HG01107,0,,13327
8,139803586,139813639,dup,HG01107,0,,10053
8,139829757,139945170,dup,HG01107,0,,115413
8,139956003,139987992,dup,HG01107,0,,31989
8,140020794,140100688,dup,HG01107,0,,79894
8,140107246,140323055,dup,HG01107,0,,215809
8,140116383,140153013,dup,HG01107,0,,36630
8,140178608,140275532,dup,HG01107,0,,96924
8,140273706,140286870,dup,HG01107,0,,13164
8,140294654,140330437,dup,HG01107,0,,35783
8,140320669,140460500,dup,HG01524,0,,139831
8,140341542,140455346,dup,HG01107,0,,113804
8,141407785,141522222,dup,NA19017,0,,114437
8,141413917,141448565,dup,NA19017,0,,34648
8,141506301,141518614,dup,HG01551,0,,12313
8,141963551,141975623,dup,HG03069,0,,12072
8,142001791,142005111,dup,HG01586,0,,3320
8,142022385,142029930,dup,HG01817,0,,7545
8,142130895,142157313,dup,HG02836,0,,26418
8,142163597,142197176,dup,HG02836,0,,33579
8,142310624,142364057,dup,HG01675,0,,53433
8,142336221,142360838,dup,HG01675,0,,24617
8,142565171,142629482,dup,HG03625,0,,64311
8,143300422,143338006,dup,NA20514,0,,37584
8,144211961,144222602,dup,NA19037,0,,10641
8,144309701,144318557,dup,NA18622,0,,8856
8,144417212,144461117,dup,HG04056,0,,43905
8,144422605,144513782,dup,HG04056,0,,91177
8,144472805,144489242,dup,HG04056,0,,16437
8,145164708,145179276,dup,HG01840,0,,14568
8,145725542,145730291,dup,HG00128,0,,4749
8,145745349,145750302,dup,HG00123,0,,4953
8,145970994,145991284,dup,HG01188,0,,20290
8,146193953,146223876,dup,HG03762,0,,29923
8,146217034,146238252,dup,HG00103,0,,21218
8,146237243,146253219,dup,HG03084,0,,15976
8,146238227,146294268,dup,HG03343,0,,56041
8,146254080,146267361,dup,HG03084,0,,13281
8,146273368,146303902,dup,HG03084,0,,30534
9,33482642,33485938,del,HG00136,0,,3296
9,15815306,15821940,del,HG00233,0,,6634
9,81317872,81326869,del,HG00150,0,,8997
9,128782655,128785399,del,HG00152,0,,2744
9,127957315,127962175,del,NA19213,0,,4860
9,136360812,136361204,del,NA12413,0,,392
9,4501099,4503946,del,NA19448,0,,2847
9,81968359,81975294,del,HG01441,0,,6935
9,89447311,89454591,del,HG00361,0,,7280
9,82907597,82909151,del,NA19172,0,,1554
9,139246416,139246822,del,HG01182,0,,406
9,98468096,98468188,del,HG00692,0,,92
9,6399555,6401670,del,NA19474,0,,2115
9,25156772,25161692,del,HG00254,0,,4920
9,132719349,132719859,del,NA20813,0,,510
9,137416452,137416678,del,NA19786,0,,226
9,124345373,124351683,del,NA19463,0,,6310
9,130560178,130560809,del,NA19393,0,,631
9,123849653,123860147,del,NA18907,0,,10494
9,101000289,101001108,del,NA19068,0,,819
9,33909751,33910339,del,NA19332,0,,588
9,136417216,136453322,del,NA19088,0,,36106
9,137844715,137845319,del,HG00149,0,,604
9,1447357,1448434,del,NA19093,0,,1077
9,135389282,135389535,del,HG00608,0,,253
9,28047359,28051255,del,HG00651,0,,3896
9,114719397,114719910,del,NA19375,0,,513
9,136258913,136262407,del,NA18616,0,,3494
9,34135082,34135917,del,HG00173,0,,835
9,117482793,117484330,del,HG00560,0,,1537
9,126307153,126308603,del,NA18486,0,,1450
9,69784716,69787522,del,NA19443,0,,2806
9,85546871,85547017,del,NA19360,0,,146
9,6663085,6671194,del,NA19774,0,,8109
9,94211068,94214490,del,NA11918,0,,3422
9,132404792,132405408,del,HG00427,0,,616
9,24791866,24791922,del,NA18989,0,,56
9,138960155,138963200,del,NA19130,0,,3045
9,118873858,118876411,del,NA19437,0,,2553
9,116128703,116130854,del,NA18631,0,,2151
9,44778516,44790922,del,NA19780,0,,12406
9,33573401,33574213,del,HG00701,0,,812
9,108125593,108125895,del,NA18973,0,,302
9,121033660,121034727,del,NA19059,0,,1067
9,84751519,84751924,del,NA19376,0,,405
9,22496527,22504344,del,NA20803,0,,7817
9,94017827,94019679,del,NA19225,0,,1852
9,90552616,90556122,del,HG00335,0,,3506
9,8003825,8019073,del,HG00154,0,,15248
9,113024716,113029777,del,NA18612,0,,5061
9,21650031,21655753,del,HG01354,0,,5722
9,117082010,117083381,del,HG00583,0,,1371
9,590595,608665,del,NA19396,0,,18070
9,71895311,71896471,del,NA20334,0,,1160
9,83624063,83632697,del,HG00654,0,,8634
9,83320584,83322083,del,NA18632,0,,1499
9,13065786,13069700,del,NA19316,0,,3914
9,43317016,43399722,del,NA19372,0,,82706
9,22192393,22195110,del,NA19445,0,,2717
9,92108512,92110968,del,NA20582,0,,2456
9,140334616,140336672,del,HG01350,0,,2056
9,44742416,44764022,del,HG00268,0,,21606
9,138054367,138054568,del,NA18546,0,,201
9,29259549,29260750,del,NA18907,0,,1201
9,99395950,99396768,del,NA19396,0,,818
9,19110534,19140636,del,HG00737,0,,30102
9,6708606,6710757,del,NA18487,0,,2151
9,111573041,111575572,del,NA19652,0,,2531
9,12118477,12149969,del,NA18984,0,,31492
9,77963405,77968750,del,HG01465,0,,5345
9,2149040,2152029,del,NA19712,0,,2989
9,126938410,126939239,del,NA20809,0,,829
9,74448959,74449924,del,NA12489,0,,965
9,15098134,15105484,del,HG01465,0,,7350
9,6055518,6064332,del,NA18873,0,,8814
9,9893813,9895947,del,NA19189,0,,2134
9,133422810,133425793,del,NA18907,0,,2983
9,140222501,140224246,del,HG00443,0,,1745
9,136974799,136975104,del,NA18498,0,,305
9,32711097,32729721,del,HG00265,0,,18624
9,139629523,139645582,del,HG00319,0,,16059
9,4202243,4257633,del,NA19313,0,,55390
9,22819935,22824658,del,HG00689,0,,4723
9,11348427,11350710,del,NA19399,0,,2283
9,127696309,127698595,del,NA18952,0,,2286
9,109024116,109024427,del,NA18949,0,,311
9,141019497,141033683,del,HG00331,0,,14186
9,11784488,11785933,del,NA10847,0,,1445
9,22729432,22743385,del,NA19384,0,,13953
9,135591964,135592234,del,NA12003,0,,270
9,91055524,91057350,del,NA18853,0,,1826
9,76007143,76016146,del,HG00626,0,,9003
9,73897185,73897346,del,HG00277,0,,161
9,15157197,15159574,del,NA19462,0,,2377
9,28845666,28848772,del,NA20322,0,,3106
9,44746916,44763122,del,HG01113,0,,16206
9,43581016,43724422,del,HG01465,0,,143406
9,132352865,132355232,del,HG01188,0,,2367
9,95342453,95345002,del,NA19900,0,,2549
9,126892222,126895800,del,NA19920,0,,3578
9,96500160,96503042,del,HG01070,0,,2882
9,132065068,132067423,del,HG00404,0,,2355
9,125975787,125982258,del,HG00231,0,,6471
9,44778416,44791422,del,NA20811,0,,13006
9,43373616,43445422,del,NA20529,0,,71806
9,24876366,24878626,del,NA19398,0,,2260
9,113024816,113029822,del,NA18986,0,,5006
9,11669816,11718822,del,NA18523,0,,49006
9,107480112,107491414,del,NA12283,0,,11302
9,82081416,82082664,del,NA19703,0,,1248
9,38489344,38498344,del,NA19443,0,,9000
9,30507806,30521708,del,NA20809,0,,13902
9,132916753,132917979,del,HG00556,0,,1226
9,24555971,24561323,del,HG01072,0,,5352
9,90065581,90066372,del,NA19449,0,,791
9,18924047,18927625,del,HG00381,0,,3578
9,132526066,132530372,del,NA19327,0,,4306
9,38075797,38075957,del,HG00131,0,,160
9,6648895,6701885,del,HG00684,0,,52990
9,74681066,74684172,del,NA19346,0,,3106
9,12907635,12908993,del,HG01359,0,,1358
9,112830195,112830898,del,NA19455,0,,703
9,73501115,73514581,del,NA19137,0,,13466
9,128208111,128209933,del,NA19712,0,,1822
9,11507979,11583833,del,NA19390,0,,75854
9,82982166,82986622,del,NA19360,0,,4456
9,129393817,129394954,del,HG00737,0,,1137
9,27629799,27635138,del,HG00120,0,,5339
9,40804037,41621457,del,HG01461,0,,817420
9,95826686,95827834,del,NA19056,0,,1148
9,20799591,20804617,del,HG00704,0,,5026
9,110942833,110943078,del,NA18501,0,,245
9,126593089,126594642,del,NA07048,0,,1553
9,8081801,8082501,del,HG00421,0,,700
9,106225491,106230850,del,HG01073,0,,5359
9,114228595,114232803,del,NA19080,0,,4208
9,3393535,3393769,del,NA20515,0,,234
9,5203029,5209291,del,HG01170,0,,6262
9,79555759,79558101,del,NA12383,0,,2342
9,113876467,113878479,del,NA19440,0,,2012
9,115444264,115445099,del,NA19439,0,,835
9,91864364,91865682,del,HG00143,0,,1318
9,11964231,11967316,del,NA19446,0,,3085
9,139898361,139898468,del,HG00436,0,,107
9,125303090,125360648,del,HG00264,0,,57558
9,133440338,133440312,del,NA19403,0,,-26
9,68439966,68445357,del,HG01174,0,,5391
9,515016,528222,del,NA19375,0,,13206
9,134835593,134840474,del,NA19789,0,,4881
9,46343716,46426122,del,HG00177,0,,82406
9,128971073,128978454,del,NA19704,0,,7381
9,34266798,34282481,del,NA18602,0,,15683
9,136547830,136548024,del,HG00533,0,,194
9,34051226,34058468,del,NA18507,0,,7242
9,85709065,85709324,del,NA18508,0,,259
9,71671689,71671898,del,NA20755,0,,209
9,125729068,125732448,del,HG00114,0,,3380
9,26415431,26416887,del,NA19007,0,,1456
9,74684477,74689746,del,NA12842,0,,5269
9,136127800,136133621,del,NA19102,0,,5821
9,43642662,44253810,del,HG00247,0,,611148
9,118254930,118261858,del,NA19664,0,,6928
9,6702045,6702787,del,NA18627,0,,742
9,12907754,12911686,del,NA19456,0,,3932
9,131420701,131422646,del,NA12751,0,,1945
9,140756320,140758553,del,HG00136,0,,2233
9,127609863,127610599,del,NA19451,0,,736
9,133383116,133387420,del,NA12342,0,,4304
9,28700229,28700514,del,NA18596,0,,285
9,130766981,130767487,del,NA19390,0,,506
9,6034565,6039729,del,NA19063,0,,5164
9,44807416,44851422,del,NA19722,0,,44006
9,116397677,116398522,del,NA19098,0,,845
9,119893485,119895087,del,NA19338,0,,1602
9,121422815,121424658,del,HG00625,0,,1843
9,8510701,8511305,del,HG00708,0,,604
9,31019110,31019360,del,NA19129,0,,250
9,93693382,93693719,del,NA20531,0,,337
9,96195889,96200276,del,NA19439,0,,4387
9,23857404,23858088,del,NA12842,0,,684
9,114732796,114733039,del,HG01101,0,,243
9,105777070,105777222,del,HG00108,0,,152
9,107596179,107597337,del,NA19717,0,,1158
9,124514517,124514731,del,NA18517,0,,214
9,92768550,92769282,del,NA19099,0,,732
9,34056401,34056539,del,HG00249,0,,138
9,139901666,139908222,del,NA18634,0,,6556
9,87775077,87776048,del,NA19663,0,,971
9,76701708,76704611,del,NA18541,0,,2903
9,82093820,82094867,del,HG00372,0,,1047
9,16332323,16332438,del,NA18615,0,,115
9,78023962,78032404,del,HG01353,0,,8442
9,43563316,43693522,del,NA12829,0,,130206
9,122291405,122304639,del,NA18868,0,,13234
9,136361221,136361473,del,NA18545,0,,252
9,78866327,78866890,del,NA19445,0,,563
9,442597,442878,del,NA18505,0,,281
9,133383116,133387427,del,HG01168,0,,4311
9,9516969,9517974,del,NA19720,0,,1005
9,90552516,90555722,del,HG00740,0,,3206
9,101309043,101311664,del,HG00577,0,,2621
9,131118979,131119129,del,NA19084,0,,150
9,115656608,115664500,del,NA19428,0,,7892
9,134137357,134138370,del,NA18523,0,,1013
9,138274571,138278882,del,HG00512,0,,4311
9,15553831,15563137,del,NA12748,0,,9306
9,76789623,76790831,del,NA19469,0,,1208
9,642666,648522,del,NA19439,0,,5856
9,90909379,90910213,del,NA19058,0,,834
9,74679296,74689536,del,HG01108,0,,10240
9,15050616,15051794,del,HG01198,0,,1178
9,10360918,10362697,del,HG00357,0,,1779
9,110018566,110020672,del,NA18959,0,,2106
9,17401465,17407033,del,HG00136,0,,5568
9,119017021,119020769,del,HG00404,0,,3748
9,135542246,135544075,del,HG01489,0,,1829
9,117606295,117609273,del,NA20801,0,,2978
9,85664434,85670507,del,NA18499,0,,6073
9,94930317,94931515,del,NA20766,0,,1198
9,101209330,101209644,del,HG01375,0,,314
9,91020167,91029460,del,NA19311,0,,9293
9,76017647,76027640,del,HG00270,0,,9993
9,83967917,83970683,del,HG00276,0,,2766
9,15098155,15105577,del,HG01465,0,,7422
9,19143054,19156982,del,NA18952,0,,13928
9,69736639,70101016,del,HG00190,0,,364377
9,8640847,8641662,del,NA19257,0,,815
9,22615297,22617910,del,NA19332,0,,2613
9,121420866,121423636,del,HG01183,0,,2770
9,7367108,7367244,del,NA18532,0,,136
9,139843516,139849322,del,HG00734,0,,5806
9,71777926,71778244,del,NA19394,0,,318
9,68495490,68495724,del,HG01173,0,,234
9,138688467,138691954,del,NA19435,0,,3487
9,33707436,33708535,del,NA18605,0,,1099
9,118562422,118574763,del,NA12044,0,,12341
9,93883362,93883684,del,HG00513,0,,322
9,99655982,99656296,del,NA19834,0,,314
9,44779216,44791022,del,HG01052,0,,11806
9,84872125,84879199,del,NA19651,0,,7074
9,139297826,139297921,del,HG00326,0,,95
9,81995834,81996760,del,HG00584,0,,926
9,87352607,87353321,del,NA19130,0,,714
9,134915388,134921091,del,NA19007,0,,5703
9,130181618,130186076,del,NA19771,0,,4458
9,25594087,25594448,del,NA20768,0,,361
9,46913616,46917222,del,HG00704,0,,3606
9,80553970,80563533,del,NA19338,0,,9563
9,20087770,20088835,del,NA20778,0,,1065
9,115038742,115041990,del,HG00629,0,,3248
9,4416252,4446916,del,NA20507,0,,30664
9,43494216,43542522,del,HG01462,0,,48306
9,78490568,78494546,del,HG00252,0,,3978
9,38555934,38565118,del,NA19679,0,,9184
9,138177074,138177637,del,HG00309,0,,563
9,34737015,34737780,del,NA19334,0,,765
9,6729218,6730118,del,NA18942,0,,900
9,106628370,106630295,del,NA19360,0,,1925
9,140345793,140345961,del,HG01125,0,,168
9,137032550,137034307,del,NA19102,0,,1757
9,95934445,95936555,del,NA11932,0,,2110
9,33423361,33424654,del,NA19711,0,,1293
9,104965127,104965479,del,HG00342,0,,352
9,129520430,129523245,del,NA19000,0,,2815
9,11137855,11142093,del,NA18950,0,,4238
9,73992446,73997768,del,NA18609,0,,5322
9,132526394,132530481,del,NA18908,0,,4087
9,31947143,31948375,del,NA19055,0,,1232
9,865790,869800,del,NA19703,0,,4010
9,12165000,12186861,del,NA19068,0,,21861
9,136130694,136130808,del,HG00613,0,,114
9,92086605,92086729,del,HG00138,0,,124
9,26711637,26719761,del,NA19066,0,,8124
9,112300709,112301421,del,NA18547,0,,712
9,34159863,34160118,del,NA20287,0,,255
9,128358704,128366095,del,HG00137,0,,7391
9,11433120,11433435,del,HG01107,0,,315
9,36456446,36457188,del,HG01440,0,,742
9,4017854,4019665,del,HG01170,0,,1811
9,131556786,131557771,del,NA20804,0,,985
9,41969816,41984022,del,NA18608,0,,14206
9,603752,604594,del,NA12144,0,,842
9,96273466,96274663,del,HG01488,0,,1197
9,29925235,29935467,del,NA19437,0,,10232
9,115312345,115312548,del,HG01055,0,,203
9,17701671,17706227,del,HG01082,0,,4556
9,8921067,8921747,del,NA18624,0,,680
9,107932027,107932621,del,NA19381,0,,594
9,31147402,31148043,del,NA18557,0,,641
9,72151083,72153029,del,NA20798,0,,1946
9,132102776,132102963,del,HG01389,0,,187
9,88118722,88119947,del,NA18873,0,,1225
9,120044887,120045214,del,NA19198,0,,327
9,132123543,132124377,del,NA19334,0,,834
9,28846386,28847899,del,NA19236,0,,1513
9,120513854,120520520,del,HG00699,0,,6666
9,74706001,74707536,del,NA19355,0,,1535
9,86676629,86687382,del,NA18610,0,,10753
9,46344116,46409222,del,HG00479,0,,65106
9,82815775,82819145,del,HG00256,0,,3370
9,123257024,123259730,del,NA19334,0,,2706
9,136459551,136463225,del,NA19457,0,,3674
9,94675915,94679083,del,HG00247,0,,3168
9,126070888,126072363,del,HG01437,0,,1475
9,124333080,124338788,del,NA19236,0,,5708
9,124519770,124520099,del,NA19376,0,,329
9,133525286,133525893,del,HG00530,0,,607
9,133040097,133040197,del,HG00246,0,,100
9,79397405,79398155,del,NA19007,0,,750
9,130633126,130634037,del,NA19319,0,,911
9,105763207,105823283,del,HG00375,0,,60076
9,25218622,25221552,del,NA19080,0,,2930
9,89457908,89458273,del,NA19455,0,,365
9,11783982,11785764,del,HG00271,0,,1782
9,12288536,12588772,del,NA19130,0,,300236
9,135894791,135896575,del,HG01489,0,,1784
9,99650060,99655921,del,NA19900,0,,5861
9,116463148,116463353,del,NA12399,0,,205
9,9594351,9598888,del,HG00559,0,,4537
9,107366951,107379528,del,NA19070,0,,12577
9,83372963,83373233,del,NA20516,0,,270
9,134275742,134277179,del,HG00533,0,,1437
9,110427672,110431349,del,NA19648,0,,3677
9,22496716,22502772,del,NA12283,0,,6056
9,126934389,126935485,del,NA20531,0,,1096
9,6507916,6510638,del,NA19462,0,,2722
9,131996437,132007440,del,NA18632,0,,11003
9,113821897,113826430,del,NA18520,0,,4533
9,122079170,122079436,del,NA19818,0,,266
9,43581016,43738822,del,NA19385,0,,157806
9,132120976,132121421,del,NA18520,0,,445
9,23908240,23916151,del,HG00160,0,,7911
9,547416,547773,del,NA12751,0,,357
9,86090059,86100651,del,HG00443,0,,10592
9,114726362,114726893,del,HG00280,0,,531
9,100786562,100789270,del,NA20510,0,,2708
9,107874931,107875631,del,NA19225,0,,700
9,90907856,90909595,del,NA18867,0,,1739
9,244023,245927,del,HG00334,0,,1904
9,14686825,14688596,del,NA18867,0,,1771
9,23328679,23329030,del,HG01365,0,,351
9,117087508,117094285,del,NA19471,0,,6777
9,116138541,116138828,del,NA18549,0,,287
9,93604468,93604767,del,NA19655,0,,299
9,114350967,114352076,del,NA18988,0,,1109
9,43446916,43542522,del,NA12004,0,,95606
9,131429714,131430317,del,NA19711,0,,603
9,71321713,71323109,del,NA19394,0,,1396
9,27486532,27487373,del,NA19474,0,,841
9,34044271,34046514,del,NA12272,0,,2243
9,43610516,43693922,del,NA18620,0,,83406
9,19018589,19021925,del,NA18953,0,,3336
9,104684097,104685338,del,HG00422,0,,1241
9,38035802,38039386,del,NA19436,0,,3584
9,140223206,140224191,del,NA18908,0,,985
9,119535082,119543711,del,HG01102,0,,8629
9,98336688,98336900,del,HG01187,0,,212
9,105710707,105719865,del,HG00378,0,,9158
9,124508278,124509467,del,NA19835,0,,1189
9,11691644,11694286,del,NA19462,0,,2642
9,135437294,135441487,del,HG00278,0,,4193
9,12351072,12391338,del,NA18950,0,,40266
9,139495417,139495685,del,NA19311,0,,268
9,132900562,132901844,del,NA18573,0,,1282
9,82475488,82475832,del,NA19428,0,,344
9,12184678,12234128,del,NA12272,0,,49450
9,33103777,33106160,del,NA18916,0,,2383
9,133236005,133237078,del,NA19058,0,,1073
9,138214063,138217603,del,NA19075,0,,3540
9,134958731,134959210,del,NA19373,0,,479
9,44814616,44844322,del,HG01136,0,,29706
9,8164771,8166394,del,HG00437,0,,1623
9,107363066,107366622,del,NA19451,0,,3556
9,5133113,5133976,del,NA19137,0,,863
9,30018528,30023237,del,HG00131,0,,4709
9,6672237,6675374,del,NA19347,0,,3137
9,97286348,97286981,del,NA20519,0,,633
9,105853828,105859739,del,NA19917,0,,5911
9,128940631,128940892,del,HG00740,0,,261
9,133391185,133391488,del,NA19395,0,,303
9,140222292,140222496,del,HG00404,0,,204
9,104569694,104570482,del,NA20527,0,,788
9,19358450,19359746,del,NA19469,0,,1296
9,78772330,78772703,del,NA19398,0,,373
9,107362831,107370339,del,NA19472,0,,7508
9,40135616,40158522,del,NA18626,0,,22906
9,29451740,29451929,del,HG00479,0,,189
9,14686710,14688578,del,NA18871,0,,1868
9,140365879,140367235,del,HG00231,0,,1356
9,113437452,113439020,del,NA19394,0,,1568
9,11934100,11939810,del,NA18562,0,,5710
9,123839993,123840129,del,HG00654,0,,136
9,30997469,31001440,del,NA18747,0,,3971
9,114333291,114333883,del,HG00427,0,,592
9,101276313,101276708,del,HG01516,0,,395
9,39184816,39626422,del,HG01390,0,,441606
9,131814246,131815465,del,HG00261,0,,1219
9,130188530,130190124,del,HG00143,0,,1594
9,20130920,20131144,del,NA18511,0,,224
9,642168,648239,del,NA19445,0,,6071
9,131191825,131196335,del,NA19472,0,,4510
9,15310913,15318247,del,NA19654,0,,7334
9,76066971,76080255,del,NA19375,0,,13284
9,35662934,35664531,del,NA12830,0,,1597
9,65608216,65687422,del,NA18963,0,,79206
9,137495641,137497666,del,NA18853,0,,2025
9,9901023,9917919,del,NA18908,0,,16896
9,31361526,31369524,del,NA18868,0,,7998
9,125435740,125435906,del,NA19374,0,,166
9,128243565,128243630,del,NA18861,0,,65
9,76236760,76242019,del,NA12717,0,,5259
9,52725,69541,del,HG01170,0,,16816
9,88018447,88019788,del,HG00188,0,,1341
9,25030829,25031790,del,NA20798,0,,961
9,95535919,95546500,del,HG01366,0,,10581
9,114165668,114169731,del,HG00662,0,,4063
9,5641632,5642810,del,NA19144,0,,1178
9,106328692,106331703,del,HG01191,0,,3011
9,13896326,13901986,del,HG01190,0,,5660
9,134244576,134249177,del,HG00328,0,,4601
9,129670199,129670645,del,NA19064,0,,446
9,107530190,107535319,del,NA11893,0,,5129
9,28719579,28748783,del,NA07357,0,,29204
9,129520566,129523472,del,NA19679,0,,2906
9,122436359,122437243,del,HG00123,0,,884
9,108527466,108539922,del,NA18984,0,,12456
9,132424328,132424894,del,NA11893,0,,566
9,136761039,136761267,del,NA20504,0,,228
9,82982213,82985144,del,NA19470,0,,2931
9,74827225,74828546,del,NA19428,0,,1321
9,94563348,94566062,del,NA19099,0,,2714
9,131384001,131385790,del,NA19430,0,,1789
9,81999819,82001145,del,HG00708,0,,1326
9,122596179,122597039,del,NA19779,0,,860
9,131694898,131695031,del,NA18550,0,,133
9,93835630,93835713,del,NA19093,0,,83
9,22653394,22653768,del,NA18973,0,,374
9,114970757,114972740,del,NA18498,0,,1983
9,4008883,4022071,del,NA19448,0,,13188
9,66776430,66853147,del,NA19058,0,,76717
9,11152961,11161160,del,HG01125,0,,8199
9,105130217,105132425,del,HG00281,0,,2208
9,9692168,9693216,del,NA19256,0,,1048
9,138054379,138054558,del,HG00277,0,,179
9,17277057,17277293,del,NA19377,0,,236
9,25258361,25352494,del,HG01354,0,,94133
9,127605354,127611467,del,NA19651,0,,6113
9,140773610,140777194,del,NA20783,0,,3584
9,33015517,33023807,del,NA18501,0,,8290
9,34680169,34681590,del,NA20585,0,,1421
9,24243087,24243332,del,NA18517,0,,245
9,100806314,100814611,del,NA19138,0,,8297
9,99395965,99396743,del,NA18867,0,,778
9,3656600,3656807,del,NA10851,0,,207
9,110971856,110974096,del,NA19397,0,,2240
9,84154878,84159728,del,HG00693,0,,4850
9,22625772,22688182,del,NA18532,0,,62410
9,140180086,140186296,del,HG00589,0,,6210
9,115825342,115852549,del,NA19731,0,,27207
9,112118945,112124036,del,NA18574,0,,5091
9,46908616,46918322,del,NA19728,0,,9706
9,130181816,130186722,del,NA18548,0,,4906
9,43563316,43724422,del,NA19900,0,,161106
9,108508076,108548563,del,HG00640,0,,40487
9,508544,508825,del,NA19393,0,,281
9,115292825,115293907,del,NA19682,0,,1082
9,36588197,36588520,del,NA19711,0,,323
9,113659228,113688361,del,HG00533,0,,29133
9,8848769,8849002,del,NA20809,0,,233
9,30587896,30671327,del,NA19068,0,,83431
9,91589360,91589490,del,NA18988,0,,130
9,756597,770666,del,NA19319,0,,14069
9,92510242,92510901,del,NA19776,0,,659
9,25722879,25724802,del,NA18858,0,,1923
9,19547517,19548287,del,NA19901,0,,770
9,91009939,91014040,del,HG00173,0,,4101
9,11935383,11953194,del,NA19473,0,,17811
9,28676974,28710753,del,HG00698,0,,33779
9,69354716,69375522,del,HG00671,0,,20806
9,74681462,74684837,del,NA19449,0,,3375
9,76060593,76062850,del,HG01069,0,,2257
9,8991822,8997972,del,NA19707,0,,6150
9,134657042,134663424,del,HG00640,0,,6382
9,132494314,132494841,del,HG00501,0,,527
9,16988098,17064852,del,NA20756,0,,76754
9,76805835,76806330,del,HG01108,0,,495
9,140909858,140910036,del,NA19703,0,,178
9,74670116,74671422,del,HG01183,0,,1306
9,10136559,10137720,del,NA18499,0,,1161
9,133030642,133034801,del,HG00533,0,,4159
9,88088061,88088325,del,HG01101,0,,264
9,135400161,135400532,del,NA18989,0,,371
9,99062582,99062920,del,HG01390,0,,338
9,110537535,110540611,del,NA19658,0,,3076
9,139533262,139534306,del,NA19463,0,,1044
9,22496716,22503122,del,HG01461,0,,6406
9,400098,400952,del,NA19703,0,,854
9,44785116,44790922,del,HG00534,0,,5806
9,134297626,134300557,del,NA19819,0,,2931
9,87319254,87321508,del,HG00656,0,,2254
9,133305073,133305183,del,NA12878,0,,110
9,105775316,105778622,del,NA19056,0,,3306
9,106717450,106720752,del,NA19380,0,,3302
9,124223281,124231143,del,NA19138,0,,7862
9,137154556,137154704,del,HG00154,0,,148
9,91228116,91235112,del,NA19066,0,,6996
9,33488709,33492831,del,NA19130,0,,4122
9,18045767,18049097,del,NA19000,0,,3330
9,102043048,102043958,del,NA12775,0,,910
9,15609280,15617426,del,HG00427,0,,8146
9,126658174,126665485,del,NA18559,0,,7311
9,19279052,19279304,del,NA19204,0,,252
9,73766173,73771789,del,NA20527,0,,5616
9,24624893,24629923,del,HG00331,0,,5030
9,83071656,83072065,del,NA12878,0,,409
9,92019506,92020178,del,HG00663,0,,672
9,136154347,136154433,del,HG00479,0,,86
9,89675328,89683015,del,HG01462,0,,7687
9,96003826,96004229,del,NA19463,0,,403
9,18286560,18286739,del,NA19064,0,,179
9,99600517,99602951,del,NA19717,0,,2434
9,28840002,28847117,del,NA19395,0,,7115
9,22123589,22124099,del,NA20582,0,,510
9,31042915,31043139,del,HG00583,0,,224
9,84872197,84879304,del,NA19651,0,,7107
9,26707652,26788038,del,HG00707,0,,80386
9,129432,133181,del,NA19819,0,,3749
9,12143129,12147632,del,HG00274,0,,4503
9,139047653,139052809,del,HG00543,0,,5156
9,24145513,24150288,del,HG00259,0,,4775
9,114725851,114726836,del,NA18567,0,,985
9,97376231,97376690,del,HG00244,0,,459
9,137525540,137527466,del,NA19469,0,,1926
9,38678651,38678950,del,HG01356,0,,299
9,101347985,101348316,del,HG01140,0,,331
9,93761105,93765956,del,NA19334,0,,4851
9,120272263,120274970,del,NA19682,0,,2707
9,29080611,29109602,del,HG00472,0,,28991
9,99902666,99903772,del,NA19916,0,,1106
9,36474246,36475079,del,NA18501,0,,833
9,6700452,6710572,del,NA19663,0,,10120
9,96433542,96433846,del,NA12283,0,,304
9,98269216,98273222,del,HG00698,0,,4006
9,43446916,43541022,del,NA19701,0,,94106
9,955574,957736,del,HG01491,0,,2162
9,26339805,26358076,del,NA19317,0,,18271
9,634893,636431,del,HG00442,0,,1538
9,92995337,92998594,del,HG01197,0,,3257
9,105763095,105823162,del,HG00375,0,,60067
9,133602652,133603653,del,NA19719,0,,1001
9,132373845,132374775,del,NA19985,0,,930
9,119698920,119700667,del,HG00663,0,,1747
9,108960992,108972089,del,NA19391,0,,11097
9,30345776,30346094,del,NA18861,0,,318
9,22991731,22992241,del,HG00428,0,,510
9,11045761,11047955,del,HG00671,0,,2194
9,104714616,104724322,del,NA19726,0,,9706
9,127330725,127331355,del,NA19099,0,,630
9,29672076,29676185,del,NA12763,0,,4109
9,28740085,28767110,del,NA19313,0,,27025
9,135622635,135627333,del,NA20509,0,,4698
9,130633229,130634042,del,NA19909,0,,813
9,9965280,9971884,del,NA18542,0,,6604
9,110046557,110053383,del,HG01047,0,,6826
9,45679450,45681071,del,NA20759,0,,1621
9,88028756,88030289,del,HG00151,0,,1533
9,96730345,96730597,del,HG00273,0,,252
9,79149950,79160744,del,HG00123,0,,10794
9,88473471,88476170,del,NA19404,0,,2699
9,82028158,82033446,del,NA18547,0,,5288
9,78004516,78011972,del,HG01334,0,,7456
9,16882532,16885017,del,HG00254,0,,2485
9,131191909,131196099,del,NA19472,0,,4190
9,99248813,99249550,del,HG00123,0,,737
9,117730126,117731494,del,NA18548,0,,1368
9,33604177,33604590,del,NA19350,0,,413
9,137910295,137910546,del,NA20289,0,,251
9,6276096,6276383,del,HG01440,0,,287
9,29932800,29932891,del,NA19360,0,,91
9,11921129,11998886,del,NA12383,0,,77757
9,871593,872313,del,NA19009,0,,720
9,128502557,128503851,del,NA18505,0,,1294
9,4734944,4736820,del,NA19380,0,,1876
9,109675897,109676565,del,NA12718,0,,668
9,108508002,108548482,del,HG00311,0,,40480
9,102878587,102880650,del,HG00182,0,,2063
9,34935434,34938733,del,HG00463,0,,3299
9,14287262,14291287,del,NA11843,0,,4025
9,400355,400664,del,NA20294,0,,309
9,93603726,93604461,del,HG01061,0,,735
9,19461373,19465390,del,HG01069,0,,4017
9,127947708,127950400,del,HG01101,0,,2692
9,103672544,103682393,del,HG01125,0,,9849
9,41969216,41984022,del,NA20783,0,,14806
9,32713128,32731783,del,NA19077,0,,18655
9,43470462,43541146,del,HG00524,0,,70684
9,80166791,80168620,del,HG00708,0,,1829
9,91909510,91911790,del,NA20530,0,,2280
9,79452250,79453453,del,NA19462,0,,1203
9,78712153,78712371,del,NA19398,0,,218
9,134300668,134303444,del,HG00533,0,,2776
9,5106620,5115631,del,NA19449,0,,9011
9,128154868,128155632,del,NA12046,0,,764
9,74680174,74683919,del,NA19449,0,,3745
9,124405184,124406080,del,NA19663,0,,896
9,112430200,112430515,del,HG00610,0,,315
9,108464497,108465325,del,NA12348,0,,828
9,32985581,32986746,del,HG01137,0,,1165
9,126907190,126915709,del,NA19059,0,,8519
9,126180958,126185198,del,HG00654,0,,4240
9,35913345,35914157,del,NA19147,0,,812
9,72761806,72763900,del,HG00142,0,,2094
9,84421259,84423251,del,HG01083,0,,1992
9,24497883,24498818,del,NA20585,0,,935
9,107798522,107803446,del,HG00323,0,,4924
9,107366265,107378834,del,NA19235,0,,12569
9,107798066,107804272,del,HG01360,0,,6206
9,90715365,90715597,del,HG00614,0,,232
9,4397087,4398749,del,NA19331,0,,1662
9,17701584,17706100,del,HG01082,0,,4516
9,114024086,114036269,del,NA19835,0,,12183
9,5749939,5751516,del,NA19471,0,,1577
9,99913299,99918812,del,NA12778,0,,5513
9,107822347,107822725,del,NA12275,0,,378
9,130812929,130816218,del,NA12058,0,,3289
9,124358848,124359051,del,NA19137,0,,203
9,97462531,97465501,del,NA19238,0,,2970
9,80901827,80902787,del,NA19474,0,,960
9,90933794,90937520,del,NA19648,0,,3726
9,22385497,22386084,del,NA19257,0,,587
9,110326371,110327205,del,NA18489,0,,834
9,82845160,82845497,del,NA19726,0,,337
9,89298111,89302132,del,NA18542,0,,4021
9,12132993,12134929,del,NA20515,0,,1936
9,75890481,75893927,del,NA19003,0,,3446
9,9209766,9211135,del,NA19719,0,,1369
9,123852315,123852455,del,HG00315,0,,140
9,9389164,9390663,del,HG01488,0,,1499
9,32711213,32729829,del,HG00116,0,,18616
9,41281116,41358522,del,HG00663,0,,77406
9,104219695,104220378,del,NA19401,0,,683
9,19524031,19526708,del,HG00346,0,,2677
9,124831362,124832270,del,HG00277,0,,908
9,134461872,134462112,del,HG00513,0,,240
9,140713013,140714032,del,HG01357,0,,1019
9,135757095,135757894,del,NA19834,0,,799
9,36523596,36524589,del,NA19443,0,,993
9,38514065,38517129,del,NA20322,0,,3064
9,139612634,139612706,del,NA18549,0,,72
9,130765641,130767248,del,NA18941,0,,1607
9,96116960,96125005,del,NA19901,0,,8045
9,80231817,80233581,del,HG00339,0,,1764
9,94214949,94216396,del,NA19396,0,,1447
9,131210282,131216817,del,HG00595,0,,6535
9,44243116,44280722,del,NA19914,0,,37606
9,4376417,4377644,del,NA12546,0,,1227
9,106568300,106569729,del,NA18623,0,,1429
9,5750020,5751598,del,NA19471,0,,1578
9,117082216,117084772,del,HG00683,0,,2556
9,87772754,87775642,del,NA19704,0,,2888
9,86202460,86206397,del,NA20800,0,,3937
9,10404561,10405091,del,NA19225,0,,530
9,97250785,97308913,del,NA18626,0,,58128
9,88426178,88427628,del,NA19102,0,,1450
9,21592460,21594545,del,NA18552,0,,2085
9,95634587,95634723,del,HG01350,0,,136
9,124411494,124411796,del,HG01174,0,,302
9,131564188,131564482,del,HG01461,0,,294
9,273756,275657,del,NA19311,0,,1901
9,1192001,1571212,del,NA18873,0,,379211
9,91292171,91292416,del,NA18907,0,,245
9,94395816,94403298,del,HG00190,0,,7482
9,42312516,42360222,del,NA20800,0,,47706
9,132325724,132327803,del,NA18596,0,,2079
9,104496700,104498218,del,HG00131,0,,1518
9,26896110,26902791,del,HG00338,0,,6681
9,131210265,131216874,del,HG00595,0,,6609
9,96170572,96212262,del,NA20809,0,,41690
9,91827773,91832473,del,HG00171,0,,4700
9,128143109,128144921,del,HG00427,0,,1812
9,44244216,44279222,del,NA20505,0,,35006
9,114351047,114351809,del,NA18988,0,,762
9,78004293,78011800,del,HG00245,0,,7507
9,98332754,98333832,del,NA18610,0,,1078
9,2191936,2197746,del,HG00702,0,,5810
9,137153309,137154189,del,NA19448,0,,880
9,38515119,38518220,del,NA19462,0,,3101
9,10447114,10451775,del,NA19904,0,,4661
9,109276453,109279878,del,NA19712,0,,3425
9,79831264,79832946,del,NA18950,0,,1682
9,27788196,27788307,del,HG01052,0,,111
9,88521568,88521854,del,NA19379,0,,286
9,2286270,2288064,del,NA19909,0,,1794
9,113024816,113031822,del,HG00120,0,,7006
9,135999346,135999548,del,HG01488,0,,202
9,114993240,114993610,del,NA19920,0,,370
9,80898612,80898735,del,HG01350,0,,123
9,112824012,112824317,del,NA19819,0,,305
9,126675962,126681954,del,HG00740,0,,5992
9,22496716,22504522,del,HG00259,0,,7806
9,78136719,78137524,del,NA19779,0,,805
9,30908192,30909482,del,NA18867,0,,1290
9,34726220,34835264,del,NA19074,0,,109044
9,138362937,138363278,del,NA19685,0,,341
9,42312516,42339922,del,HG00244,0,,27406
9,125676510,125677082,del,NA19379,0,,572
9,140253509,140255979,del,NA19654,0,,2470
9,139747439,139747566,del,NA11918,0,,127
9,120172691,120173340,del,NA20581,0,,649
9,46368816,46423022,del,HG01149,0,,54206
9,3835764,3836569,del,NA19676,0,,805
9,31239842,31240052,del,HG00740,0,,210
9,38447193,38449617,del,NA19777,0,,2424
9,86398900,86399280,del,NA07000,0,,380
9,129561260,129566761,del,NA19456,0,,5501
9,33376743,33378909,del,HG00701,0,,2166
9,109739493,109742052,del,NA19399,0,,2559
9,84930644,84932454,del,HG00559,0,,1810
9,139667329,139677234,del,NA19722,0,,9905
9,99396367,99396900,del,NA18508,0,,533
9,3988842,3996757,del,HG01066,0,,7915
9,16955632,16960014,del,NA18874,0,,4382
9,24703591,24760674,del,HG01136,0,,57083
9,34109929,34116765,del,NA19385,0,,6836
9,127925851,127931140,del,HG00476,0,,5289
9,66835147,66835470,del,NA12778,0,,323
9,137296715,137297093,del,NA19679,0,,378
9,136762008,136763469,del,NA18868,0,,1461
9,138194298,138196223,del,NA18541,0,,1925
9,43471216,43542322,del,NA19682,0,,71106
9,12645787,12649026,del,NA19138,0,,3239
9,136065816,136065984,del,HG01550,0,,168
9,26512927,26513242,del,NA19072,0,,315
9,871366,872095,del,NA19213,0,,729
9,34181523,34182288,del,NA18536,0,,765
9,67711316,67762922,del,HG01491,0,,51606
9,44243016,44281122,del,HG01489,0,,38106
9,606288,606620,del,NA18510,0,,332
9,11440058,11442190,del,NA18597,0,,2132
9,23005775,23014249,del,NA19312,0,,8474
9,135389290,135389500,del,NA18934,0,,210
9,88695989,88697312,del,HG00325,0,,1323
9,136377069,136377446,del,NA12413,0,,377
9,3063017,3073548,del,HG00186,0,,10531
9,112421648,112423270,del,HG00656,0,,1622
9,139054485,139059014,del,HG00464,0,,4529
9,15157388,15159632,del,NA19384,0,,2244
9,105130217,105132432,del,HG00281,0,,2215
9,29591757,29592479,del,NA19391,0,,722
9,106398899,106426983,del,NA19776,0,,28084
9,100997335,100998282,del,NA19439,0,,947
9,94295240,94296709,del,NA18628,0,,1469
9,28077559,28079206,del,NA19456,0,,1647
9,95546969,95547393,del,HG00608,0,,424
9,81437930,81471168,del,NA18907,0,,33238
9,129492236,129492682,del,NA19355,0,,446
9,113025216,113031822,del,HG00282,0,,6606
9,129334355,129337919,del,HG00475,0,,3564
9,67711316,67745122,del,HG01073,0,,33806
9,132924917,132925232,del,NA19375,0,,315
9,14215128,14215469,del,NA19201,0,,341
9,140975936,140982025,del,NA19060,0,,6089
9,6508005,6510735,del,NA19462,0,,2730
9,134260502,134265977,del,NA19749,0,,5475
9,25258416,25352562,del,HG01354,0,,94146
9,92176046,92177975,del,NA19087,0,,1929
9,138960090,138963155,del,NA18870,0,,3065
9,27788200,27790078,del,HG01082,0,,1878
9,71198816,71200922,del,HG01124,0,,2106
9,27619441,27624786,del,NA19379,0,,5345
9,30537562,30572408,del,HG00596,0,,34846
9,91130561,91134013,del,NA20334,0,,3452
9,84003105,84003256,del,HG00537,0,,151
9,7306236,7321389,del,NA19716,0,,15153
9,23290079,23299889,del,NA18599,0,,9810
9,29923689,29998788,del,NA07048,0,,75099
9,94538999,94539928,del,HG01101,0,,929
9,133752169,133753239,del,HG01357,0,,1070
9,83303343,83311791,del,HG00331,0,,8448
9,132297994,132299067,del,NA19661,0,,1073
9,79555316,79557822,del,NA20805,0,,2506
9,112995116,112995172,del,HG00732,0,,56
9,11962753,11973509,del,NA07347,0,,10756
9,10908809,10909099,del,NA19172,0,,290
9,128907565,128912022,del,HG00619,0,,4457
9,86108094,86109332,del,HG00258,0,,1238
9,6217848,6217989,del,HG00260,0,,141
9,27629790,27635147,del,HG00120,0,,5357
9,90832355,90832889,del,NA19138,0,,534
9,139059508,139059853,del,HG00476,0,,345
9,94148160,94148482,del,NA19099,0,,322
9,43581016,43693922,del,HG00534,0,,112906
9,44833816,44842422,del,NA11918,0,,8606
9,23025604,23028295,del,HG00236,0,,2691
9,116912082,116915964,del,HG00146,0,,3882
9,140365908,140367034,del,HG00231,0,,1126
9,7226401,7234057,del,HG00244,0,,7656
9,43446916,43561922,del,NA19010,0,,115006
9,76149094,76150020,del,HG00500,0,,926
9,43607516,43693722,del,NA19782,0,,86206
9,132748845,132750631,del,NA19434,0,,1786
9,117985903,117990964,del,NA19360,0,,5061
9,125287,128172,del,HG00142,0,,2885
9,44777416,44790922,del,HG01521,0,,13506
9,99901143,99904262,del,NA19240,0,,3119
9,124847628,124849348,del,HG00657,0,,1720
9,93787610,93789386,del,NA19063,0,,1776
9,140528677,140623563,del,HG01342,0,,94886
9,74681066,74683722,del,NA20340,0,,2656
9,97222907,97226123,del,HG01488,0,,3216
9,28523278,28561911,del,HG00464,0,,38633
9,129488186,129490782,del,NA19917,0,,2596
9,138344138,138345445,del,NA19062,0,,1307
9,16847393,16847518,del,NA19391,0,,125
9,86632091,86635308,del,NA18552,0,,3217
9,107596187,107597103,del,NA18631,0,,916
9,107362850,107369023,del,NA19375,0,,6173
9,108491720,108494948,del,HG00580,0,,3228
9,137906293,137906435,del,NA20299,0,,142
9,72839359,72840581,del,HG00737,0,,1222
9,111060929,111064999,del,NA18571,0,,4070
9,44243116,44279022,del,NA12717,0,,35906
9,22666438,22666929,del,NA12751,0,,491
9,12008236,12121382,del,HG01073,0,,113146
9,91130962,91133567,del,NA19678,0,,2605
9,8660202,8663197,del,NA19257,0,,2995
9,23362801,23377685,del,HG00160,0,,14884
9,123936039,123936958,del,NA07056,0,,919
9,1447357,1448439,del,NA19093,0,,1082
9,34726145,34835190,del,HG00595,0,,109045
9,28542181,28569456,del,HG00281,0,,27275
9,138153839,138153931,del,HG00740,0,,92
9,131700925,131702157,del,HG00117,0,,1232
9,114902342,114902657,del,NA19360,0,,315
9,34003858,34005993,del,NA20757,0,,2135
9,121148187,121158375,del,NA19072,0,,10188
9,74256658,74260132,del,NA18853,0,,3474
9,514141,527931,del,HG01108,0,,13790
9,105628739,105633374,del,NA18633,0,,4635
9,86108175,86109444,del,HG00258,0,,1269
9,34055725,34059045,del,HG00318,0,,3320
9,7371813,7372131,del,NA07357,0,,318
9,113024576,113037093,del,HG00534,0,,12517
9,35364129,35364311,del,NA19461,0,,182
9,44806016,44854022,del,HG00116,0,,48006
9,21791473,21792504,del,NA18545,0,,1031
9,140324291,140324553,del,NA19394,0,,262
9,5385346,5403373,del,NA19377,0,,18027
9,131936716,131941322,del,HG00327,0,,4606
9,67748016,67781822,del,HG00176,0,,33806
9,106195741,106196082,del,NA11919,0,,341
9,79124512,79124828,del,NA19080,0,,316
9,24502066,24519098,del,NA11843,0,,17032
9,74679277,74684274,del,NA12340,0,,4997
9,91538465,91539066,del,NA19469,0,,601
9,8280903,8286226,del,NA19093,0,,5323
9,139314518,139314706,del,NA19373,0,,188
9,89874577,89879571,del,NA19723,0,,4994
9,140674619,140674770,del,HG00256,0,,151
9,43316516,43445222,del,NA18510,0,,128706
9,2141541,2142631,del,HG00620,0,,1090
9,12580871,12616247,del,NA07347,0,,35376
9,136625194,136626267,del,NA18593,0,,1073
9,23115019,23115320,del,HG00536,0,,301
9,34112777,34117770,del,HG00593,0,,4993
9,15157710,15159772,del,HG01390,0,,2062
9,36309279,36309600,del,HG01149,0,,321
9,46913216,46918322,del,HG01360,0,,5106
9,11210610,11215868,del,NA19701,0,,5258
9,138961323,138966168,del,NA19000,0,,4845
9,130033158,130034815,del,NA19311,0,,1657
9,43571316,43775022,del,NA18520,0,,203706
9,19671768,19673474,del,NA19200,0,,1706
9,98717676,98718009,del,NA19116,0,,333
9,110235514,110238422,del,NA18619,0,,2908
9,43401516,43541022,del,NA19443,0,,139506
9,136360799,136361331,del,NA20787,0,,532
9,13571327,13575950,del,NA19651,0,,4623
9,133381516,133385722,del,NA20801,0,,4206
9,107361516,107371972,del,NA18874,0,,10456
9,111770471,111771200,del,NA19700,0,,729
9,121748859,121751530,del,HG00525,0,,2671
9,94061205,94064415,del,NA19472,0,,3210
9,78644349,78652074,del,NA18984,0,,7725
9,5423841,5424013,del,NA18949,0,,172
9,132102607,132102837,del,HG00274,0,,230
9,133785185,133792739,del,NA19003,0,,7554
9,113477171,113480105,del,NA19198,0,,2934
9,71736916,71745222,del,HG00524,0,,8306
9,44857954,44889313,del,NA20533,0,,31359
9,127056644,127058110,del,NA19681,0,,1466
9,6701966,6711272,del,NA20757,0,,9306
9,43069087,44053953,del,HG00275,0,,984866
9,27030483,27032763,del,NA12775,0,,2280
9,69736198,70100832,del,HG00149,0,,364634
9,93172662,93175035,del,HG00346,0,,2373
9,110658281,110662705,del,NA19319,0,,4424
9,91408482,91409281,del,NA20525,0,,799
9,15285124,15285714,del,HG00614,0,,590
9,115909485,115910173,del,HG00404,0,,688
9,131412045,131416007,del,NA20332,0,,3962
9,77146758,77147390,del,NA18977,0,,632
9,136170927,136176688,del,HG00252,0,,5761
9,74601584,74605295,del,NA19661,0,,3711
9,703243,703965,del,NA19681,0,,722
9,8864916,8872470,del,NA18628,0,,7554
9,119016516,119021622,del,HG00689,0,,5106
9,710435,730478,del,NA20533,0,,20043
9,134747938,134748092,del,NA18502,0,,154
9,139429416,139430022,del,NA19900,0,,606
9,33488621,33492725,del,NA18874,0,,4104
9,19313356,19315510,del,NA19334,0,,2154
9,15605121,15608663,del,NA19371,0,,3542
9,136974703,136975007,del,HG01052,0,,304
9,90816996,90822013,del,NA19660,0,,5017
9,6308351,6318505,del,NA19788,0,,10154
9,95811873,95812664,del,NA18856,0,,791
9,28047716,28049222,del,NA19711,0,,1506
9,119821317,119823840,del,NA11992,0,,2523
9,29092574,29098014,del,NA19713,0,,5440
9,132721627,132723484,del,NA19444,0,,1857
9,11553164,11557450,del,NA11843,0,,4286
9,28840616,28848272,del,NA18873,0,,7656
9,8901351,8903577,del,NA20759,0,,2226
9,34110984,34116784,del,NA19385,0,,5800
9,26119518,26124603,del,HG00690,0,,5085
9,15595667,15600008,del,HG01148,0,,4341
9,136583502,136583983,del,HG00595,0,,481
9,124438578,124440073,del,NA18618,0,,1495
9,84690769,84691836,del,NA07037,0,,1067
9,118157151,118171811,del,NA19711,0,,14660
9,128155425,128162234,del,NA06986,0,,6809
9,1355345,1360254,del,NA18611,0,,4909
9,74375321,74375618,del,NA06984,0,,297
9,121440178,121440580,del,NA18620,0,,402
9,117206078,117213991,del,NA19107,0,,7913
9,129138909,129140656,del,NA19190,0,,1747
9,23370996,23372429,del,NA19914,0,,1433
9,128633472,128635278,del,NA18856,0,,1806
9,114746729,114747149,del,NA19238,0,,420
9,135252664,135252784,del,NA20760,0,,120
9,107932008,107932630,del,NA19171,0,,622
9,4738431,4739010,del,HG00331,0,,579
9,26124278,26124388,del,HG00537,0,,110
9,18662892,18665530,del,NA19461,0,,2638
9,44876352,44880204,del,NA19900,0,,3852
9,122667800,122670193,del,NA20515,0,,2393
9,81907501,81909585,del,HG01072,0,,2084
9,107821322,107822793,del,NA20535,0,,1471
9,33587783,33588441,del,NA19315,0,,658
9,42312416,42339522,del,HG00625,0,,27106
9,31586487,31590996,del,NA19443,0,,4509
9,134258816,134266022,del,HG00443,0,,7206
9,113025216,113029822,del,HG00640,0,,4606
9,115197084,115199990,del,NA19655,0,,2906
9,133381566,133386372,del,HG00327,0,,4806
9,577276,580468,del,NA20819,0,,3192
9,4526798,4536821,del,HG00443,0,,10023
9,11907468,12013452,del,NA19446,0,,105984
9,130881110,130881304,del,HG01052,0,,194
9,20212040,20213487,del,NA18511,0,,1447
9,31028065,31030898,del,NA19376,0,,2833
9,114324795,114325994,del,HG01351,0,,1199
9,115777710,115782254,del,NA12043,0,,4544
9,88042230,88044785,del,HG00595,0,,2555
9,126616959,126617683,del,HG01095,0,,724
9,91292207,91292438,del,HG00141,0,,231
9,92799583,92803117,del,HG01137,0,,3534
9,16289390,16290270,del,NA19395,0,,880
9,138194154,138196239,del,NA18945,0,,2085
9,108372372,108373335,del,NA19900,0,,963
9,11045836,11047458,del,HG00671,0,,1622
9,104714843,104724481,del,HG00708,0,,9638
9,2147643,2151529,del,HG00325,0,,3886
9,11783922,11784295,del,NA20515,0,,373
9,38125375,38126711,del,NA19717,0,,1336
9,1446521,1452461,del,HG01191,0,,5940
9,27740584,27744053,del,HG00331,0,,3469
9,85501,111579,dup,HG00560,0,,26078
9,148486,193583,dup,HG03941,0,,45097
9,224074,289974,dup,HG00179,0,,65900
9,224230,276540,dup,HG01686,0,,52310
9,252465,489287,dup,HG01602,0,,236822
9,307021,355483,dup,HG01119,0,,48462
9,319775,547052,dup,HG01686,0,,227277
9,371937,403634,dup,HG01686,0,,31697
9,389985,485014,dup,HG01686,0,,95029
9,514301,527559,dup,HG01108,0,,13258
9,514830,877545,dup,HG01602,0,,362715
9,528544,547810,dup,HG03577,0,,19266
9,541506,555452,dup,HG04152,0,,13946
9,556503,577362,dup,HG01864,0,,20859
9,572426,595092,dup,HG01864,0,,22666
9,582051,593885,dup,HG01697,0,,11834
9,591313,605689,dup,HG01375,0,,14376
9,608369,623960,dup,HG02484,0,,15591
9,623461,642866,dup,HG02142,0,,19405
9,642261,819008,dup,HG02142,0,,176747
9,647615,699308,dup,HG02142,0,,51693
9,715186,784298,dup,NA19256,0,,69112
9,831286,837195,dup,NA20854,0,,5909
9,857516,881246,dup,NA20854,0,,23730
9,1101898,1232603,dup,HG01353,0,,130705
9,1111872,1136581,dup,HG02891,0,,24709
9,1113543,1151215,dup,HG02891,0,,37672
9,1132824,1192924,dup,HG01353,0,,60100
9,1181206,1246799,dup,HG03976,0,,65593
9,1386156,1531782,dup,HG01936,0,,145626
9,1477949,1507930,dup,HG01936,0,,29981
9,1514181,1533804,dup,HG01936,0,,19623
9,1523347,1630535,dup,HG03514,0,,107188
9,1543928,1572469,dup,HG03514,0,,28541
9,1587890,1592054,dup,HG00329,0,,4164
9,1599953,1632810,dup,HG03514,0,,32857
9,1686347,1759876,dup,HG02879,0,,73529
9,2745732,2816795,dup,HG00442,0,,71063
9,2745926,2793850,dup,HG00442,0,,47924
9,3112470,3119165,dup,HG02401,0,,6695
9,4009345,4023747,dup,HG02322,0,,14402
9,4357604,4382091,dup,HG03112,0,,24487
9,4361790,4384990,dup,HG03112,0,,23200
9,4503000,4539232,dup,HG03788,0,,36232
9,5302684,5339885,dup,HG00132,0,,37201
9,6137627,6254604,dup,HG01968,0,,116977
9,6308141,6318290,dup,NA19788,0,,10149
9,6504022,6523956,dup,HG00258,0,,19934
9,6547222,6640759,dup,HG00109,0,,93537
9,6562815,6595947,dup,HG00109,0,,33132
9,6618139,6643071,dup,HG00109,0,,24932
9,6620055,6757858,dup,HG00109,0,,137803
9,6652179,6657259,dup,HG00684,0,,5080
9,6663287,6671110,dup,HG00684,0,,7823
9,6669053,6683764,dup,HG00684,0,,14711
9,6680421,6690677,dup,HG00684,0,,10256
9,6688346,6697479,dup,HG00684,0,,9133
9,6700382,6709249,dup,HG00096,0,,8867
9,6721914,6726802,dup,HG00109,0,,4888
9,6730757,6738662,dup,HG00109,0,,7905
9,6745216,6962830,dup,HG00109,0,,217614
9,6748603,6753390,dup,HG00109,0,,4787
9,6759342,6805750,dup,NA18951,0,,46408
9,6774478,6789125,dup,NA18951,0,,14647
9,6794170,6800267,dup,HG02484,0,,6097
9,6803772,6930130,dup,HG00109,0,,126358
9,6911059,6974729,dup,HG02014,0,,63670
9,7288275,7373570,dup,NA18608,0,,85295
9,8020049,8032073,dup,HG02489,0,,12024
9,8864920,8872372,dup,HG00637,0,,7452
9,9685887,9709990,dup,HG02775,0,,24103
9,9799007,9828748,dup,HG01524,0,,29741
9,9898128,9919575,dup,NA18908,0,,21447
9,9953926,10018377,dup,NA19399,0,,64451
9,10312450,10328987,dup,HG00131,0,,16537
9,10647445,10706472,dup,HG00131,0,,59027
9,10652862,10699710,dup,HG00131,0,,46848
9,10818096,10845813,dup,HG03692,0,,27717
9,10821996,10884152,dup,NA19625,0,,62156
9,10857092,10870478,dup,HG01124,0,,13386
9,10898014,11077994,dup,NA19625,0,,179980
9,11085275,11115809,dup,HG02611,0,,30534
9,11117010,11186399,dup,NA19625,0,,69389
9,11152893,11276567,dup,HG01513,0,,123674
9,11213610,11245429,dup,NA19625,0,,31819
9,11249844,11265766,dup,HG03196,0,,15922
9,11264874,11288494,dup,HG03196,0,,23620
9,11429861,11462685,dup,HG02029,0,,32824
9,11440114,11465211,dup,HG02029,0,,25097
9,11589411,11599417,dup,HG02029,0,,10006
9,11633444,11724318,dup,HG00113,0,,90874
9,11699029,11751670,dup,HG03028,0,,52641
9,11700150,11722185,dup,HG00123,0,,22035
9,11730295,11875351,dup,HG03773,0,,145056
9,11812265,11852950,dup,HG00123,0,,40685
9,11934533,12112794,dup,HG00155,0,,178261
9,12112125,12343454,dup,HG02253,0,,231329
9,12114554,12156818,dup,HG01813,0,,42264
9,12148070,12175963,dup,HG02724,0,,27893
9,12166283,12213012,dup,HG00446,0,,46729
9,12171614,12188441,dup,HG00446,0,,16827
9,12182536,12245223,dup,HG01444,0,,62687
9,12350716,12392828,dup,NA18950,0,,42112
9,12401759,12469803,dup,NA21099,0,,68044
9,12457630,12493560,dup,HG01396,0,,35930
9,12462702,12492904,dup,HG01396,0,,30202
9,12480450,12569299,dup,HG03619,0,,88849
9,12509702,12612475,dup,HG03619,0,,102773
9,12570300,12619118,dup,HG03619,0,,48818
9,12621841,12766937,dup,NA21099,0,,145096
9,13324654,13342876,dup,HG01441,0,,18222
9,13636162,13658112,dup,HG00378,0,,21950
9,13643595,13715834,dup,HG00378,0,,72239
9,13663855,13673541,dup,HG00378,0,,9686
9,13685775,13737711,dup,HG00378,0,,51936
9,13880248,13909812,dup,NA19443,0,,29564
9,13914862,13927159,dup,HG03832,0,,12297
9,15132933,15151805,dup,HG02139,0,,18872
9,15140388,15207669,dup,HG02139,0,,67281
9,15163386,15206004,dup,HG02139,0,,42618
9,15166237,15337988,dup,HG02139,0,,171751
9,16058915,16096868,dup,HG02070,0,,37953
9,16068890,16098794,dup,HG02070,0,,29904
9,16624356,16638040,dup,HG02155,0,,13684
9,16806978,16820661,dup,HG04140,0,,13683
9,16988427,16991479,dup,HG01513,0,,3052
9,17581659,17633783,dup,HG00157,0,,52124
9,17582180,17636016,dup,HG00157,0,,53836
9,17641245,17721209,dup,HG02107,0,,79964
9,17983521,18081115,dup,NA20795,0,,97594
9,17997359,18281754,dup,NA20795,0,,284395
9,18083815,18152962,dup,NA20795,0,,69147
9,18298058,18320066,dup,HG02696,0,,22008
9,18329860,18372274,dup,NA20795,0,,42414
9,18831158,18952563,dup,NA20795,0,,121405
9,18833104,18856927,dup,HG02816,0,,23823
9,19142751,19210226,dup,HG02582,0,,67475
9,19276096,19375341,dup,HG03490,0,,99245
9,19283669,19298744,dup,HG02571,0,,15075
9,19322691,19441412,dup,HG03490,0,,118721
9,19379245,19517377,dup,HG03490,0,,138132
9,19433833,19551228,dup,HG03490,0,,117395
9,20417308,20431077,dup,HG03854,0,,13769
9,20935732,20947221,dup,NA18643,0,,11489
9,21193994,21211760,dup,HG00732,0,,17766
9,21238435,21267280,dup,NA11932,0,,28845
9,21251089,21278743,dup,NA11932,0,,27654
9,21547952,21619776,dup,HG03593,0,,71824
9,22289930,22483183,dup,HG00457,0,,193253
9,22837788,22950253,dup,HG02113,0,,112465
9,24082370,24142767,dup,HG00554,0,,60397
9,24157878,24248899,dup,HG00554,0,,91021
9,24248900,24351154,dup,HG00554,0,,102254
9,24462705,24498026,dup,NA11881,0,,35321
9,24468241,24496871,dup,HG00336,0,,28630
9,24524145,24529403,dup,HG00360,0,,5258
9,24702464,24754534,dup,HG00343,0,,52070
9,24707341,24714543,dup,HG01136,0,,7202
9,24713607,24718800,dup,HG01136,0,,5193
9,24752916,24759915,dup,HG01136,0,,6999
9,25134047,25241439,dup,NA20866,0,,107392
9,25221247,25264733,dup,HG00675,0,,43486
9,25259009,25281798,dup,HG01395,0,,22789
9,25296061,25352801,dup,HG01395,0,,56740
9,25368586,25419406,dup,HG01075,0,,50820
9,26264728,26434170,dup,HG00182,0,,169442
9,26339416,26369449,dup,HG00404,0,,30033
9,26359298,26366070,dup,HG01414,0,,6772
9,26364093,26396240,dup,HG01414,0,,32147
9,26377194,26403521,dup,HG01414,0,,26327
9,27200776,27239253,dup,NA19309,0,,38477
9,27247572,27295785,dup,NA19309,0,,48213
9,27629635,27635447,dup,HG00120,0,,5812
9,27748440,27811172,dup,NA18599,0,,62732
9,27768146,27818126,dup,NA18599,0,,49980
9,28047286,28051212,dup,HG00107,0,,3926
9,28131788,28147141,dup,HG04206,0,,15353
9,28154616,28207640,dup,HG04206,0,,53024
9,28452732,28478153,dup,HG04206,0,,25421
9,28456158,28480078,dup,HG00464,0,,23920
9,28529031,28685460,dup,HG00243,0,,156429
9,28650251,28674360,dup,HG00243,0,,24109
9,29390728,29426872,dup,HG00338,0,,36144
9,29444915,29450398,dup,HG02793,0,,5483
9,29788066,29848889,dup,HG01874,0,,60823
9,29923807,29999726,dup,NA07048,0,,75919
9,30181815,30229825,dup,HG01817,0,,48010
9,30226768,30255308,dup,HG01817,0,,28540
9,30253967,30387244,dup,HG03105,0,,133277
9,30255058,30337817,dup,HG01961,0,,82759
9,30333959,30382379,dup,HG03105,0,,48420
9,30388045,30457122,dup,HG01802,0,,69077
9,30446882,30568541,dup,NA20815,0,,121659
9,30489205,30571454,dup,HG01773,0,,82249
9,30527467,30618453,dup,HG01773,0,,90986
9,30565447,30601460,dup,HG01773,0,,36013
9,30617077,30681218,dup,HG02648,0,,64141
9,32080938,32090230,dup,HG00323,0,,9292
9,32104703,32126292,dup,HG00449,0,,21589
9,32556079,32559947,dup,HG01083,0,,3868
9,32569142,33069473,dup,HG00266,0,,500331
9,32610229,32619274,dup,NA12872,0,,9045
9,32709379,32736091,dup,HG02798,0,,26712
9,32716370,32735732,dup,HG02798,0,,19362
9,33484759,33510088,dup,HG01815,0,,25329
9,33871809,34738195,dup,HG01602,0,,866386
9,33982085,34003866,dup,NA20334,0,,21781
9,34010567,34052715,dup,HG02840,0,,42148
9,34080823,34134463,dup,NA20334,0,,53640
9,34143889,34153806,dup,NA20334,0,,9917
9,34151974,34160548,dup,NA20334,0,,8574
9,34163211,34171126,dup,NA20334,0,,7915
9,35058193,35071681,dup,HG01431,0,,13488
9,35170031,35175163,dup,HG01092,0,,5132
9,35229810,35233297,dup,NA20885,0,,3487
9,35499803,35547674,dup,HG00674,0,,47871
9,35504374,35568614,dup,HG00674,0,,64240
9,36270442,36276441,dup,HG00244,0,,5999
9,37061767,37100805,dup,HG01174,0,,39038
9,37502437,37514476,dup,HG00407,0,,12039
9,38097277,38101726,dup,HG01920,0,,4449
9,38383377,38389962,dup,NA20769,0,,6585
9,39002061,39024618,dup,HG00106,0,,22557
9,39044749,39055764,dup,HG01977,0,,11015
9,39089689,39125233,dup,HG03237,0,,35544
9,39140766,39206559,dup,HG03237,0,,65793
9,40749113,40789930,dup,HG01360,0,,40817
9,41971191,41985717,dup,HG00099,0,,14526
9,43392405,43404180,dup,HG00096,0,,11775
9,43450178,43463455,dup,HG00096,0,,13277
9,43495449,43520900,dup,HG00096,0,,25451
9,43580844,43606160,dup,HG00096,0,,25316
9,43612172,43623150,dup,HG00096,0,,10978
9,43652217,43676146,dup,HG00096,0,,23929
9,44100508,44140689,dup,HG00641,0,,40181
9,44158909,44200752,dup,HG00641,0,,41843
9,44208061,44240980,dup,HG00419,0,,32919
9,44255190,44276471,dup,HG00096,0,,21281
9,44726698,44739394,dup,HG00099,0,,12696
9,44779267,44790258,dup,HG00099,0,,10991
9,44812410,44830472,dup,HG00099,0,,18062
9,44868836,44906868,dup,HG00129,0,,38032
9,45700960,45715411,dup,HG00101,0,,14451
9,66243042,66266398,dup,HG00641,0,,23356
9,66284867,66313496,dup,HG00640,0,,28629
9,66318447,66343333,dup,HG00641,0,,24886
9,68141171,68159868,dup,HG01942,0,,18697
9,68167356,68243620,dup,HG02760,0,,76264
9,68287325,68356319,dup,HG02760,0,,68994
9,68354131,68388436,dup,HG00096,0,,34305
9,68429617,68509149,dup,HG02760,0,,79532
9,70954344,70997787,dup,NA18530,0,,43443
9,71047299,71200407,dup,HG03729,0,,153108
9,71290153,71337782,dup,NA18943,0,,47629
9,71879216,71886875,dup,HG03943,0,,7659
9,72030971,72054480,dup,HG00183,0,,23509
9,72088944,72117643,dup,HG00268,0,,28699
9,72097598,72127406,dup,HG00268,0,,29808
9,72327163,72332611,dup,NA19461,0,,5448
9,72679887,72717319,dup,HG02597,0,,37432
9,73649341,73743302,dup,HG04023,0,,93961
9,73749680,73798097,dup,HG04023,0,,48417
9,73800404,73857375,dup,HG04023,0,,56971
9,73912919,73949548,dup,HG03304,0,,36629
9,74256671,74259969,dup,HG01462,0,,3298
9,74679132,74689703,dup,HG01047,0,,10571
9,74985057,74992562,dup,HG01565,0,,7505
9,75004647,75017177,dup,HG04198,0,,12530
9,75539073,75694022,dup,HG00276,0,,154949
9,75595963,75658021,dup,HG00276,0,,62058
9,75763605,75947890,dup,NA18988,0,,184285
9,75770690,75869452,dup,HG00276,0,,98762
9,75951736,75987265,dup,HG00276,0,,35529
9,76446894,76469108,dup,HG02839,0,,22214
9,76554010,76629321,dup,HG01865,0,,75311
9,76584297,76637042,dup,HG01865,0,,52745
9,77309594,77330391,dup,HG01889,0,,20797
9,77531279,77554228,dup,HG02973,0,,22949
9,77816520,77973488,dup,NA12273,0,,156968
9,77822971,77871312,dup,NA12273,0,,48341
9,78795020,78810428,dup,HG01191,0,,15408
9,79399315,79427838,dup,HG02655,0,,28523
9,79405821,79433061,dup,HG02655,0,,27240
9,79460948,79501729,dup,NA20766,0,,40781
9,79701593,79704988,dup,HG02332,0,,3395
9,79770018,79778662,dup,HG00100,0,,8644
9,79999148,80016577,dup,NA20897,0,,17429
9,80504112,80544274,dup,HG00478,0,,40162
9,80507812,80654873,dup,HG00478,0,,147061
9,80552894,80563721,dup,NA19338,0,,10827
9,80562047,80607245,dup,HG00478,0,,45198
9,80668161,80793462,dup,HG00478,0,,125301
9,80804195,80908682,dup,HG00478,0,,104487
9,80917973,80940042,dup,HG00478,0,,22069
9,80918404,81153779,dup,HG00478,0,,235375
9,81162397,81168461,dup,HG01798,0,,6064
9,81172673,81209530,dup,HG00478,0,,36857
9,81241626,81355495,dup,HG00478,0,,113869
9,81425400,81431766,dup,HG00478,0,,6366
9,81434026,81494056,dup,NA18505,0,,60030
9,81436281,81460558,dup,NA18505,0,,24277
9,81474292,81488652,dup,HG00478,0,,14360
9,81493997,81540954,dup,HG00478,0,,46957
9,81494838,81646914,dup,HG00478,0,,152076
9,81658384,81682308,dup,HG00478,0,,23924
9,82673151,82678689,dup,HG03279,0,,5538
9,83427049,83431512,dup,NA20854,0,,4463
9,83834679,83845160,dup,HG03687,0,,10481
9,84574270,84592525,dup,HG01815,0,,18255
9,85372352,85388303,dup,HG00127,0,,15951
9,85523230,85567342,dup,NA20797,0,,44112
9,85758120,85871553,dup,NA19759,0,,113433
9,86392243,86444978,dup,HG01177,0,,52735
9,86460458,86484376,dup,NA12872,0,,23918
9,86486885,86501288,dup,NA12872,0,,14403
9,86507385,86517489,dup,HG00554,0,,10104
9,86541315,86561568,dup,NA12872,0,,20253
9,86579383,86590688,dup,NA12872,0,,11305
9,87757918,87798742,dup,HG01939,0,,40824
9,87770422,87797825,dup,HG01939,0,,27403
9,88409124,88425989,dup,HG02805,0,,16865
9,88821661,88844373,dup,HG02356,0,,22712
9,89028246,89040046,dup,HG03199,0,,11800
9,89229909,89252095,dup,HG01357,0,,22186
9,89269770,89286651,dup,HG02090,0,,16881
9,89509382,89537361,dup,HG03888,0,,27979
9,89510663,89524657,dup,HG03888,0,,13994
9,89535987,89542772,dup,HG02304,0,,6785
9,90327643,90335558,dup,NA20851,0,,7915
9,90933754,90936806,dup,HG00259,0,,3052
9,91492806,92256368,dup,HG01602,0,,763562
9,92307364,92336441,dup,NA20318,0,,29077
9,92312198,92732652,dup,NA20317,0,,420454
9,92444673,92523564,dup,NA20318,0,,78891
9,92678842,92726341,dup,NA20318,0,,47499
9,92772877,92930904,dup,HG01602,0,,158027
9,93417870,94128163,dup,HG01602,0,,710293
9,93551137,93580615,dup,HG00371,0,,29478
9,93555898,93575917,dup,HG00371,0,,20019
9,93599665,93688997,dup,HG00371,0,,89332
9,93608317,93644415,dup,HG00371,0,,36098
9,94927236,94957731,dup,HG03072,0,,30495
9,95082358,95141947,dup,HG02820,0,,59589
9,95422843,95481000,dup,HG02820,0,,58157
9,96169840,96195659,dup,NA20809,0,,25819
9,96265191,96302405,dup,HG02060,0,,37214
9,96654889,96909567,dup,HG01602,0,,254678
9,96790437,96808864,dup,HG04141,0,,18427
9,96970240,97653119,dup,HG01602,0,,682879
9,97042261,97244349,dup,HG00096,0,,202088
9,97046840,97095100,dup,HG04229,0,,48260
9,97171747,97190868,dup,HG03121,0,,19121
9,97187366,97244533,dup,HG04229,0,,57167
9,97249220,97309608,dup,NA18626,0,,60388
9,97308032,97350649,dup,HG04229,0,,42617
9,97315711,97345822,dup,HG04229,0,,30111
9,97505262,97512917,dup,HG00739,0,,7655
9,98899862,98913309,dup,NA07347,0,,13447
9,99852854,99862922,dup,NA18939,0,,10068
9,100333246,100390337,dup,HG04152,0,,57091
9,100357302,100420885,dup,HG04152,0,,63583
9,100358470,100420652,dup,HG01602,0,,62182
9,100826454,100880584,dup,HG01767,0,,54130
9,100830849,101169860,dup,HG01602,0,,339011
9,101338785,101352079,dup,HG00565,0,,13294
9,101413666,102399370,dup,HG01602,0,,985704
9,101634641,101666874,dup,HG02882,0,,32233
9,101846882,101861117,dup,HG04161,0,,14235
9,103542453,103571600,dup,HG03644,0,,29147
9,104208850,104233465,dup,HG00188,0,,24615
9,104661206,104667819,dup,HG01110,0,,6613
9,104942642,104980733,dup,NA20799,0,,38091
9,104962043,104981056,dup,NA20799,0,,19013
9,105121649,105130966,dup,HG00137,0,,9317
9,105379145,105530858,dup,HG01485,0,,151713
9,105624627,105774608,dup,HG01485,0,,149981
9,105970443,105984674,dup,HG02111,0,,14231
9,107204632,107222999,dup,HG02375,0,,18367
9,107362130,107367434,dup,HG01075,0,,5304
9,107367185,107380160,dup,HG02009,0,,12975
9,107737501,107755175,dup,HG03681,0,,17674
9,108502713,108549127,dup,HG00629,0,,46414
9,108589869,108663575,dup,NA18941,0,,73706
9,108926340,108944655,dup,NA18941,0,,18315
9,108943499,108962060,dup,NA18941,0,,18561
9,108960860,108972609,dup,HG02595,0,,11749
9,109013694,109072039,dup,NA18941,0,,58345
9,109184091,109293261,dup,NA12812,0,,109170
9,109239917,109278613,dup,NA12812,0,,38696
9,110576840,110602785,dup,NA12044,0,,25945
9,110658068,110662858,dup,HG01089,0,,4790
9,112502783,112510213,dup,HG02394,0,,7430
9,112716358,112891604,dup,NA19380,0,,175246
9,112721869,113066303,dup,HG00266,0,,344434
9,112727130,112781273,dup,NA19380,0,,54143
9,112891605,113066667,dup,NA19380,0,,175062
9,112915405,112945160,dup,HG03304,0,,29755
9,113175167,113185506,dup,HG02455,0,,10339
9,113255379,113258580,dup,HG00138,0,,3201
9,113736311,113744051,dup,HG02081,0,,7740
9,113746617,113760965,dup,HG02081,0,,14348
9,114763257,114769702,dup,HG02840,0,,6445
9,115038622,115042019,dup,HG00543,0,,3397
9,115379103,115592882,dup,HG01602,0,,213779
9,115397149,115453701,dup,HG01882,0,,56552
9,115535122,115606296,dup,HG01882,0,,71174
9,115794961,115808789,dup,HG03433,0,,13828
9,115802747,115825880,dup,HG01746,0,,23133
9,115852438,115882632,dup,HG02666,0,,30194
9,115881234,115907800,dup,NA20849,0,,26566
9,115897450,115907050,dup,HG03762,0,,9600
9,116041793,116183843,dup,HG01602,0,,142050
9,116598396,117093358,dup,HG01602,0,,494962
9,117078690,117098163,dup,NA18620,0,,19473
9,118580289,118591005,dup,HG00112,0,,10716
9,119475396,119495590,dup,HG01468,0,,20194
9,119523065,119536822,dup,HG01890,0,,13757
9,119537323,119543697,dup,HG01102,0,,6374
9,121534190,121537519,dup,HG02571,0,,3329
9,121578988,121584349,dup,NA19038,0,,5361
9,122159773,122229018,dup,HG02419,0,,69245
9,122841299,122890163,dup,HG00851,0,,48864
9,124248125,124254289,dup,HG02923,0,,6164
9,126059915,126070121,dup,NA19984,0,,10206
9,126278449,126288304,dup,HG01890,0,,9855
9,126675912,126679785,dup,HG00261,0,,3873
9,127119114,127213913,dup,NA19676,0,,94799
9,127141244,127259669,dup,HG01602,0,,118425
9,127932031,127946150,dup,HG03937,0,,14119
9,127957168,127961071,dup,HG01989,0,,3903
9,127968906,127972251,dup,HG01464,0,,3345
9,128155850,128159962,dup,NA06986,0,,4112
9,129129210,129723403,dup,HG01602,0,,594193
9,130626173,130643778,dup,NA12414,0,,17605
9,130672862,130686056,dup,NA18639,0,,13194
9,131522747,131528699,dup,HG01107,0,,5952
9,131639356,131649828,dup,NA12283,0,,10472
9,132463983,132648102,dup,HG00242,0,,184119
9,132500072,132647841,dup,NA19716,0,,147769
9,132654988,132798900,dup,HG00100,0,,143912
9,132775615,132794348,dup,NA19716,0,,18733
9,132872856,132920419,dup,HG01524,0,,47563
9,133571355,134081087,dup,HG01602,0,,509732
9,134293849,134452956,dup,HG00149,0,,159107
9,134299354,134418165,dup,NA18967,0,,118811
9,134422679,134433562,dup,HG02786,0,,10883
9,134431004,134445485,dup,NA18967,0,,14481
9,134527127,134762646,dup,HG01602,0,,235519
9,134609306,134763232,dup,NA21088,0,,153926
9,134676237,134745722,dup,NA21088,0,,69485
9,135589055,135740711,dup,HG00131,0,,151656
9,135591752,135720607,dup,HG00131,0,,128855
9,135761041,135770199,dup,NA20882,0,,9158
9,135938579,135956026,dup,HG00260,0,,17447
9,137091324,137146637,dup,HG01061,0,,55313
9,137096761,137167170,dup,HG01061,0,,70409
9,137137661,137161921,dup,NA19449,0,,24260
9,137395957,137460441,dup,HG03760,0,,64484
9,137562328,137579185,dup,NA20849,0,,16857
9,138091903,138107080,dup,HG03832,0,,15177
9,138104730,138114184,dup,HG03478,0,,9454
9,138147233,138310335,dup,HG00239,0,,163102
9,138151364,138212094,dup,NA12776,0,,60730
9,138219404,138294301,dup,NA12776,0,,74897
9,138311142,138363881,dup,HG00734,0,,52739
9,138320487,138357745,dup,HG00734,0,,37258
9,139105620,139128430,dup,NA12272,0,,22810
9,139138488,139166555,dup,HG02688,0,,28067
9,139324164,139352445,dup,NA20502,0,,28281
9,139667267,139677251,dup,HG00118,0,,9984
9,139738787,139748879,dup,HG00234,0,,10092
9,139866430,139871179,dup,HG04106,0,,4749
9,140060362,140068798,dup,HG00097,0,,8436
9,140327529,140333478,dup,HG00335,0,,5949
9,140983246,141011821,dup,HG02861,0,,28575
9,141008572,141034374,dup,HG00244,0,,25802
9,141048437,141072662,dup,HG02283,0,,24225
9,141072971,141092804,dup,HG00103,0,,19833
9,141096461,141109892,dup,HG02283,0,,13431
10,118714083,118716225,del,NA19085,0,,2142
10,6169497,6169685,del,HG00346,0,,188
10,116488136,116491401,del,NA19396,0,,3265
10,111903832,111906220,del,NA20519,0,,2388
10,103042943,103044696,del,NA18599,0,,1753
10,1451811,1452230,del,HG00239,0,,419
10,2379470,2379797,del,HG00536,0,,327
10,43707467,43707928,del,NA18523,0,,461
10,42426969,42428027,del,NA19383,0,,1058
10,134867338,134867578,del,HG00428,0,,240
10,25793907,25812154,del,HG00478,0,,18247
10,71282116,71290922,del,HG00260,0,,8806
10,58921971,58923631,del,HG00553,0,,1660
10,130836871,130837274,del,NA18947,0,,403
10,82437555,82438334,del,HG00577,0,,779
10,123489197,123489479,del,HG01148,0,,282
10,12892975,12894263,del,NA19338,0,,1288
10,113539718,113541158,del,NA19347,0,,1440
10,15669759,15674202,del,NA18522,0,,4443
10,105221239,105222657,del,NA19350,0,,1418
10,130180984,130181485,del,NA20340,0,,501
10,67324094,67336446,del,HG01190,0,,12352
10,133975341,133975643,del,HG00357,0,,302
10,60357527,60365081,del,HG00117,0,,7554
10,18503075,18503589,del,NA20771,0,,514
10,74702819,74708942,del,HG01107,0,,6123
10,20132485,20133177,del,HG01125,0,,692
10,89276096,89276266,del,NA18989,0,,170
10,75123678,75127796,del,NA19472,0,,4118
10,132988716,132991422,del,NA19334,0,,2706
10,134990694,134991039,del,NA18638,0,,345
10,68053251,68054566,del,NA19379,0,,1315
10,93648113,93651995,del,HG00237,0,,3882
10,76575637,76576488,del,NA19900,0,,851
10,35215199,35220997,del,NA18574,0,,5798
10,20848974,20860284,del,NA18634,0,,11310
10,30966217,30966628,del,HG00260,0,,411
10,57383753,57384252,del,NA18501,0,,499
10,32041035,32048189,del,NA19129,0,,7154
10,96450398,96458705,del,HG00684,0,,8307
10,9228204,9231148,del,HG01060,0,,2944
10,121315571,121317078,del,NA18634,0,,1507
10,129946582,129950102,del,HG01190,0,,3520
10,19504657,19504799,del,NA18611,0,,142
10,133471838,133474190,del,HG00180,0,,2352
10,12705097,12706480,del,NA18536,0,,1383
10,5602377,5604500,del,HG01198,0,,2123
10,87878086,87879855,del,HG00610,0,,1769
10,10428387,10432872,del,NA19332,0,,4485
10,31499069,31499864,del,NA19147,0,,795
10,38749168,38752704,del,NA12399,0,,3536
10,42394746,42396071,del,HG01389,0,,1325
10,23370002,23370991,del,HG00704,0,,989
10,25145603,25146699,del,HG00373,0,,1096
10,134577994,134578371,del,NA19434,0,,377
10,6654405,6664188,del,NA12717,0,,9783
10,26931666,26932172,del,HG00176,0,,506
10,126129352,126129887,del,HG00501,0,,535
10,134634257,134635352,del,NA19982,0,,1095
10,1084579,1085083,del,NA19470,0,,504
10,54410059,54415852,del,HG00345,0,,5793
10,76536906,76538463,del,NA20287,0,,1557
10,132588878,132589274,del,NA20760,0,,396
10,59452789,59453333,del,NA18511,0,,544
10,39101511,39102269,del,NA19713,0,,758
10,80451395,80457263,del,HG00319,0,,5868
10,65509248,65511399,del,HG00641,0,,2151
10,83420680,83424030,del,NA19463,0,,3350
10,14241549,14242452,del,HG00112,0,,903
10,125742349,125744270,del,HG00278,0,,1921
10,132909058,132912779,del,NA20540,0,,3721
10,12496917,12500335,del,HG00337,0,,3418
10,102354483,102362052,del,NA19404,0,,7569
10,17416616,17416822,del,HG01183,0,,206
10,109728757,109729141,del,NA19717,0,,384
10,132258767,132259694,del,NA19834,0,,927
10,127002419,127004958,del,HG00318,0,,2539
10,73636657,73637174,del,NA19360,0,,517
10,85350566,85351991,del,NA19147,0,,1425
10,65030047,65031397,del,NA19711,0,,1350
10,73453619,73453882,del,HG00313,0,,263
10,3574225,3575396,del,NA19921,0,,1171
10,72448735,72451334,del,HG00156,0,,2599
10,44757240,44761221,del,HG00143,0,,3981
10,80051222,80052637,del,HG01080,0,,1415
10,92815383,92815704,del,NA12489,0,,321
10,66841805,66842061,del,NA19684,0,,256
10,24281539,24281958,del,NA19327,0,,419
10,8065916,8067318,del,NA12776,0,,1402
10,21011296,21013498,del,HG01168,0,,2202
10,128037165,128040700,del,NA20813,0,,3535
10,32257880,32260612,del,HG00258,0,,2732
10,103212441,103218059,del,NA20503,0,,5618
10,24569478,24570727,del,NA19457,0,,1249
10,26372306,26377185,del,HG00136,0,,4879
10,42803162,42807656,del,NA18986,0,,4494
10,14683211,14684791,del,NA18964,0,,1580
10,55419789,55420146,del,NA19198,0,,357
10,1701930,1702051,del,HG01069,0,,121
10,124341767,124359597,del,NA18548,0,,17830
10,117385011,117390501,del,HG01148,0,,5490
10,11520399,11522468,del,NA18986,0,,2069
10,106771231,106778234,del,HG00346,0,,7003
10,122770016,122788622,del,NA19189,0,,18606
10,3218517,3219376,del,NA18548,0,,859
10,52630245,52630838,del,HG00158,0,,593
10,28663803,28665095,del,HG00174,0,,1292
10,34487098,34489478,del,HG00640,0,,2380
10,42409302,42409670,del,HG01070,0,,368
10,80385719,80396160,del,NA19068,0,,10441
10,16378003,16394667,del,HG01170,0,,16664
10,121065277,121067923,del,NA19467,0,,2646
10,96867192,96874942,del,NA19153,0,,7750
10,12120135,12123574,del,HG00285,0,,3439
10,75899294,75902831,del,NA19435,0,,3537
10,82737737,82738056,del,NA20296,0,,319
10,96251541,96251717,del,NA19072,0,,176
10,90801852,90802567,del,NA19777,0,,715
10,29458569,29458763,del,NA18626,0,,194
10,112227886,112229227,del,NA19399,0,,1341
10,82879411,82891376,del,HG00116,0,,11965
10,111472544,111475266,del,NA19463,0,,2722
10,22979267,22981194,del,NA20512,0,,1927
10,55086500,55086727,del,HG00566,0,,227
10,107698686,107699231,del,NA18858,0,,545
10,110916898,110919351,del,NA19240,0,,2453
10,131279462,131286199,del,HG01051,0,,6737
10,117498182,117515421,del,NA12748,0,,17239
10,85089654,85128752,del,HG00566,0,,39098
10,1234931,1236332,del,NA19921,0,,1401
10,5887619,5893958,del,NA18990,0,,6339
10,35895245,35899148,del,NA19819,0,,3903
10,60516265,60522663,del,NA20529,0,,6398
10,29742243,29742966,del,NA12043,0,,723
10,115208313,115210068,del,NA19401,0,,1755
10,32134553,32143159,del,HG00589,0,,8606
10,126855922,126859395,del,HG00280,0,,3473
10,25492525,25492951,del,NA19704,0,,426
10,424471,424594,del,NA19072,0,,123
10,27137709,27143912,del,NA19719,0,,6203
10,54015613,54018129,del,HG01389,0,,2516
10,55591779,55592477,del,NA18853,0,,698
10,119051087,119059858,del,HG00705,0,,8771
10,101421722,101448209,del,NA19238,0,,26487
10,96497202,96558962,del,HG00268,0,,61760
10,48913816,48984722,del,HG00274,0,,70906
10,58327282,58484346,del,NA19399,0,,157064
10,17584357,17587629,del,NA19430,0,,3272
10,134172170,134172615,del,NA18565,0,,445
10,88785827,88787995,del,NA19334,0,,2168
10,18817724,18818752,del,HG01390,0,,1028
10,75922302,76000110,del,HG01069,0,,77808
10,17278374,17279224,del,NA12830,0,,850
10,68319858,68410600,del,NA18973,0,,90742
10,59209166,59211722,del,NA12827,0,,2556
10,829756,830305,del,NA18635,0,,549
10,35485112,35487645,del,NA19448,0,,2533
10,4687053,4687654,del,NA19397,0,,601
10,70612069,70623794,del,HG01066,0,,11725
10,11419407,11423391,del,HG00475,0,,3984
10,38818494,38907958,del,NA12058,0,,89464
10,71281003,71291092,del,HG01067,0,,10089
10,571975,1288086,del,HG00376,0,,716111
10,83942005,83961020,del,HG00329,0,,19015
10,70254065,70254544,del,NA20787,0,,479
10,10493409,10493732,del,NA19786,0,,323
10,129059164,129060236,del,NA19701,0,,1072
10,37012712,37013151,del,NA18516,0,,439
10,9962097,10026235,del,NA12878,0,,64138
10,62173923,62175315,del,HG01489,0,,1392
10,103976013,103976740,del,NA19009,0,,727
10,5411940,5412883,del,NA18916,0,,943
10,133644533,133666431,del,NA18516,0,,21898
10,53203676,53214222,del,NA12892,0,,10546
10,125290303,125291582,del,NA19461,0,,1279
10,84712248,84717554,del,NA18502,0,,5306
10,90939623,90947959,del,HG01052,0,,8336
10,103018615,103024433,del,NA06984,0,,5818
10,60090030,60094586,del,HG00323,0,,4556
10,134253836,134254203,del,NA19451,0,,367
10,92924518,92933870,del,NA19130,0,,9352
10,20849655,20860967,del,HG00179,0,,11312
10,17310711,17315523,del,HG00342,0,,4812
10,129905411,129906503,del,HG00097,0,,1092
10,134701998,134702398,del,HG00159,0,,400
10,22565729,22579637,del,HG00640,0,,13908
10,32992065,32995614,del,HG00327,0,,3549
10,53699534,53706940,del,NA18523,0,,7406
10,65095565,65098222,del,NA19462,0,,2657
10,99743006,99743343,del,NA18510,0,,337
10,27613109,27619761,del,NA18502,0,,6652
10,126495651,126499564,del,NA19080,0,,3913
10,51789040,51790477,del,NA19719,0,,1437
10,68023144,68097996,del,HG00683,0,,74852
10,11957188,11957927,del,NA19471,0,,739
10,51002687,51003099,del,NA19063,0,,412
10,78113720,78116270,del,HG00559,0,,2550
10,48590388,48594353,del,NA19437,0,,3965
10,8090816,8098322,del,NA19076,0,,7506
10,4293488,4311561,del,NA11992,0,,18073
10,54564050,54570622,del,NA19359,0,,6572
10,55893665,55894132,del,NA18952,0,,467
10,81785180,81792051,del,NA20768,0,,6871
10,90479879,90481577,del,NA18487,0,,1698
10,132586647,132586834,del,HG01365,0,,187
10,70330050,70331345,del,NA19384,0,,1295
10,94723286,94728754,del,HG01353,0,,5468
10,108309164,108311298,del,NA19909,0,,2134
10,42701551,42716790,del,NA19066,0,,15239
10,28564704,28572682,del,NA19093,0,,7978
10,47744516,47768622,del,NA19676,0,,24106
10,134924702,134925393,del,NA18545,0,,691
10,18860688,18862238,del,NA18499,0,,1550
10,45583575,45583699,del,HG00698,0,,124
10,3210617,3210815,del,HG01107,0,,198
10,125994693,125994873,del,NA19108,0,,180
10,36391468,36394935,del,NA19225,0,,3467
10,86860184,86860397,del,NA18517,0,,213
10,44687305,44687937,del,NA20796,0,,632
10,43384305,43387642,del,NA18867,0,,3337
10,76052439,76053355,del,HG01051,0,,916
10,103275915,103276547,del,HG01461,0,,632
10,76308006,76310089,del,NA19332,0,,2083
10,70578740,70580584,del,NA12546,0,,1844
10,13056294,13061078,del,NA07056,0,,4784
10,35120070,35124034,del,NA18628,0,,3964
10,59209787,59211853,del,HG00338,0,,2066
10,94202849,94205023,del,NA12249,0,,2174
10,44808643,44810566,del,HG00343,0,,1923
10,4437742,4441313,del,NA19171,0,,3571
10,134977411,134977627,del,NA12155,0,,216
10,134035070,134035500,del,NA19375,0,,430
10,95041736,95045718,del,NA19067,0,,3982
10,128276712,128286700,del,NA20760,0,,9988
10,21685117,21687019,del,HG00342,0,,1902
10,9297219,9302504,del,NA19707,0,,5285
10,122118169,122118312,del,HG00271,0,,143
10,35727316,35729487,del,NA19004,0,,2171
10,133656396,133656684,del,NA19985,0,,288
10,67531843,67631946,del,NA19469,0,,100103
10,28662266,28664772,del,HG00583,0,,2506
10,28650520,28651029,del,HG00315,0,,509
10,39115541,39128584,del,HG00344,0,,13043
10,133284823,133285116,del,HG00100,0,,293
10,20850516,20860422,del,NA11918,0,,9906
10,16687869,16688146,del,NA20332,0,,277
10,97992038,97992141,del,HG00513,0,,103
10,36892651,36897962,del,NA18565,0,,5311
10,22868695,22869568,del,NA19403,0,,873
10,122769701,122787511,del,NA19712,0,,17810
10,106739609,106741128,del,NA19068,0,,1519
10,23635492,23635621,del,HG00463,0,,129
10,58894812,58937151,del,NA18972,0,,42339
10,130722015,130722811,del,NA12342,0,,796
10,108110931,108111958,del,NA12546,0,,1027
10,43986192,43988000,del,HG01366,0,,1808
10,109449393,109450845,del,HG00254,0,,1452
10,1125089,1125389,del,NA18853,0,,300
10,68954264,68954932,del,HG00180,0,,668
10,81176903,81177136,del,NA19236,0,,233
10,7716172,7717547,del,NA19467,0,,1375
10,97425933,97439582,del,HG01173,0,,13649
10,62427247,62428297,del,NA19471,0,,1050
10,94202757,94204854,del,HG00188,0,,2097
10,92274340,92275230,del,HG00500,0,,890
10,85545401,85552967,del,NA19470,0,,7566
10,6976997,6987523,del,HG00309,0,,10526
10,12596202,12596584,del,HG00252,0,,382
10,66398770,66400744,del,NA19437,0,,1974
10,85522715,85523905,del,HG00326,0,,1190
10,70068225,70070644,del,NA19435,0,,2419
10,18614076,18614840,del,NA19914,0,,764
10,42454644,42457061,del,NA18961,0,,2417
10,33598339,33610400,del,HG00174,0,,12061
10,42396934,42666080,del,HG00255,0,,269146
10,2600756,2604473,del,HG00707,0,,3717
10,23312936,23313628,del,NA18636,0,,692
10,130007552,130007603,del,NA18909,0,,51
10,45158135,45158436,del,NA20518,0,,301
10,15472737,15477687,del,NA19457,0,,4950
10,4538066,4538372,del,NA19461,0,,306
10,93648391,93656154,del,HG00237,0,,7763
10,68151062,68157618,del,HG00613,0,,6556
10,20228723,20229191,del,NA19835,0,,468
10,129512675,129513737,del,HG01190,0,,1062
10,80143315,80144406,del,NA18861,0,,1091
10,90963741,90964454,del,NA20528,0,,713
10,55958256,55958547,del,NA19712,0,,291
10,86285227,86290135,del,HG00626,0,,4908
10,85129406,85129630,del,HG00258,0,,224
10,135182881,135182981,del,NA18557,0,,100
10,8062237,8067983,del,HG00345,0,,5746
10,109638485,109639692,del,NA20322,0,,1207
10,131854039,131901545,del,HG00345,0,,47506
10,7558720,7559650,del,NA18505,0,,930
10,66931430,66932817,del,NA07037,0,,1387
10,105116488,105122507,del,HG00736,0,,6019
10,127032459,127033461,del,NA18501,0,,1002
10,36825976,36827120,del,NA19371,0,,1144
10,16420011,16436543,del,NA19393,0,,16532
10,76488386,76489553,del,HG01489,0,,1167
10,25638286,25638833,del,NA19789,0,,547
10,90100152,90103131,del,HG00149,0,,2979
10,126880485,126881945,del,NA19446,0,,1460
10,490214,490325,del,HG01052,0,,111
10,98537147,98537455,del,HG00590,0,,308
10,30935168,30936515,del,NA19713,0,,1347
10,57637147,57642273,del,HG01384,0,,5126
10,56682778,56684358,del,NA19066,0,,1580
10,80666034,80667119,del,HG01137,0,,1085
10,100495009,100509034,del,HG01073,0,,14025
10,116755239,116756589,del,NA19684,0,,1350
10,103394012,103395092,del,NA19346,0,,1080
10,120225167,120226357,del,NA19401,0,,1190
10,124216820,124217263,del,HG00122,0,,443
10,32041941,32047341,del,HG01070,0,,5400
10,12365631,12368860,del,HG00577,0,,3229
10,42394854,42662983,del,NA19712,0,,268129
10,102158308,102159537,del,HG00403,0,,1229
10,116541430,116544733,del,NA19443,0,,3303
10,113553723,113578970,del,HG00651,0,,25247
10,48664616,48873522,del,NA19012,0,,208906
10,2434508,2434712,del,HG00533,0,,204
10,12120101,12124080,del,HG00285,0,,3979
10,84817573,84818437,del,NA19172,0,,864
10,134634040,134634401,del,HG00531,0,,361
10,66225948,66226729,del,NA19190,0,,781
10,123403246,123409544,del,NA19346,0,,6298
10,6169487,6169664,del,NA19394,0,,177
10,67306932,67315294,del,NA19003,0,,8362
10,119433,120565,del,HG01052,0,,1132
10,21609518,21610392,del,NA18596,0,,874
10,134876783,134877279,del,NA19312,0,,496
10,742750,742838,del,HG00257,0,,88
10,95545743,95545886,del,HG00534,0,,143
10,10308736,10309157,del,NA18543,0,,421
10,51862516,52000422,del,HG01378,0,,137906
10,15957710,15963762,del,NA19002,0,,6052
10,26933653,26935459,del,HG01488,0,,1806
10,76471132,76472349,del,NA19722,0,,1217
10,47150916,47325822,del,HG00315,0,,174906
10,86346267,86381334,del,HG00702,0,,35067
10,71399744,71401057,del,NA19374,0,,1313
10,87021885,87022510,del,NA18486,0,,625
10,2538167,2539345,del,HG01334,0,,1178
10,131279409,131286119,del,HG01051,0,,6710
10,39099450,39110552,del,NA20588,0,,11102
10,118976738,118982786,del,NA19313,0,,6048
10,59359598,59361301,del,NA19079,0,,1703
10,2874435,2878366,del,NA19172,0,,3931
10,47897616,47959122,del,NA19382,0,,61506
10,14166095,14168910,del,NA18983,0,,2815
10,55521162,55522071,del,NA19374,0,,909
10,32453846,32453984,del,HG00583,0,,138
10,17310916,17314472,del,NA18595,0,,3556
10,82569115,82574879,del,HG00560,0,,5764
10,133099020,133104180,del,NA18522,0,,5160
10,961483,968751,del,NA19445,0,,7268
10,42796226,42800156,del,HG00607,0,,3930
10,24376837,24378441,del,NA18555,0,,1604
10,1452166,1452122,del,NA10851,0,,-44
10,14954970,14955020,del,HG00329,0,,50
10,132839766,132841472,del,NA18577,0,,1706
10,1410314,1410451,del,HG00154,0,,137
10,25575798,25577184,del,HG00237,0,,1386
10,57169466,57182972,del,NA18999,0,,13506
10,132317233,132321005,del,NA19394,0,,3772
10,130477776,130482182,del,HG00626,0,,4406
10,54783542,54788830,del,NA12249,0,,5288
10,75374416,75381872,del,NA19093,0,,7456
10,133838693,133841499,del,NA19471,0,,2806
10,105069816,105071007,del,NA19428,0,,1191
10,26187872,26192099,del,NA18950,0,,4227
10,18842872,18845236,del,NA18562,0,,2364
10,7077040,7078301,del,NA19398,0,,1261
10,68340832,68365774,del,HG00531,0,,24942
10,135150725,135151770,del,NA12889,0,,1045
10,57030508,57036651,del,NA19247,0,,6143
10,134176190,134176746,del,NA19401,0,,556
10,88769151,88769785,del,HG01067,0,,634
10,44095425,44095606,del,HG00150,0,,181
10,63285885,63286236,del,NA18597,0,,351
10,42409385,42409737,del,HG00262,0,,352
10,54015776,54018292,del,NA12154,0,,2516
10,34754635,34756586,del,NA19435,0,,1951
10,93993338,93995614,del,NA19471,0,,2276
10,80675394,80681008,del,HG00560,0,,5614
10,82242106,82242555,del,NA19098,0,,449
10,26139958,26143460,del,NA19316,0,,3502
10,11418554,11424217,del,HG00592,0,,5663
10,31246747,31251776,del,NA12843,0,,5029
10,588588,588728,del,NA11919,0,,140
10,27216603,27599491,del,HG00121,0,,382888
10,59070852,59072008,del,HG00512,0,,1156
10,96251608,96251905,del,NA18989,0,,297
10,47750716,47768672,del,NA20126,0,,17956
10,42380287,42792285,del,HG00458,0,,411998
10,70786329,70787312,del,NA20510,0,,983
10,45728767,45731642,del,NA19384,0,,2875
10,16368047,16371369,del,HG01125,0,,3322
10,34684468,34684793,del,HG00442,0,,325
10,83941886,83960961,del,HG00329,0,,19075
10,37136360,37138009,del,HG01124,0,,1649
10,133643877,133666860,del,NA19436,0,,22983
10,122426018,122427440,del,NA20532,0,,1422
10,29290577,29293607,del,NA19429,0,,3030
10,60518662,60522477,del,HG00338,0,,3815
10,38791412,38801418,del,HG00119,0,,10006
10,120044852,120057673,del,NA19679,0,,12821
10,113139587,113141918,del,NA19471,0,,2331
10,50985050,50985801,del,NA19440,0,,751
10,53686171,53686890,del,NA20520,0,,719
10,100817550,100819863,del,HG00708,0,,2313
10,494023,494192,del,NA19116,0,,169
10,22081649,22082196,del,NA19350,0,,547
10,58431502,58431709,del,NA18511,0,,207
10,31246747,31251769,del,NA20508,0,,5022
10,99443619,99444447,del,NA19317,0,,828
10,65143350,65172102,del,NA19455,0,,28752
10,98161379,98163050,del,NA18610,0,,1671
10,98397075,98402626,del,NA19700,0,,5551
10,43174410,43176102,del,NA19434,0,,1692
10,47036094,47036306,del,NA19776,0,,212
10,67306866,67314772,del,NA20539,0,,7906
10,19216666,19377987,del,NA19240,0,,161321
10,73862011,73865886,del,NA18909,0,,3875
10,68321765,68322938,del,NA19463,0,,1173
10,5249892,5250994,del,NA19312,0,,1102
10,30721302,30721824,del,NA18553,0,,522
10,134709576,134709734,del,NA20507,0,,158
10,126195316,126196222,del,NA19385,0,,906
10,20824450,20824567,del,HG01148,0,,117
10,48664216,48870722,del,NA18576,0,,206506
10,50106883,50107157,del,NA18489,0,,274
10,123579101,123582600,del,NA18908,0,,3499
10,52082950,52083253,del,HG00126,0,,303
10,32254548,32272899,del,NA20322,0,,18351
10,42609301,42646869,del,HG00734,0,,37568
10,90822127,90831080,del,HG00554,0,,8953
10,127745183,127745984,del,HG00448,0,,801
10,67342569,67344170,del,HG01492,0,,1601
10,108326662,108329505,del,NA11892,0,,2843
10,4869510,4869694,del,HG00583,0,,184
10,55082175,55090351,del,NA19375,0,,8176
10,132002,143295,del,NA20537,0,,11293
10,82711788,82712799,del,NA19455,0,,1011
10,5644126,5644258,del,HG00464,0,,132
10,78346589,78351577,del,HG00560,0,,4988
10,70559504,70562736,del,NA19315,0,,3232
10,72599010,72602758,del,NA12778,0,,3748
10,92391612,92396782,del,HG00117,0,,5170
10,50487467,50492596,del,NA19054,0,,5129
10,85535978,85536709,del,HG00620,0,,731
10,12314197,12352408,del,HG01334,0,,38211
10,110695833,110696175,del,HG00282,0,,342
10,97569587,97570014,del,HG01351,0,,427
10,66248191,66249020,del,NA19190,0,,829
10,120769130,120769244,del,HG00254,0,,114
10,111472594,111475329,del,NA19463,0,,2735
10,134634368,134637423,del,HG00366,0,,3055
10,93631916,93634422,del,HG00179,0,,2506
10,43384314,43387630,del,NA18867,0,,3316
10,54411640,54416294,del,HG00345,0,,4654
10,84566668,84621012,del,NA18623,0,,54344
10,115861721,115862030,del,NA19236,0,,309
10,125234277,125236252,del,NA19700,0,,1975
10,1910043,1910242,del,NA12489,0,,199
10,61361959,61365008,del,NA06985,0,,3049
10,49576233,49580712,del,NA18633,0,,4479
10,134924734,134925242,del,NA18599,0,,508
10,354142,354469,del,NA18916,0,,327
10,134256626,134256829,del,HG00324,0,,203
10,87569860,87569974,del,HG00335,0,,114
10,1465763,1465963,del,HG00323,0,,200
10,132988166,132991272,del,NA11832,0,,3106
10,25011216,25013422,del,HG00530,0,,2206
10,100495009,100509030,del,HG01073,0,,14021
10,8550481,8560127,del,NA20810,0,,9646
10,36787162,36791529,del,NA19332,0,,4367
10,6639140,6641553,del,NA19395,0,,2413
10,17312766,17316072,del,HG01070,0,,3306
10,91996816,92003872,del,NA19067,0,,7056
10,107677543,107677868,del,NA19375,0,,325
10,59674516,59712550,del,HG00589,0,,38034
10,10133069,10166318,del,HG00309,0,,33249
10,126124251,126128967,del,NA18985,0,,4716
10,45336710,45337350,del,NA19909,0,,640
10,12556421,12558807,del,NA18637,0,,2386
10,87956572,87956985,del,HG00269,0,,413
10,17310711,17315509,del,HG01051,0,,4798
10,123945014,123946183,del,NA19076,0,,1169
10,15163051,15166162,del,NA18538,0,,3111
10,51516719,51518218,del,NA18507,0,,1499
10,2035204,2036808,del,HG00321,0,,1604
10,24607371,24611523,del,NA19720,0,,4152
10,116719638,116730869,del,HG00524,0,,11231
10,54526502,54529234,del,NA19917,0,,2732
10,108030317,108032541,del,NA12892,0,,2224
10,132714439,132715321,del,NA18595,0,,882
10,127345117,127345659,del,HG01140,0,,542
10,18999558,19005327,del,NA18572,0,,5769
10,107325034,107325856,del,NA19661,0,,822
10,129935565,129935877,del,NA19761,0,,312
10,86865246,86867763,del,HG00614,0,,2517
10,118473052,118481257,del,HG00698,0,,8205
10,38791520,38801669,del,HG00638,0,,10149
10,63251114,63251166,del,NA18537,0,,52
10,80404638,80405563,del,HG01187,0,,925
10,102158116,102159722,del,HG00185,0,,1606
10,26684567,26689823,del,NA19788,0,,5256
10,18850692,18851476,del,NA19383,0,,784
10,20477946,20478123,del,HG01389,0,,177
10,129355098,129355308,del,NA12342,0,,210
10,107056594,107062357,del,NA19678,0,,5763
10,67056999,67063645,del,HG00662,0,,6646
10,70018704,70020342,del,HG01188,0,,1638
10,64775161,64775574,del,NA19382,0,,413
10,109622311,109701071,del,HG00620,0,,78760
10,73824656,73824960,del,NA19452,0,,304
10,44383342,44384086,del,NA19240,0,,744
10,71430598,71431632,del,NA19004,0,,1034
10,119219112,119219450,del,HG00708,0,,338
10,90822136,90831067,del,HG00554,0,,8931
10,73860432,73863127,del,NA19916,0,,2695
10,76521791,76523084,del,NA19338,0,,1293
10,134249338,134249995,del,NA18502,0,,657
10,20850216,20857322,del,HG01519,0,,7106
10,21617878,21618688,del,NA19703,0,,810
10,125955740,125959328,del,HG01378,0,,3588
10,113984579,113986217,del,NA18950,0,,1638
10,131763016,131771922,del,NA19474,0,,8906
10,102159016,102159322,del,HG01174,0,,306
10,51862116,52000422,del,HG00377,0,,138306
10,65402275,65403138,del,NA19713,0,,863
10,693714,695161,del,NA12004,0,,1447
10,82904657,82904910,del,HG00274,0,,253
10,79694561,79695336,del,NA18912,0,,775
10,87025021,87033538,del,NA19390,0,,8517
10,62618384,62619664,del,NA18501,0,,1280
10,84936606,84939796,del,NA18982,0,,3190
10,123362508,123363395,del,HG00530,0,,887
10,8524846,8525285,del,NA18501,0,,439
10,34017766,34017858,del,NA12776,0,,92
10,92461854,92465629,del,HG01133,0,,3775
10,15797151,15804628,del,NA06986,0,,7477
10,28041471,28041618,del,HG00418,0,,147
10,121154357,121154650,del,NA18542,0,,293
10,58845447,58851143,del,NA18631,0,,5696
10,130688548,130693814,del,HG00328,0,,5266
10,131985917,131986473,del,NA19238,0,,556
10,13053036,13061090,del,HG00708,0,,8054
10,42400415,42404969,del,NA07037,0,,4554
10,47148758,47150447,del,HG00131,0,,1689
10,135239947,135384724,del,HG00707,0,,144777
10,10656051,10661012,del,NA19401,0,,4961
10,135036012,135037333,del,NA19236,0,,1321
10,104452535,104456373,del,NA18615,0,,3838
10,56183028,56184370,del,NA18523,0,,1342
10,4538018,4538749,del,NA18595,0,,731
10,133526722,133528315,del,HG01066,0,,1593
10,26354755,26355098,del,HG00261,0,,343
10,70612009,70623676,del,NA19315,0,,11667
10,131047811,131047983,del,NA19390,0,,172
10,3305767,3310829,del,NA11831,0,,5062
10,90949074,90950303,del,HG00326,0,,1229
10,95041816,95045667,del,NA19661,0,,3851
10,8089716,8097322,del,NA20753,0,,7606
10,126577843,126579595,del,HG01149,0,,1752
10,78504919,78529825,del,HG00125,0,,24906
10,122745987,122747264,del,NA18982,0,,1277
10,12296125,12297686,del,NA19712,0,,1561
10,54783542,54788829,del,HG01137,0,,5287
10,135424269,135424444,del,HG00543,0,,175
10,54929089,54938111,del,NA19908,0,,9022
10,67602985,67603097,del,HG01495,0,,112
10,5108629,5109134,del,NA18982,0,,505
10,53600577,53604919,del,NA20769,0,,4342
10,28657682,28663699,del,HG01354,0,,6017
10,81725285,81727425,del,NA19372,0,,2140
10,5914816,5916071,del,HG01183,0,,1255
10,128605476,128605632,del,HG01052,0,,156
10,2434536,2434747,del,HG01072,0,,211
10,36219661,36221066,del,NA18628,0,,1405
10,61202685,61203527,del,HG00335,0,,842
10,93652477,93656341,del,HG00237,0,,3864
10,25672232,25674575,del,NA18543,0,,2343
10,35480305,35481650,del,NA12003,0,,1345
10,32552188,32553650,del,NA19399,0,,1462
10,37768217,37773230,del,HG01134,0,,5013
10,42797828,42798715,del,HG01462,0,,887
10,43274200,43274532,del,HG00246,0,,332
10,8903757,8905309,del,NA18634,0,,1552
10,36411867,36412186,del,NA19311,0,,319
10,54068736,54069183,del,NA19835,0,,447
10,10981100,10981093,del,NA18572,0,,-7
10,86445708,86446817,del,NA18868,0,,1109
10,52181953,52189810,del,HG00476,0,,7857
10,102179818,102180320,del,NA19190,0,,502
10,82313834,82329137,del,HG00419,0,,15303
10,134335450,134335715,del,NA19075,0,,265
10,71057373,71060541,del,HG01079,0,,3168
10,83883622,83889004,del,NA20801,0,,5382
10,102504916,102509322,del,HG00595,0,,4406
10,44855792,44856276,del,HG00140,0,,484
10,26757277,26765455,del,HG00543,0,,8178
10,39080945,39098424,del,NA19257,0,,17479
10,65633499,65634363,del,HG00512,0,,864
10,27638254,27642096,del,NA19716,0,,3842
10,7420174,7420438,del,HG00143,0,,264
10,43102009,43108201,del,NA19390,0,,6192
10,11683742,11694539,del,HG00653,0,,10797
10,92474513,92477871,del,NA19440,0,,3358
10,17632795,17635439,del,HG00472,0,,2644
10,92087667,92088301,del,NA20773,0,,634
10,5889559,5892817,del,NA19207,0,,3258
10,126068939,126074488,del,NA19385,0,,5549
10,134879087,134879359,del,HG00369,0,,272
10,112438573,112441854,del,NA18986,0,,3281
10,30758314,30759242,del,HG00136,0,,928
10,107535116,107540422,del,HG00650,0,,5306
10,7666523,7667470,del,NA19374,0,,947
10,68151122,68157702,del,HG00613,0,,6580
10,133937964,133938066,del,HG01148,0,,102
10,43739684,43740163,del,HG01437,0,,479
10,5412221,5413351,del,NA19452,0,,1130
10,31199337,31204481,del,NA19247,0,,5144
10,52986468,52991959,del,NA20512,0,,5491
10,57689237,57692935,del,HG01365,0,,3698
10,126187578,126192425,del,HG01102,0,,4847
10,29110874,29111084,del,HG00578,0,,210
10,8062025,8068014,del,HG00345,0,,5989
10,22151556,22161197,del,NA19443,0,,9641
10,117711616,117712002,del,HG00699,0,,386
10,122291304,122299486,del,NA18541,0,,8182
10,28456357,28460131,del,HG00556,0,,3774
10,53869478,53870047,del,NA18505,0,,569
10,76367555,76374538,del,HG01082,0,,6983
10,99418913,99420174,del,NA19332,0,,1261
10,7760946,7763166,del,NA12045,0,,2220
10,126195894,126196407,del,HG00312,0,,513
10,64167635,64173475,del,NA19471,0,,5840
10,96867516,96876222,del,NA20332,0,,8706
10,45752214,45752870,del,HG00249,0,,656
10,26266863,26268297,del,HG01197,0,,1434
10,85650120,85653456,del,HG00638,0,,3336
10,66435141,66438995,del,NA19107,0,,3854
10,94079302,94082744,del,NA19467,0,,3442
10,69544696,69555322,del,HG00732,0,,10626
10,126140496,126141226,del,HG00123,0,,730
10,70160438,70160769,del,NA18870,0,,331
10,68388940,68397063,del,HG00559,0,,8123
10,3627331,3631292,del,HG00596,0,,3961
10,110656634,110662021,del,NA19236,0,,5387
10,70292910,70296413,del,NA19000,0,,3503
10,132369859,132370007,del,NA18612,0,,148
10,73870288,73872234,del,NA12749,0,,1946
10,87952278,87959889,del,HG01359,0,,7611
10,121046787,121046921,del,HG00542,0,,134
10,62900409,62902812,del,NA12342,0,,2403
10,33378192,33379166,del,NA18519,0,,974
10,49969213,49977276,del,NA20760,0,,8063
10,42385258,42599065,del,HG01095,0,,213807
10,48411520,48411617,del,HG00237,0,,97
10,2538566,2539022,del,HG00328,0,,456
10,116551382,116563599,del,HG00684,0,,12217
10,27385121,27395502,del,NA18508,0,,10381
10,33264480,33266242,del,NA18530,0,,1762
10,12336966,12346638,del,NA18616,0,,9672
10,2932819,2934314,del,NA19312,0,,1495
10,2622318,2623904,del,NA19818,0,,1586
10,30399580,30400012,del,NA07346,0,,432
10,118766100,118769312,del,HG01437,0,,3212
10,90940513,90948050,del,NA18549,0,,7537
10,55176451,55183604,del,NA19375,0,,7153
10,128004117,128005925,del,HG00160,0,,1808
10,127399517,127406129,del,HG00732,0,,6612
10,26999015,27002153,del,HG00262,0,,3138
10,126016174,126031403,del,NA18618,0,,15229
10,133520134,133520442,del,NA20528,0,,308
10,92462120,92462227,del,NA18636,0,,107
10,132589197,132589706,del,NA19780,0,,509
10,52181907,52189779,del,HG00476,0,,7872
10,18913663,18923800,del,HG00500,0,,10137
10,129946564,129946884,del,HG01440,0,,320
10,134253715,134254253,del,HG00556,0,,538
10,121187152,121187274,del,NA18547,0,,122
10,93974120,93987740,del,HG01149,0,,13620
10,76888516,76895596,del,NA19455,0,,7080
10,16025146,16025475,del,NA19328,0,,329
10,19030336,19030576,del,HG00274,0,,240
10,5287299,5293345,del,NA19381,0,,6046
10,117694021,117695295,del,NA20502,0,,1274
10,42873998,42880115,del,NA19377,0,,6117
10,7838693,7842262,del,HG00342,0,,3569
10,85635092,85642300,del,HG00524,0,,7208
10,48313506,48314713,del,NA19007,0,,1207
10,12318432,12323120,del,NA19057,0,,4688
10,69039299,69040222,del,NA20760,0,,923
10,105715877,105720768,del,HG01389,0,,4891
10,59209787,59211867,del,NA19467,0,,2080
10,133142554,133142849,del,HG00542,0,,295
10,14094860,14097034,del,NA19471,0,,2174
10,16700605,16714150,del,NA18623,0,,13545
10,19996551,19998008,del,NA19056,0,,1457
10,135290400,135294439,del,HG00260,0,,4039
10,115207517,115216816,del,HG00136,0,,9299
10,130906998,130907192,del,NA12144,0,,194
10,84707512,84710359,del,NA19982,0,,2847
10,11945431,11945770,del,HG01052,0,,339
10,23015561,23016754,del,NA19235,0,,1193
10,23701148,23708347,del,NA19435,0,,7199
10,50543501,50543653,del,HG00464,0,,152
10,56645817,56645992,del,NA19446,0,,175
10,129744650,129744864,del,NA19783,0,,214
10,20650442,20653878,del,NA11894,0,,3436
10,73962885,73963678,del,HG00319,0,,793
10,2543541,2543693,del,NA12003,0,,152
10,21727939,21728880,del,NA19818,0,,941
10,50197968,50207188,del,NA19238,0,,9220
10,87755803,87761670,del,NA19076,0,,5867
10,120175193,120178272,del,NA18596,0,,3079
10,112908868,112910000,del,NA19457,0,,1132
10,35997572,36003067,del,NA19067,0,,5495
10,26608963,26611057,del,NA18933,0,,2094
10,86863789,86866144,del,HG01191,0,,2355
10,27793990,27795897,del,NA18963,0,,1907
10,66319470,66327022,del,NA18631,0,,7552
10,19001660,19061471,del,NA20802,0,,59811
10,30675133,30680043,del,HG00478,0,,4910
10,43182879,43186543,del,NA18487,0,,3664
10,99804079,99804330,del,NA18861,0,,251
10,3421798,3423114,del,NA19908,0,,1316
10,57030508,57036643,del,NA19467,0,,6135
10,64584802,64586556,del,NA19917,0,,1754
10,120739805,120739941,del,NA19375,0,,136
10,3376151,3378580,del,NA19700,0,,2429
10,13259249,13260740,del,HG00142,0,,1491
10,104289658,104290968,del,NA19077,0,,1310
10,35120136,35124082,del,NA18628,0,,3946
10,111936895,111938445,del,NA19713,0,,1550
10,15792916,15793970,del,NA20322,0,,1054
10,12898463,12903398,del,NA19085,0,,4935
10,82750296,82752649,del,NA19395,0,,2353
10,83248650,83251693,del,HG01375,0,,3043
10,128856326,128856981,del,NA18522,0,,655
10,81662730,81663492,del,NA12748,0,,762
10,28432507,28432806,del,HG01079,0,,299
10,54015516,54018722,del,HG01173,0,,3206
10,96403446,96521581,del,HG00185,0,,118135
10,66428994,66430130,del,NA19916,0,,1136
10,63895651,63898802,del,HG00256,0,,3151
10,103445734,103446335,del,NA20786,0,,601
10,27618285,27621951,del,HG01149,0,,3666
10,120602692,120602866,del,HG00326,0,,174
10,73176012,73181306,del,NA19716,0,,5294
10,70576500,70583404,del,HG00422,0,,6904
10,13258021,13258334,del,NA18595,0,,313
10,121863323,121866782,del,HG00253,0,,3459
10,15794532,15795289,del,HG01107,0,,757
10,104509980,104511480,del,HG00262,0,,1500
10,48411169,48411254,del,HG00280,0,,85
10,113409650,113412512,del,NA18867,0,,2862
10,80446017,80447243,del,NA19428,0,,1226
10,1556774,1557164,del,HG00427,0,,390
10,30323420,30332405,del,NA12830,0,,8985
10,103853964,103861523,del,NA20765,0,,7559
10,14094901,14097206,del,NA19439,0,,2305
10,123450382,123450764,del,HG00608,0,,382
10,113996176,114001211,del,HG00124,0,,5035
10,19781494,19783050,del,HG00150,0,,1556
10,58888724,58897621,del,NA19474,0,,8897
10,115207540,115216973,del,NA20508,0,,9433
10,6411563,6417629,del,NA19467,0,,6066
10,24604553,24606979,del,HG00106,0,,2426
10,15436816,15439122,del,HG00581,0,,2306
10,1072478,1075599,del,NA18619,0,,3121
10,93633335,93634562,del,NA19452,0,,1227
10,59296694,59297011,del,HG00151,0,,317
10,131017709,131021000,del,NA18636,0,,3291
10,39105236,39112063,del,NA19147,0,,6827
10,37816563,37823511,del,NA19466,0,,6948
10,96910019,96916411,del,NA18631,0,,6392
10,824324,824442,del,NA18517,0,,118
10,73862072,73866050,del,NA19448,0,,3978
10,96241032,96241212,del,NA18615,0,,180
10,36176429,36178061,del,HG00245,0,,1632
10,12657444,12657709,del,NA18489,0,,265
10,70306906,70308152,del,HG00273,0,,1246
10,68298697,68320167,del,HG00281,0,,21470
10,127021634,127028516,del,HG00254,0,,6882
10,86738671,86748747,del,NA19834,0,,10076
10,32553540,32554350,del,HG00100,0,,810
10,48896616,48986422,del,HG00611,0,,89806
10,28503272,28511810,del,NA19240,0,,8538
10,131416123,131417035,del,HG00581,0,,912
10,25732571,25733060,del,NA20530,0,,489
10,12540462,12549881,del,NA18553,0,,9419
10,24073965,24079386,del,HG00478,0,,5421
10,112011887,112014739,del,NA19712,0,,2852
10,120707057,120707846,del,HG00737,0,,789
10,105126069,105126467,del,NA18544,0,,398
10,31443350,31444864,del,NA18576,0,,1514
10,89618455,89619697,del,NA18868,0,,1242
10,32044135,32048189,del,NA19332,0,,4054
10,8781978,8782307,del,NA19663,0,,329
10,111967916,111970822,del,HG00189,0,,2906
10,12158515,12164442,del,HG00619,0,,5927
10,105461087,105461610,del,HG00310,0,,523
10,85089703,85128830,del,HG00566,0,,39127
10,131478791,131478909,del,NA12144,0,,118
10,88838805,88842760,del,NA12717,0,,3955
10,5250316,5251272,del,NA19190,0,,956
10,57282548,57284602,del,NA18505,0,,2054
10,82736821,82739383,del,NA19461,0,,2562
10,65244481,65248743,del,NA18572,0,,4262
10,746254,746375,del,HG01492,0,,121
10,14247249,14249146,del,HG00583,0,,1897
10,75373789,75381187,del,NA20287,0,,7398
10,95086465,95087598,del,NA19462,0,,1133
10,135035313,135035481,del,NA19239,0,,168
10,38791477,38801423,del,HG00123,0,,9946
10,17777916,17955922,del,HG00282,0,,178006
10,128588848,128592215,del,NA18908,0,,3367
10,96570102,96725910,del,NA19917,0,,155808
10,3114672,3115948,del,HG00152,0,,1276
10,48514550,48514726,del,HG00654,0,,176
10,76759845,76762335,del,NA19189,0,,2490
10,66642160,66649258,del,HG01168,0,,7098
10,87256212,87257253,del,HG01134,0,,1041
10,998143,1025745,del,NA19435,0,,27602
10,134977410,134977627,del,NA20808,0,,217
10,61450939,61452113,del,NA18982,0,,1174
10,124814697,124815745,del,NA18516,0,,1048
10,99835165,99837477,del,NA18508,0,,2312
10,16356944,16357249,del,NA19213,0,,305
10,106104323,106107870,del,NA19462,0,,3547
10,100496979,100497287,del,NA19729,0,,308
10,104535470,104540914,del,NA19067,0,,5444
10,130221360,130225082,del,NA18616,0,,3722
10,60584802,60585807,del,NA18579,0,,1005
10,119979190,119979505,del,NA18520,0,,315
10,76584516,76590722,del,HG00309,0,,6206
10,42620793,42624935,del,HG00536,0,,4142
10,35695037,35699176,del,NA19713,0,,4139
10,129227075,129227268,del,HG00699,0,,193
10,107995994,107997734,del,NA12748,0,,1740
10,133972169,133974365,del,HG00657,0,,2196
10,45031362,45033326,del,HG00595,0,,1964
10,70182392,70187723,del,NA19385,0,,5331
10,112708565,112747278,del,HG01353,0,,38713
10,112842310,112845159,del,NA19189,0,,2849
10,58302294,58309668,del,HG00684,0,,7374
10,99106947,99108500,del,HG01048,0,,1553
10,21685291,21687092,del,HG00342,0,,1801
10,21116723,21118342,del,HG00653,0,,1619
10,101445739,101446996,del,NA19449,0,,1257
10,25474085,25490825,del,NA19375,0,,16740
10,12193023,12193434,del,NA19381,0,,411
10,55489414,55489601,del,NA18488,0,,187
10,2538816,2539122,del,HG01550,0,,306
10,39079094,39085839,del,NA18596,0,,6745
10,6647876,6648835,del,HG01171,0,,959
10,123433282,123461419,del,NA19982,0,,28137
10,7503140,7577345,del,NA18611,0,,74205
10,30781051,30783656,del,NA12751,0,,2605
10,105248821,105252289,del,NA18486,0,,3468
10,107401710,107405298,del,NA18486,0,,3588
10,123591992,123594459,del,NA19384,0,,2467
10,8339026,8339516,del,NA19108,0,,490
10,413875,414166,del,HG00330,0,,291
10,50408477,50410825,del,NA19313,0,,2348
10,63312336,63315764,del,NA19682,0,,3428
10,12600553,12602555,del,NA19394,0,,2002
10,171952,174560,del,HG00268,0,,2608
10,129228760,129230478,del,HG01083,0,,1718
10,19060825,19269069,del,NA19334,0,,208244
10,133937843,133938069,del,NA07037,0,,226
10,70211895,70213255,del,HG00260,0,,1360
10,135071497,135073208,del,NA19782,0,,1711
10,18670534,18671331,del,NA19381,0,,797
10,122570680,122572145,del,HG01055,0,,1465
10,28925263,28926127,del,HG00367,0,,864
10,8936558,8943264,del,HG00475,0,,6706
10,37794880,37795157,del,HG00512,0,,277
10,52718577,52719970,del,HG01136,0,,1393
10,43547728,43548662,del,NA19055,0,,934
10,3272785,3273125,del,NA19130,0,,340
10,43844950,43853213,del,NA20510,0,,8263
10,117473649,117474269,del,HG01107,0,,620
10,107252998,107253351,del,NA19770,0,,353
10,30593515,30593599,del,NA19359,0,,84
10,134354496,134354612,del,HG01108,0,,116
10,89894220,89894303,del,HG00708,0,,83
10,20529606,20531934,del,NA19070,0,,2328
10,5903830,5906720,del,NA18868,0,,2890
10,84946533,84947853,del,NA12892,0,,1320
10,27137727,27143675,del,NA19719,0,,5948
10,14647887,14648794,del,HG00640,0,,907
10,32988405,32989361,del,NA18933,0,,956
10,100025118,100025453,del,NA20513,0,,335
10,53578470,53578799,del,NA19711,0,,329
10,27603747,27706370,del,HG00281,0,,102623
10,134081178,134081338,del,HG01101,0,,160
10,20849735,20861046,del,HG00252,0,,11311
10,134778685,134779232,del,NA19007,0,,547
10,57168761,57182658,del,NA18949,0,,13897
10,42672522,42673342,del,NA12058,0,,820
10,9301931,9302243,del,NA19453,0,,312
10,67342066,67345372,del,NA19396,0,,3306
10,134067912,134068227,del,NA18552,0,,315
10,56517027,56517340,del,HG00148,0,,313
10,67330925,67337826,del,NA19819,0,,6901
10,69760875,69762007,del,NA20521,0,,1132
10,60476451,60476798,del,NA19985,0,,347
10,79788916,79794222,del,HG00266,0,,5306
10,104532283,104532592,del,NA19209,0,,309
10,85375925,85376144,del,NA18964,0,,219
10,126486625,126489396,del,NA20797,0,,2771
10,66394868,66400546,del,NA19380,0,,5678
10,12883188,12884627,del,NA18606,0,,1439
10,131580840,131581909,del,NA19783,0,,1069
10,106771231,106778229,del,HG00346,0,,6998
10,73256581,73256701,del,NA18534,0,,120
10,67242570,67243297,del,NA19713,0,,727
10,14420816,14421325,del,HG00259,0,,509
10,12273867,12435053,del,HG00247,0,,161186
10,15539352,15543529,del,NA12889,0,,4177
10,68838809,68840453,del,HG01390,0,,1644
10,125927669,125927776,del,NA19359,0,,107
10,132588359,132588705,del,NA20356,0,,346
10,83844189,83849005,del,HG01051,0,,4816
10,71797296,71801180,del,NA19371,0,,3884
10,55748456,55751782,del,NA19437,0,,3326
10,11484966,11485147,del,HG00116,0,,181
10,42400712,42409334,del,HG00554,0,,8622
10,124369744,124377828,del,HG00404,0,,8084
10,39145170,39145575,del,HG01082,0,,405
10,116270065,116271567,del,NA19238,0,,1502
10,23134045,23135793,del,HG00143,0,,1748
10,123344227,123344501,del,NA18620,0,,274
10,111789960,111790789,del,NA20775,0,,829
10,87380158,87382084,del,NA12154,0,,1926
10,129902836,129904285,del,HG00246,0,,1449
10,60953088,60953481,del,NA18989,0,,393
10,129165538,129167646,del,NA18561,0,,2108
10,122226654,122228803,del,NA19068,0,,2149
10,9491068,9496498,del,HG01190,0,,5430
10,29712145,29712720,del,HG00436,0,,575
10,103355965,103356587,del,NA18502,0,,622
10,61488840,61526307,del,NA06986,0,,37467
10,51003350,51011054,del,HG00369,0,,7704
10,35694963,35699091,del,NA19713,0,,4128
10,119330249,119330432,del,HG00608,0,,183
10,63824337,63825521,del,NA19471,0,,1184
10,68328207,68362283,del,NA19117,0,,34076
10,35331050,35332314,del,HG01070,0,,1264
10,132372179,132372324,del,HG00179,0,,145
10,22364258,22365551,del,HG00258,0,,1293
10,50611057,50611232,del,HG01101,0,,175
10,130180984,130181405,del,HG00530,0,,421
10,73216159,73216304,del,NA18502,0,,145
10,64890077,65261356,del,NA19130,0,,371279
10,19998840,19999504,del,NA19382,0,,664
10,132988684,132991208,del,HG00183,0,,2524
10,30780491,30780781,del,NA12751,0,,290
10,127300790,127300925,del,NA19074,0,,135
10,91998535,92002027,del,NA19247,0,,3492
10,119154231,119155144,del,NA19063,0,,913
10,64425660,64430893,del,NA19114,0,,5233
10,76532311,76532612,del,NA18582,0,,301
10,80935213,80936458,del,HG00324,0,,1245
10,132257882,132258083,del,HG00337,0,,201
10,54543611,54549906,del,NA18910,0,,6295
10,58952046,58953372,del,NA19385,0,,1326
10,19713627,19719526,del,HG00690,0,,5899
10,105053164,105054192,del,HG00274,0,,1028
10,58513078,58526955,del,NA18924,0,,13877
10,34197058,34203407,del,NA19471,0,,6349
10,73699291,73705961,del,HG00277,0,,6670
10,28042102,28042227,del,NA12006,0,,125
10,45094367,45096740,del,HG00330,0,,2373
10,135243190,135387947,del,HG00171,0,,144757
10,17094429,17101637,del,NA12043,0,,7208
10,107950682,107951595,del,NA19384,0,,913
10,27995967,27996202,del,NA18546,0,,235
10,133647597,133666860,del,NA18489,0,,19263
10,128145966,128154587,del,NA20812,0,,8621
10,56950010,56996736,del,NA19346,0,,46726
10,18703932,18708796,del,HG01356,0,,4864
10,75956031,75957188,del,NA19381,0,,1157
10,7670709,7671160,del,NA11995,0,,451
10,13054466,13059690,del,HG00232,0,,5224
10,68023109,68097937,del,HG00683,0,,74828
10,70272096,70272418,del,HG00463,0,,322
10,505758,505881,del,NA19147,0,,123
10,26899199,26977740,del,HG01140,0,,78541
10,121533505,121539815,del,NA18871,0,,6310
10,4159605,4159790,del,NA18549,0,,185
10,27624735,27629846,del,NA19625,0,,5111
10,19585708,19587275,del,NA19462,0,,1567
10,98417563,98420684,del,NA19401,0,,3121
10,101707597,101709255,del,NA19060,0,,1658
10,89652823,89653722,del,HG00247,0,,899
10,61295304,61295490,del,NA18856,0,,186
10,126611829,126612603,del,NA19712,0,,774
10,48410838,48411163,del,NA19190,0,,325
10,84127814,84130364,del,NA19473,0,,2550
10,128004075,128005867,del,HG00160,0,,1792
10,76471120,76472358,del,NA19722,0,,1238
10,90940164,90947591,del,HG00543,0,,7427
10,110302853,110314724,del,NA19453,0,,11871
10,55117872,55140358,del,NA19102,0,,22486
10,29918521,29918991,del,HG00231,0,,470
10,11419999,11423320,del,HG00513,0,,3321
10,94159920,94169410,del,HG00620,0,,9490
10,45410835,45414342,del,NA19654,0,,3507
10,71230830,71237824,del,HG01375,0,,6994
10,33492640,33492929,del,HG01334,0,,289
10,58863547,58863866,del,NA18502,0,,319
10,102957011,102957647,del,NA19390,0,,636
10,81784236,81791468,del,NA19670,0,,7232
10,38791400,38801669,del,HG01067,0,,10269
10,134635393,134635515,del,HG00692,0,,122
10,85105,115322,dup,HG01351,0,,30217
10,101948,135503,dup,HG00105,0,,33555
10,164366,220315,dup,NA20872,0,,55949
10,292047,306120,dup,NA19351,0,,14073
10,624055,639546,dup,HG04227,0,,15491
10,965823,971128,dup,NA19038,0,,5305
10,998173,1016934,dup,HG02568,0,,18761
10,999797,1029177,dup,HG02568,0,,29380
10,1110655,1117529,dup,HG02614,0,,6874
10,1370004,1462101,dup,HG02549,0,,92097
10,1613673,1617333,dup,HG00320,0,,3660
10,1861199,1921597,dup,NA18974,0,,60398
10,1861357,1921693,dup,NA18952,0,,60336
10,1862332,1889193,dup,NA18952,0,,26861
10,1884391,1912165,dup,NA19734,0,,27774
10,1903990,1922355,dup,NA18952,0,,18365
10,2035987,2047506,dup,HG02455,0,,11519
10,2655397,2680162,dup,HG00533,0,,24765
10,2688812,3134296,dup,HG00533,0,,445484
10,2690830,2770211,dup,HG00533,0,,79381
10,2705742,2818078,dup,HG01886,0,,112336
10,2876282,2886776,dup,HG02810,0,,10494
10,2963457,2978290,dup,HG01886,0,,14833
10,3141429,3167629,dup,HG00266,0,,26200
10,3179999,3227801,dup,HG00533,0,,47802
10,3305742,3310523,dup,HG00266,0,,4781
10,3859331,3871168,dup,NA12286,0,,11837
10,4027153,4056371,dup,HG03007,0,,29218
10,4293454,4312539,dup,HG02067,0,,19085
10,5034406,5087198,dup,HG03437,0,,52792
10,5143422,5326389,dup,HG03585,0,,182967
10,5154840,5216975,dup,HG01762,0,,62135
10,5202104,5324761,dup,HG01762,0,,122657
10,5270253,5294004,dup,HG00556,0,,23751
10,5651199,5702569,dup,HG03157,0,,51370
10,6146661,6361141,dup,HG01668,0,,214480
10,6213118,6227710,dup,HG00622,0,,14592
10,7080262,7126659,dup,NA19758,0,,46397
10,7094618,7143939,dup,NA18517,0,,49321
10,7706362,7727485,dup,NA19316,0,,21123
10,7706502,7727095,dup,NA19316,0,,20593
10,8722562,8728344,dup,HG01345,0,,5782
10,8899619,8912023,dup,HG04056,0,,12404
10,9374586,9477369,dup,HG03397,0,,102783
10,9492626,9495896,dup,HG01190,0,,3270
10,9742555,9805336,dup,HG03049,0,,62781
10,9806995,9876021,dup,HG03049,0,,69026
10,10130884,10172467,dup,HG00309,0,,41583
10,10521448,10534634,dup,NA19206,0,,13186
10,11154290,11159239,dup,HG01624,0,,4949
10,11734045,11739468,dup,HG02634,0,,5423
10,11847114,11881009,dup,HG03803,0,,33895
10,11847141,11902058,dup,HG03803,0,,54917
10,12092804,12171370,dup,HG01886,0,,78566
10,12102547,12113247,dup,HG01886,0,,10700
10,12111903,12124450,dup,HG01886,0,,12547
10,12142306,12157616,dup,HG01886,0,,15310
10,12242774,12870317,dup,HG03061,0,,627543
10,12542123,12550936,dup,NA18553,0,,8813
10,13034991,13057357,dup,HG01464,0,,22366
10,13884258,13900724,dup,HG03990,0,,16466
10,15011227,15060084,dup,HG01500,0,,48857
10,15409489,15528644,dup,HG01796,0,,119155
10,15645294,15788398,dup,HG02756,0,,143104
10,15646352,15808603,dup,HG02756,0,,162251
10,16185341,16200226,dup,HG01851,0,,14885
10,16850206,16976687,dup,HG00530,0,,126481
10,17364415,17383538,dup,HG01363,0,,19123
10,17611933,17630331,dup,HG02141,0,,18398
10,18378527,18407098,dup,HG00179,0,,28571
10,18379674,18403329,dup,NA12813,0,,23655
10,18746977,18761003,dup,HG01247,0,,14026
10,18831144,18909986,dup,HG03790,0,,78842
10,18839302,18944144,dup,HG03790,0,,104842
10,19060680,19084125,dup,NA19378,0,,23445
10,19093992,19268804,dup,NA19378,0,,174812
10,19507134,19510917,dup,HG00651,0,,3783
10,19825563,20035698,dup,HG00580,0,,210135
10,20781692,20823839,dup,NA11829,0,,42147
10,20788636,20818627,dup,HG00246,0,,29991
10,20836526,21006042,dup,HG01353,0,,169516
10,21030871,21039873,dup,HG01104,0,,9002
10,21267776,21272112,dup,HG03019,0,,4336
10,21616832,21627035,dup,NA19431,0,,10203
10,22366338,22410555,dup,NA18633,0,,44217
10,23767867,23787958,dup,HG03681,0,,20091
10,24123508,24140026,dup,HG02724,0,,16518
10,24160522,24166603,dup,HG00513,0,,6081
10,24378130,24382519,dup,HG01187,0,,4389
10,24430940,24438235,dup,HG00536,0,,7295
10,24521516,24549353,dup,HG00332,0,,27837
10,24522784,24535590,dup,HG00310,0,,12806
10,25023419,25031256,dup,HG03490,0,,7837
10,25048746,25059150,dup,HG02491,0,,10404
10,25531813,25545042,dup,HG00245,0,,13229
10,25711770,25716345,dup,HG01344,0,,4575
10,26187841,26192006,dup,NA18950,0,,4165
10,27126287,27131614,dup,HG01531,0,,5327
10,27224210,27228442,dup,HG00116,0,,4232
10,27360447,27425317,dup,HG04164,0,,64870
10,27427014,27985729,dup,HG00631,0,,558715
10,27454138,27478031,dup,HG00631,0,,23893
10,27495175,27502826,dup,HG00631,0,,7651
10,27531694,27589600,dup,HG00631,0,,57906
10,27603764,27689764,dup,HG00250,0,,86000
10,27659349,27701469,dup,HG00281,0,,42120
10,27701738,27794266,dup,HG00631,0,,92528
10,27858472,27993301,dup,HG00631,0,,134829
10,28989342,29029685,dup,HG03736,0,,40343
10,29371871,29585430,dup,NA19236,0,,213559
10,29374337,29399703,dup,NA19236,0,,25366
10,29383400,29520839,dup,NA19236,0,,137439
10,29444206,29581836,dup,NA19236,0,,137630
10,30364690,30375816,dup,HG03055,0,,11126
10,31096041,31114649,dup,NA19764,0,,18608
10,31576974,31582436,dup,HG00536,0,,5462
10,32044145,32048168,dup,HG01061,0,,4023
10,32254650,32270866,dup,NA19456,0,,16216
10,32274044,32285068,dup,HG01122,0,,11024
10,32863341,32868420,dup,HG01051,0,,5079
10,32997873,33008884,dup,NA19658,0,,11011
10,33666505,33855205,dup,HG00421,0,,188700
10,33667877,33728890,dup,HG00421,0,,61013
10,33856425,33959585,dup,HG00421,0,,103160
10,33963745,34080115,dup,HG00421,0,,116370
10,34466981,34605262,dup,HG00421,0,,138281
10,34862057,34889477,dup,NA20800,0,,27420
10,34928664,34931845,dup,HG00278,0,,3181
10,35022223,35145934,dup,HG01775,0,,123711
10,35025740,35089205,dup,HG01775,0,,63465
10,35112629,35122031,dup,HG00261,0,,9402
10,35120555,35124035,dup,HG00610,0,,3480
10,35126852,35137360,dup,HG00261,0,,10508
10,35157683,35214685,dup,HG00261,0,,57002
10,35571326,35615825,dup,HG01606,0,,44499
10,35584590,35617719,dup,HG01606,0,,33129
10,36302721,36329567,dup,HG03538,0,,26846
10,36795809,36839129,dup,HG01678,0,,43320
10,36801390,36815041,dup,HG01678,0,,13651
10,36929637,37016951,dup,HG02697,0,,87314
10,36930696,36966310,dup,HG02697,0,,35614
10,37048463,37133691,dup,HG02697,0,,85228
10,37055070,37059460,dup,HG01589,0,,4390
10,37124580,37228240,dup,HG02697,0,,103660
10,37199661,37331789,dup,HG03445,0,,132128
10,37342287,37439614,dup,HG02697,0,,97327
10,37455931,37505417,dup,HG00406,0,,49486
10,37483620,37740789,dup,HG02697,0,,257169
10,37489270,37541316,dup,HG02697,0,,52046
10,37541317,37583524,dup,HG02697,0,,42207
10,37728962,37886956,dup,HG00473,0,,157994
10,37731342,38036498,dup,HG00473,0,,305156
10,37838003,37865382,dup,HG00473,0,,27379
10,38019876,38061793,dup,HG00473,0,,41917
10,38873284,38907858,dup,HG00097,0,,34574
10,38910054,38926089,dup,HG01896,0,,16035
10,38970575,39006575,dup,HG01896,0,,36000
10,42611559,42684053,dup,HG00428,0,,72494
10,42717063,42758306,dup,HG00626,0,,41243
10,42789198,42947829,dup,HG00626,0,,158631
10,42857631,42929901,dup,HG00096,0,,72270
10,42919650,43022026,dup,HG03708,0,,102376
10,43016526,43033378,dup,HG00734,0,,16852
10,43041974,43060488,dup,NA20804,0,,18514
10,43079537,43151089,dup,NA18620,0,,71552
10,43184528,43247358,dup,NA18620,0,,62830
10,43405544,43425745,dup,NA12045,0,,20201
10,44193584,44202108,dup,NA19028,0,,8524
10,44412138,44430734,dup,HG01775,0,,18596
10,44476766,44487603,dup,NA18617,0,,10837
10,45208633,45359880,dup,HG00097,0,,151247
10,45226031,45270970,dup,HG00097,0,,44939
10,45331249,45360544,dup,HG00097,0,,29295
10,45410942,45414448,dup,HG01694,0,,3506
10,45489207,45523559,dup,HG03380,0,,34352
10,45570009,45804481,dup,HG00096,0,,234472
10,45601388,45646802,dup,HG00096,0,,45414
10,45961390,45980783,dup,HG03380,0,,19393
10,45990189,46027701,dup,HG03380,0,,37512
10,46161870,46173404,dup,HG03380,0,,11534
10,46205785,46220054,dup,HG03380,0,,14269
10,47383857,47395064,dup,HG00237,0,,11207
10,47531022,47599037,dup,HG00237,0,,68015
10,47596038,47634490,dup,HG00237,0,,38452
10,47645964,47697149,dup,HG00237,0,,51185
10,48590483,48594285,dup,HG01889,0,,3802
10,50365255,50369454,dup,HG02088,0,,4199
10,50365689,50379545,dup,HG02582,0,,13856
10,50751366,50765272,dup,HG02259,0,,13906
10,51095087,51137134,dup,HG00475,0,,42047
10,51488994,51537064,dup,NA18868,0,,48070
10,51489794,51600128,dup,HG03548,0,,110334
10,51574546,51594246,dup,NA18530,0,,19700
10,52030335,52118171,dup,HG02570,0,,87836
10,52032571,52052474,dup,HG02570,0,,19903
10,52165724,52169058,dup,NA18534,0,,3334
10,52261375,52268683,dup,NA12829,0,,7308
10,52264818,52290086,dup,HG03868,0,,25268
10,52267184,52273749,dup,HG03931,0,,6565
10,52274000,52298783,dup,HG03868,0,,24783
10,52754975,52758023,dup,HG02462,0,,3048
10,53094058,53215481,dup,HG01673,0,,121423
10,54201954,54241815,dup,HG03772,0,,39861
10,54204379,54240205,dup,HG03772,0,,35826
10,54315037,54430074,dup,NA18749,0,,115037
10,54536334,54548154,dup,HG04001,0,,11820
10,54545804,54587610,dup,NA18749,0,,41806
10,54682113,54695310,dup,HG03717,0,,13197
10,54701802,54782731,dup,HG02397,0,,80929
10,54787545,54907119,dup,HG02397,0,,119574
10,54975861,55046428,dup,HG01459,0,,70567
10,54981257,54984505,dup,HG01459,0,,3248
10,55046429,55209835,dup,HG01459,0,,163406
10,55247701,55316056,dup,NA20901,0,,68355
10,55259943,55268027,dup,HG03744,0,,8084
10,55271043,55311490,dup,NA20901,0,,40447
10,55373214,55459927,dup,HG01403,0,,86713
10,56297093,56320522,dup,NA20588,0,,23429
10,56445493,56470541,dup,HG00123,0,,25048
10,56569778,56610696,dup,HG00142,0,,40918
10,56870484,56886275,dup,HG04019,0,,15791
10,56925226,56934704,dup,HG00404,0,,9478
10,57030445,57034603,dup,HG03121,0,,4158
10,57219558,57292334,dup,NA12156,0,,72776
10,57374747,57389411,dup,HG01029,0,,14664
10,57439432,57499393,dup,HG03212,0,,59961
10,57579002,57742186,dup,HG03212,0,,163184
10,57584186,57628594,dup,HG03212,0,,44408
10,57669180,57730336,dup,HG03212,0,,61156
10,57723724,57754108,dup,HG02722,0,,30384
10,57774132,57779632,dup,NA19017,0,,5500
10,57934910,57947827,dup,HG03774,0,,12917
10,58036719,58106576,dup,HG01620,0,,69857
10,58107002,58120799,dup,HG01620,0,,13797
10,58119588,58159738,dup,HG01620,0,,40150
10,58251071,58265308,dup,HG03793,0,,14237
10,58324399,58351361,dup,HG01985,0,,26962
10,58408495,58484220,dup,HG01985,0,,75725
10,58739037,58752064,dup,HG00257,0,,13027
10,58902108,58940969,dup,HG00406,0,,38861
10,59739481,59773021,dup,HG02383,0,,33540
10,59842001,59892302,dup,HG02702,0,,50301
10,60856139,60906551,dup,NA19129,0,,50412
10,61357908,61380107,dup,HG00566,0,,22199
10,62156301,62184676,dup,HG02541,0,,28375
10,62381657,62389102,dup,HG00743,0,,7445
10,63299437,63304617,dup,HG00583,0,,5180
10,63312280,63315336,dup,NA18757,0,,3056
10,63571259,63575627,dup,HG02724,0,,4368
10,65936537,65969594,dup,HG02522,0,,33057
10,65980398,65988367,dup,HG03866,0,,7969
10,65992658,66016853,dup,HG02769,0,,24195
10,66143354,66260445,dup,HG03397,0,,117091
10,66401575,66458411,dup,HG01596,0,,56836
10,66460612,66470213,dup,NA19089,0,,9601
10,66492733,66545189,dup,HG01596,0,,52456
10,66671851,66710322,dup,HG01596,0,,38471
10,66728956,66742317,dup,HG01596,0,,13361
10,66755491,66765200,dup,HG01596,0,,9709
10,66780716,66830795,dup,HG01596,0,,50079
10,66846512,66860506,dup,HG03616,0,,13994
10,67162914,67181445,dup,NA19377,0,,18531
10,67779169,67865936,dup,NA18740,0,,86767
10,67779460,67971002,dup,NA18740,0,,191542
10,67988601,67995651,dup,HG02657,0,,7050
10,68009043,68032331,dup,NA18740,0,,23288
10,68024709,68095051,dup,HG00683,0,,70342
10,68032524,68148495,dup,HG00683,0,,115971
10,68078929,68116539,dup,HG00742,0,,37610
10,68107479,68139898,dup,HG02291,0,,32419
10,68143949,68165632,dup,NA18740,0,,21683
10,68161958,68204702,dup,HG01865,0,,42744
10,68195851,68242900,dup,HG01865,0,,47049
10,68247675,68300554,dup,HG01865,0,,52879
10,68247697,68301600,dup,HG00557,0,,53903
10,68295628,68306858,dup,HG00281,0,,11230
10,68296544,68398402,dup,HG00557,0,,101858
10,68339608,68410427,dup,HG01865,0,,70819
10,68424363,68449653,dup,HG00557,0,,25290
10,68543835,68590008,dup,HG04152,0,,46173
10,69015180,69080278,dup,HG04002,0,,65098
10,69099429,69138595,dup,HG04002,0,,39166
10,69335756,69456371,dup,HG01342,0,,120615
10,69343046,69383833,dup,HG01342,0,,40787
10,69733931,69869742,dup,HG03914,0,,135811
10,69739687,69813004,dup,HG03914,0,,73317
10,69858765,70057168,dup,HG03914,0,,198403
10,69973869,70064668,dup,HG03914,0,,90799
10,71053947,71071532,dup,HG03672,0,,17585
10,71203494,71213357,dup,HG02153,0,,9863
10,71444974,71449098,dup,NA20505,0,,4124
10,71638238,71746629,dup,NA21092,0,,108391
10,71780782,71808998,dup,HG00641,0,,28216
10,73711338,73721542,dup,NA19372,0,,10204
10,74404227,74420215,dup,HG02611,0,,15988
10,75975062,76048634,dup,HG00141,0,,73572
10,76323946,76327343,dup,HG01628,0,,3397
10,76541716,76553162,dup,HG02356,0,,11446
10,76944134,76960202,dup,HG03890,0,,16068
10,77544156,77568881,dup,NA12872,0,,24725
10,77544308,77701786,dup,NA12872,0,,157478
10,77961809,77966048,dup,HG02009,0,,4239
10,79369170,79516141,dup,NA18633,0,,146971
10,79369487,79595193,dup,NA18633,0,,225706
10,79544079,79595382,dup,NA18633,0,,51303
10,80880600,80902685,dup,HG01790,0,,22085
10,81174082,81223958,dup,HG01630,0,,49876
10,81174121,81278514,dup,HG01630,0,,104393
10,81294047,81313479,dup,HG00329,0,,19432
10,81304676,81394762,dup,HG00329,0,,90086
10,81304879,81391064,dup,HG01133,0,,86185
10,81474561,81502396,dup,HG00097,0,,27835
10,81505304,81602509,dup,HG00266,0,,97205
10,81613179,81623563,dup,HG01133,0,,10384
10,81636383,81738266,dup,HG01133,0,,101883
10,81682942,81834924,dup,HG01133,0,,151982
10,81781977,81811446,dup,HG01133,0,,29469
10,81841548,81852440,dup,HG01133,0,,10892
10,81849256,81862893,dup,HG01133,0,,13637
10,81877419,81884006,dup,HG01133,0,,6587
10,81893221,81935490,dup,HG00349,0,,42269
10,81971095,81985058,dup,HG00361,0,,13963
10,82094663,82112817,dup,HG02493,0,,18154
10,82482110,82502501,dup,HG01139,0,,20391
10,82888310,82945824,dup,HG02882,0,,57514
10,82890194,82929800,dup,HG02882,0,,39606
10,82935951,82946401,dup,HG00331,0,,10450
10,83829290,83902698,dup,HG03945,0,,73408
10,83829460,83903664,dup,HG03945,0,,74204
10,84042801,84063184,dup,NA18579,0,,20383
10,84398039,84431734,dup,HG00128,0,,33695
10,84406902,84430923,dup,HG00128,0,,24021
10,84918135,84933897,dup,HG03024,0,,15762
10,85074060,85124250,dup,HG00566,0,,50190
10,86345443,86383343,dup,HG00656,0,,37900
10,86551212,86619458,dup,HG01597,0,,68246
10,86623452,86930338,dup,HG01597,0,,306886
10,86687540,86712690,dup,NA20887,0,,25150
10,86691964,86719934,dup,NA20887,0,,27970
10,86724239,86741959,dup,NA18879,0,,17720
10,86738881,86799567,dup,HG01516,0,,60686
10,86794536,87022939,dup,HG01597,0,,228403
10,86933241,87073298,dup,HG01597,0,,140057
10,87053820,87138625,dup,HG01597,0,,84805
10,87081853,87166156,dup,HG01597,0,,84303
10,87156837,87162119,dup,HG01597,0,,5282
10,89079429,89114090,dup,HG00136,0,,34661
10,89153746,89188370,dup,NA18549,0,,34624
10,89953671,89998550,dup,NA20357,0,,44879
10,90117170,90217052,dup,HG02309,0,,99882
10,90144507,90285434,dup,HG02309,0,,140927
10,90248794,90448452,dup,HG01060,0,,199658
10,90315639,90463406,dup,HG02309,0,,147767
10,90484737,90763064,dup,HG02309,0,,278327
10,90551092,90632203,dup,HG00537,0,,81111
10,90636694,90771393,dup,HG03479,0,,134699
10,90795115,90800286,dup,HG00759,0,,5171
10,91110290,91121654,dup,HG03757,0,,11364
10,91568742,91800746,dup,HG03950,0,,232004
10,91859534,92047333,dup,HG03950,0,,187799
10,94101486,94124170,dup,HG03117,0,,22684
10,96404664,96484330,dup,HG00185,0,,79666
10,96495219,96575369,dup,HG00268,0,,80150
10,96660577,96670276,dup,HG03778,0,,9699
10,96683725,96859143,dup,HG03388,0,,175418
10,96691647,96764236,dup,HG03388,0,,72589
10,96915940,96925503,dup,HG03910,0,,9563
10,97069414,97263028,dup,HG03378,0,,193614
10,97069543,97116534,dup,HG03378,0,,46991
10,97069619,97262785,dup,HG03378,0,,193166
10,97408784,97438410,dup,HG02817,0,,29626
10,97706476,97759462,dup,NA18924,0,,52986
10,97763722,97800819,dup,NA18924,0,,37097
10,99190969,99201598,dup,HG01551,0,,10629
10,99573434,99587022,dup,NA11933,0,,13588
10,99573666,99585012,dup,NA11933,0,,11346
10,101777284,101782625,dup,HG03018,0,,5341
10,102214024,102269395,dup,NA06994,0,,55371
10,102844563,102972323,dup,HG01709,0,,127760
10,103192250,103228813,dup,NA19722,0,,36563
10,103224939,103232818,dup,HG02143,0,,7879
10,103270617,103403267,dup,NA19722,0,,132650
10,104926841,105008279,dup,HG02635,0,,81438
10,104961801,105006778,dup,HG02635,0,,44977
10,105152393,105219515,dup,NA19819,0,,67122
10,105172600,105219027,dup,NA19819,0,,46427
10,105308023,105311053,dup,HG00543,0,,3030
10,107056449,107062280,dup,HG00097,0,,5831
10,107099713,107252254,dup,HG02684,0,,152541
10,107100763,107317898,dup,HG02684,0,,217135
10,107102271,107200277,dup,HG02684,0,,98006
10,107898580,107902201,dup,HG04239,0,,3621
10,108094043,108179952,dup,HG01551,0,,85909
10,109844973,109895563,dup,NA20800,0,,50590
10,109957785,109966913,dup,NA19654,0,,9128
10,110604239,110618403,dup,HG01085,0,,14164
10,110934924,110962056,dup,NA12842,0,,27132
10,110989623,111005605,dup,NA12842,0,,15982
10,112918898,113001546,dup,HG02224,0,,82648
10,112967230,113004177,dup,HG03007,0,,36947
10,112994997,113013687,dup,NA20897,0,,18690
10,113168721,113185030,dup,NA19379,0,,16309
10,113170375,113210879,dup,NA19379,0,,40504
10,113177384,113232336,dup,NA19379,0,,54952
10,113547357,113570770,dup,HG02778,0,,23413
10,114346795,114380867,dup,HG03193,0,,34072
10,115280247,115301705,dup,NA19435,0,,21458
10,115341616,115505175,dup,HG01757,0,,163559
10,115342545,115429613,dup,HG01757,0,,87068
10,115439096,115492147,dup,HG01757,0,,53051
10,116628479,116658975,dup,HG00238,0,,30496
10,116633940,116679382,dup,HG00238,0,,45442
10,116636290,116883372,dup,HG00238,0,,247082
10,116673480,116750766,dup,HG00238,0,,77286
10,116682869,116854566,dup,HG00238,0,,171697
10,117625592,117667683,dup,HG00736,0,,42091
10,118338172,118356010,dup,HG02299,0,,17838
10,118429204,118439274,dup,HG01412,0,,10070
10,118447027,118490519,dup,HG01747,0,,43492
10,118820421,118955996,dup,HG02983,0,,135575
10,118821189,118879315,dup,HG02983,0,,58126
10,118901368,119184715,dup,HG02983,0,,283347
10,121282705,121303087,dup,HG01598,0,,20382
10,121738861,121741883,dup,HG02651,0,,3022
10,122350084,122473168,dup,NA20332,0,,123084
10,122361926,122390484,dup,NA20332,0,,28558
10,122391579,122400919,dup,HG02682,0,,9340
10,122402420,122470549,dup,NA20332,0,,68129
10,122486271,122770533,dup,HG02144,0,,284262
10,122487302,122599781,dup,HG02144,0,,112479
10,122746953,122769592,dup,HG02144,0,,22639
10,123434389,123462971,dup,HG01122,0,,28582
10,124344431,124353237,dup,HG00099,0,,8806
10,124362323,124384173,dup,NA18969,0,,21850
10,124621086,124663901,dup,NA18878,0,,42815
10,125955762,125959174,dup,HG01369,0,,3412
10,126620671,126626329,dup,HG01102,0,,5658
10,127071478,127076777,dup,HG01577,0,,5299
10,127747155,127805812,dup,HG01708,0,,58657
10,127747264,127888360,dup,HG01708,0,,141096
10,127924952,128142477,dup,HG01708,0,,217525
10,127947691,127958811,dup,NA18939,0,,11120
10,127962193,128109790,dup,HG01708,0,,147597
10,128588921,128592081,dup,HG01047,0,,3160
10,128766065,128783100,dup,NA20535,0,,17035
10,128767540,128804277,dup,HG04096,0,,36737
10,128790325,128807844,dup,HG01867,0,,17519
10,129103222,129133534,dup,HG03875,0,,30312
10,132046388,132063018,dup,NA20845,0,,16630
10,132082642,132150010,dup,HG03629,0,,67368
10,132339338,132364494,dup,HG01390,0,,25156
10,132670985,132690268,dup,HG01842,0,,19283
10,132909082,132912781,dup,HG00101,0,,3699
10,133047401,134036654,dup,NA19428,0,,989253
10,133244953,133379385,dup,HG02952,0,,134432
10,133245153,133473311,dup,HG02952,0,,228158
10,133440466,133563194,dup,HG02952,0,,122728
10,133469631,133477540,dup,HG00180,0,,7909
10,133491031,133634991,dup,HG02952,0,,143960
10,133559860,133677281,dup,HG02952,0,,117421
10,133644197,133670151,dup,HG02481,0,,25954
10,133732098,133755439,dup,HG02952,0,,23341
10,133805142,133900703,dup,NA20291,0,,95561
10,134136386,134364854,dup,HG00096,0,,228468
10,134151810,134179753,dup,HG00096,0,,27943
10,134183629,134212401,dup,HG00096,0,,28772
10,134265395,134300021,dup,HG00096,0,,34626
10,134317241,134362349,dup,HG00096,0,,45108
10,134576614,134584995,dup,HG01110,0,,8381
10,134604484,134616215,dup,HG01110,0,,11731
10,134633552,134647027,dup,HG01110,0,,13475
10,134655909,134669033,dup,HG01110,0,,13124
10,134664837,134679407,dup,HG01110,0,,14570
10,134698920,134729636,dup,HG01110,0,,30716
10,134702516,134928191,dup,HG03902,0,,225675
10,134742951,134766544,dup,HG01110,0,,23593
10,134751121,134801614,dup,HG03902,0,,50493
10,134758357,134777113,dup,HG02166,0,,18756
10,134779359,134816887,dup,HG02166,0,,37528
10,134812159,134934419,dup,HG03902,0,,122260
10,135012973,135033050,dup,HG02769,0,,20077
10,135014366,135193246,dup,NA20516,0,,178880
10,135032651,135047362,dup,HG02010,0,,14711
10,135053242,135063009,dup,HG02769,0,,9767
10,135066539,135077371,dup,NA20516,0,,10832
10,135112533,135129984,dup,HG00626,0,,17451
10,135132071,135142744,dup,HG01082,0,,10673
10,135141195,135186635,dup,HG01779,0,,45440
10,135218352,135228675,dup,NA20535,0,,10323
10,135256278,135368497,dup,HG03445,0,,112219
10,135273198,135338534,dup,HG03445,0,,65336
10,135348035,135378260,dup,HG02075,0,,30225
10,135399245,135435575,dup,HG03823,0,,36330
11,22433876,22433992,del,NA19731,0,,116
11,68069297,68234415,del,NA18977,0,,165118
11,129905270,129905399,del,NA19108,0,,129
11,60451045,60451734,del,HG00344,0,,689
11,75875818,75875997,del,HG00533,0,,179
11,47216127,47219270,del,NA19777,0,,3143
11,93910803,93911243,del,NA12045,0,,440
11,54993518,54995385,del,HG01187,0,,1867
11,13789658,13790521,del,NA19376,0,,863
11,128760735,128762785,del,NA20814,0,,2050
11,71912278,71912502,del,NA18557,0,,224
11,56345761,56356461,del,HG00140,0,,10700
11,63561322,63564288,del,NA18593,0,,2966
11,1935941,1936339,del,NA19776,0,,398
11,4272153,4327520,del,NA18638,0,,55367
11,104724920,104759604,del,NA18504,0,,34684
11,4574499,4574818,del,NA19239,0,,319
11,95273706,95285256,del,NA19717,0,,11550
11,49125619,49127629,del,NA12044,0,,2010
11,55248868,55253581,del,NA18627,0,,4713
11,97517721,97521129,del,HG01488,0,,3408
11,86753840,86756512,del,NA19213,0,,2672
11,96743067,96753571,del,NA18486,0,,10504
11,3417831,3420420,del,NA12892,0,,2589
11,99227840,99228165,del,NA19819,0,,325
11,106274875,106275374,del,NA19431,0,,499
11,68291087,68291608,del,HG00443,0,,521
11,7846663,7847578,del,NA18511,0,,915
11,55001388,55015687,del,HG01495,0,,14299
11,132566334,132575288,del,HG01204,0,,8954
11,128785686,128785885,del,HG00590,0,,199
11,71212745,71215722,del,HG01353,0,,2977
11,67986819,67988568,del,HG00734,0,,1749
11,107124369,107129226,del,NA19438,0,,4857
11,85248550,85250380,del,NA20317,0,,1830
11,63197918,63202785,del,NA19347,0,,4867
11,50366415,50416213,del,NA19395,0,,49798
11,110911647,110911818,del,HG00273,0,,171
11,90193216,90195622,del,NA19818,0,,2406
11,73560784,73561418,del,NA18999,0,,634
11,3649016,3651322,del,HG00671,0,,2306
11,114386459,114386570,del,HG00139,0,,111
11,48878753,48881833,del,NA19682,0,,3080
11,98511404,98513215,del,HG00513,0,,1811
11,39821045,39826468,del,NA19712,0,,5423
11,58631772,58636553,del,HG00560,0,,4781
11,25076678,25079639,del,HG00178,0,,2961
11,124681780,124682766,del,NA18907,0,,986
11,85055943,85060987,del,NA19399,0,,5044
11,50694248,50700376,del,HG01060,0,,6128
11,37210868,37211993,del,NA19712,0,,1125
11,69686782,69686934,del,HG00310,0,,152
11,125391402,125394343,del,HG00705,0,,2941
11,102751130,102753291,del,NA19982,0,,2161
11,66854085,66857221,del,HG00178,0,,3136
11,27253913,27254925,del,HG00708,0,,1012
11,20844554,20849947,del,HG00141,0,,5393
11,1433315,1433747,del,HG01204,0,,432
11,24658369,24664349,del,NA18517,0,,5980
11,117664516,117668422,del,HG00118,0,,3906
11,28570864,28571256,del,NA18907,0,,392
11,41828802,41829098,del,NA18595,0,,296
11,61649274,61652947,del,NA19471,0,,3673
11,44113508,44115309,del,HG01066,0,,1801
11,9338352,9338631,del,HG01365,0,,279
11,4542704,4543818,del,NA19247,0,,1114
11,18097753,18100112,del,NA12749,0,,2359
11,62827666,62829806,del,NA18544,0,,2140
11,133020578,133025059,del,NA19430,0,,4481
11,55434016,55443822,del,HG01198,0,,9806
11,46408529,46408689,del,NA07347,0,,160
11,8470404,8471241,del,NA19373,0,,837
11,96538780,96544451,del,HG01204,0,,5671
11,72243510,72247959,del,NA18916,0,,4449
11,83850494,83855890,del,NA12761,0,,5396
11,116991774,116992488,del,HG00626,0,,714
11,3649187,3651886,del,HG00620,0,,2699
11,114486032,114487824,del,NA19373,0,,1792
11,17209752,17211215,del,NA19099,0,,1463
11,61263643,61269222,del,NA18983,0,,5579
11,48090754,48098522,del,NA18989,0,,7768
11,68797622,68797722,del,HG00237,0,,100
11,102104602,102107497,del,NA19085,0,,2895
11,45429846,45431613,del,NA11932,0,,1767
11,104316084,104320762,del,NA19473,0,,4678
11,54928223,54929022,del,NA19390,0,,799
11,127685591,127686076,del,HG00157,0,,485
11,118281656,118282938,del,NA19240,0,,1282
11,127924256,127935420,del,HG00607,0,,11164
11,57728510,57729652,del,HG00318,0,,1142
11,93695220,93702084,del,NA18547,0,,6864
11,51335370,51368596,del,NA20818,0,,33226
11,1815833,1816697,del,NA19436,0,,864
11,111461893,111464453,del,NA19920,0,,2560
11,34048616,34048786,del,NA12889,0,,170
11,65641616,65644322,del,HG01518,0,,2706
11,6189741,6192921,del,NA19147,0,,3180
11,91275373,91278489,del,NA19377,0,,3116
11,130225609,130230334,del,NA18510,0,,4725
11,61900703,61900907,del,HG00478,0,,204
11,72260225,72261573,del,NA19703,0,,1348
11,33089839,33090120,del,HG00326,0,,281
11,46579180,46591657,del,HG00118,0,,12477
11,56439772,56440269,del,HG01060,0,,497
11,134403939,134407557,del,HG00345,0,,3618
11,124202377,124274249,del,NA12775,0,,71872
11,70451533,70452555,del,NA19909,0,,1022
11,76142327,76148551,del,HG00638,0,,6224
11,4967801,4976289,del,HG00608,0,,8488
11,95735835,95735991,del,NA19114,0,,156
11,25880196,25880405,del,HG01101,0,,209
11,55315283,55316273,del,NA18943,0,,990
11,21669014,21676501,del,NA18611,0,,7487
11,70846745,70848017,del,HG00671,0,,1272
11,31318924,31322913,del,HG00708,0,,3989
11,61944787,61945085,del,HG01516,0,,298
11,20934219,20936845,del,HG00464,0,,2626
11,86624317,86625084,del,NA19456,0,,767
11,71310971,71610964,del,HG01489,0,,299993
11,105413349,105416534,del,NA18502,0,,3185
11,9584608,9585955,del,NA18956,0,,1347
11,47405796,47406574,del,HG00278,0,,778
11,65552095,65552415,del,NA18534,0,,320
11,105765505,105765824,del,NA19652,0,,319
11,127221493,127228419,del,HG00536,0,,6926
11,25030309,25060182,del,NA12889,0,,29873
11,61436533,61445914,del,NA19078,0,,9381
11,3651867,3662225,del,HG00707,0,,10358
11,123314793,123320402,del,HG00500,0,,5609
11,5623588,5623964,del,HG00339,0,,376
11,83128394,83135983,del,NA18523,0,,7589
11,118567135,118567133,del,HG01048,0,,-2
11,69049117,69056337,del,NA19448,0,,7220
11,99933469,99934635,del,HG00428,0,,1166
11,34838058,34838172,del,NA19654,0,,114
11,115259541,115262786,del,NA20525,0,,3245
11,55422334,55603646,del,NA19376,0,,181312
11,24349482,24355548,del,HG00118,0,,6066
11,51238610,51245270,del,HG00656,0,,6660
11,398084,398487,del,HG01055,0,,403
11,100794227,100796282,del,HG01082,0,,2055
11,43201669,43208768,del,HG00596,0,,7099
11,134610148,134610256,del,NA19403,0,,108
11,112367800,112369149,del,NA12717,0,,1349
11,2450298,2450711,del,HG00736,0,,413
11,86304230,86306558,del,NA18989,0,,2328
11,69413968,69430722,del,HG01378,0,,16754
11,85794732,85800001,del,HG00267,0,,5269
11,97137420,97137839,del,NA20528,0,,419
11,65934916,65939172,del,NA19257,0,,4256
11,81157264,81158796,del,NA19383,0,,1532
11,89379290,89389832,del,HG00326,0,,10542
11,85429852,85472198,del,NA12761,0,,42346
11,37708649,37712794,del,NA19438,0,,4145
11,38355997,38358204,del,HG00258,0,,2207
11,32868484,32872422,del,NA19371,0,,3938
11,107783916,107788822,del,NA18973,0,,4906
11,31566492,31570645,del,HG00583,0,,4153
11,129238063,129238889,del,NA20516,0,,826
11,17289115,17296193,del,NA19077,0,,7078
11,51271085,51273932,del,HG00118,0,,2847
11,36942857,36949565,del,HG00266,0,,6708
11,59093248,59093903,del,HG00536,0,,655
11,126956478,126961213,del,HG00281,0,,4735
11,59621396,59621920,del,NA18523,0,,524
11,132034529,132037075,del,NA12489,0,,2546
11,81644174,81691957,del,HG00731,0,,47783
11,90742118,90743880,del,NA18941,0,,1762
11,76742716,76744922,del,HG01170,0,,2206
11,125075397,125085637,del,NA20535,0,,10240
11,3416398,3615504,del,NA19901,0,,199106
11,50526147,50533098,del,NA19334,0,,6951
11,102751148,102752809,del,NA18637,0,,1661
11,58799204,58839413,del,HG00353,0,,40209
11,89851101,89854075,del,NA19403,0,,2974
11,67212363,67216179,del,NA19332,0,,3816
11,109559279,109560129,del,HG00737,0,,850
11,92024692,92027977,del,HG00251,0,,3285
11,77725347,77730515,del,NA19236,0,,5168
11,69982552,69984487,del,NA20521,0,,1935
11,41632887,41635308,del,NA19471,0,,2421
11,130929993,130933024,del,HG00159,0,,3031
11,1055696,1055946,del,NA19703,0,,250
11,90962759,91047197,del,NA18605,0,,84438
11,98473656,98476468,del,NA18504,0,,2812
11,349987,942855,del,NA18983,0,,592868
11,128311493,128316095,del,NA19985,0,,4602
11,25557385,25558408,del,HG00478,0,,1023
11,65972716,65973225,del,NA18486,0,,509
11,81326182,81329288,del,NA18602,0,,3106
11,126160525,126162735,del,NA18542,0,,2210
11,129675649,129684579,del,HG00261,0,,8930
11,7004751,7006391,del,NA19676,0,,1640
11,88964482,88967930,del,NA19393,0,,3448
11,134003983,134007927,del,HG00701,0,,3944
11,63676516,63685322,del,HG00650,0,,8806
11,25702266,25720906,del,NA19093,0,,18640
11,103257432,103685743,del,HG00732,0,,428311
11,5784416,5809122,del,HG00731,0,,24706
11,95979169,95981539,del,NA20528,0,,2370
11,89370635,89381717,del,HG00626,0,,11082
11,102566697,102569473,del,HG00148,0,,2776
11,60572589,60574352,del,HG01187,0,,1763
11,49759296,49760857,del,HG01097,0,,1561
11,38764566,38783272,del,NA18487,0,,18706
11,9794635,9794962,del,NA19360,0,,327
11,13628286,13629400,del,NA20289,0,,1114
11,74024905,74027387,del,NA18638,0,,2482
11,5497981,5498501,del,NA19080,0,,520
11,48560036,48590962,del,HG00277,0,,30926
11,31860095,31860501,del,HG01462,0,,406
11,80711557,80712251,del,NA12044,0,,694
11,18606214,18621785,del,HG01125,0,,15571
11,14924089,14927138,del,NA19404,0,,3049
11,117419382,117420569,del,NA06984,0,,1187
11,108615728,108616881,del,HG00476,0,,1153
11,38085097,38086987,del,NA19648,0,,1890
11,71132964,71134500,del,NA19835,0,,1536
11,31393773,31397646,del,HG00542,0,,3873
11,7811108,7833201,del,NA19446,0,,22093
11,29360257,29360897,del,NA19374,0,,640
11,46161017,46162400,del,NA12777,0,,1383
11,112125251,112125365,del,NA20521,0,,114
11,81500504,81521338,del,HG00319,0,,20834
11,55870016,55889372,del,NA20515,0,,19356
11,62259967,62264835,del,NA19431,0,,4868
11,749209,753048,del,NA18637,0,,3839
11,65884147,65884578,del,NA19390,0,,431
11,54869897,54871609,del,HG01137,0,,1712
11,62182655,62183350,del,NA19311,0,,695
11,92771871,92773329,del,HG01522,0,,1458
11,12907726,12908927,del,NA19082,0,,1201
11,47875262,47877034,del,NA18522,0,,1772
11,26951467,26961183,del,NA19067,0,,9716
11,79342624,79348987,del,HG01350,0,,6363
11,6573063,6573511,del,HG00177,0,,448
11,123926581,123929563,del,NA20765,0,,2982
11,27832147,27835285,del,NA18608,0,,3138
11,49635804,49636081,del,NA19704,0,,277
11,21847271,21849378,del,NA20503,0,,2107
11,48954386,48956592,del,NA19901,0,,2206
11,62512325,62513135,del,HG00672,0,,810
11,60228164,60229386,del,HG01462,0,,1222
11,81856410,81863345,del,NA19712,0,,6935
11,40187326,40189425,del,HG00335,0,,2099
11,93683328,93688564,del,NA20509,0,,5236
11,91370583,91371644,del,NA19318,0,,1061
11,4968197,4976811,del,HG00259,0,,8614
11,99647272,99657172,del,NA18546,0,,9900
11,83810971,83812805,del,HG00280,0,,1834
11,66907387,66917257,del,HG00269,0,,9870
11,76672826,76677820,del,NA19982,0,,4994
11,62296030,62296231,del,HG00328,0,,201
11,99185458,99186698,del,NA19439,0,,1240
11,58557534,58563668,del,HG00126,0,,6134
11,25040699,25052745,del,NA19383,0,,12046
11,132558583,132558874,del,NA18623,0,,291
11,106878595,106878977,del,HG00315,0,,382
11,6316141,6316763,del,NA19469,0,,622
11,128907201,128908696,del,NA19107,0,,1495
11,25564472,25564813,del,NA12889,0,,341
11,119520095,119523117,del,HG01174,0,,3022
11,59398789,59399116,del,NA19436,0,,327
11,83464655,83467917,del,NA19723,0,,3262
11,57620606,57621369,del,NA19449,0,,763
11,50640451,50640964,del,NA20534,0,,513
11,124775029,124778298,del,HG00252,0,,3269
11,125433227,125437981,del,NA12775,0,,4754
11,42110739,42115244,del,NA18534,0,,4505
11,126321009,126321430,del,NA18542,0,,421
11,122788583,122789633,del,NA19462,0,,1050
11,100267541,100267850,del,HG01174,0,,309
11,114486183,114487824,del,NA19093,0,,1641
11,47009389,47012964,del,NA18983,0,,3575
11,50763720,50765597,del,HG01102,0,,1877
11,55434016,55457622,del,HG01498,0,,23606
11,67437539,67437719,del,HG00257,0,,180
11,51494293,51501281,del,HG00353,0,,6988
11,68799600,68799688,del,NA19099,0,,88
11,10225172,10231931,del,HG00236,0,,6759
11,38740615,38828839,del,HG00614,0,,88224
11,21340119,21341603,del,NA19462,0,,1484
11,1148605,1149368,del,NA18565,0,,763
11,111893271,111895649,del,NA19379,0,,2378
11,58220607,58220934,del,HG00251,0,,327
11,16652515,16652820,del,HG00512,0,,305
11,33426497,33427302,del,HG00501,0,,805
11,1058849,1060224,del,HG00640,0,,1375
11,122493117,122493847,del,NA19776,0,,730
11,119228978,119229124,del,HG00479,0,,146
11,64201265,64203265,del,HG01356,0,,2000
11,83143373,83143660,del,NA18523,0,,287
11,107236516,107244122,del,HG01356,0,,7606
11,66711680,66713356,del,NA18628,0,,1676
11,117044605,117046920,del,HG00428,0,,2315
11,86300137,86301679,del,HG00326,0,,1542
11,55434716,55443822,del,NA19719,0,,9106
11,99411407,99411753,del,HG00533,0,,346
11,72083362,72087829,del,NA19007,0,,4467
11,4323947,4375118,del,HG00560,0,,51171
11,40739587,40746460,del,NA18599,0,,6873
11,19181064,19183281,del,NA18912,0,,2217
11,65017466,65024994,del,NA19657,0,,7528
11,73761756,73762322,del,NA19909,0,,566
11,120407008,120409666,del,NA19311,0,,2658
11,78170214,78170569,del,NA19451,0,,355
11,3648916,3652172,del,NA18546,0,,3256
11,23745403,23745712,del,NA19190,0,,309
11,60571464,60572130,del,NA19780,0,,666
11,128820861,128821658,del,HG00284,0,,797
11,34014821,34018047,del,NA19900,0,,3226
11,65610239,65610512,del,HG00698,0,,273
11,30258371,30258488,del,NA19819,0,,117
11,55001504,55015140,del,NA18511,0,,13636
11,18473823,18475235,del,NA12340,0,,1412
11,1828257,1832771,del,NA19436,0,,4514
11,90192816,90195822,del,HG00671,0,,3006
11,102707991,102709431,del,HG00324,0,,1440
11,103373089,103377716,del,HG00512,0,,4627
11,70712842,70713300,del,HG00610,0,,458
11,56384264,56395346,del,NA20522,0,,11082
11,7442844,7444169,del,NA18961,0,,1325
11,74183342,74189283,del,NA18634,0,,5941
11,92415949,92418027,del,HG00146,0,,2078
11,55365716,55431322,del,NA19009,0,,65606
11,127456298,127456432,del,HG00268,0,,134
11,43909593,43909899,del,NA19087,0,,306
11,106595867,106596164,del,HG00740,0,,297
11,20770320,20770724,del,NA18858,0,,404
11,491642,491866,del,HG01383,0,,224
11,60867485,60867608,del,HG00693,0,,123
11,134362428,134365440,del,HG00323,0,,3012
11,10273148,10278017,del,HG00534,0,,4869
11,14451134,14464310,del,HG00701,0,,13176
11,65132119,65139331,del,HG00513,0,,7212
11,76924419,76924607,del,HG01489,0,,188
11,55284919,55300470,del,HG00361,0,,15551
11,3649075,3652232,del,HG00708,0,,3157
11,104923349,104931393,del,NA19374,0,,8044
11,39795370,39796865,del,HG00403,0,,1495
11,896134,896646,del,NA19108,0,,512
11,126184309,126187158,del,NA19235,0,,2849
11,123419242,123420843,del,HG00159,0,,1601
11,635825,635945,del,NA19395,0,,120
11,61807407,61809944,del,NA19472,0,,2537
11,45420169,45420262,del,NA11918,0,,93
11,27859506,27861336,del,NA20582,0,,1830
11,130599938,130601432,del,NA18908,0,,1494
11,20437052,20437132,del,NA12144,0,,80
11,603059,603861,del,HG00512,0,,802
11,80020956,80023381,del,HG00628,0,,2425
11,38300752,38301112,del,HG00249,0,,360
11,5890512,5893429,del,NA19007,0,,2917
11,49841410,49875967,del,HG00654,0,,34557
11,33425973,33427291,del,NA19435,0,,1318
11,16790538,16792119,del,NA18612,0,,1581
11,49043328,49045803,del,NA20800,0,,2475
11,39225952,39227618,del,NA19452,0,,1666
11,48928944,48929255,del,NA19058,0,,311
11,31921600,31927236,del,HG00324,0,,5636
11,96493121,96493286,del,NA18517,0,,165
11,102783498,102789623,del,HG01170,0,,6125
11,107782516,107788022,del,HG00608,0,,5506
11,76107693,76111423,del,NA19711,0,,3730
11,101416784,101417122,del,HG00403,0,,338
11,47949386,47950555,del,HG01061,0,,1169
11,26195190,26196581,del,NA19435,0,,1391
11,112987375,112989947,del,NA18517,0,,2572
11,134803690,134805254,del,NA18616,0,,1564
11,97172217,97172973,del,HG00404,0,,756
11,25377202,25377871,del,NA19916,0,,669
11,55031599,55038540,del,NA18538,0,,6941
11,6889280,6892478,del,HG00464,0,,3198
11,7809816,7833772,del,NA18917,0,,23956
11,5430950,5492407,del,NA19066,0,,61457
11,399516,402822,del,NA18636,0,,3306
11,64349445,64349802,del,HG01101,0,,357
11,126161484,126162354,del,NA19436,0,,870
11,82132213,82132582,del,NA19685,0,,369
11,82221827,82221933,del,HG01073,0,,106
11,56628812,56629564,del,NA19080,0,,752
11,67246168,67248347,del,HG00421,0,,2179
11,50526082,50533398,del,NA19321,0,,7316
11,72348053,72348196,del,NA19391,0,,143
11,19676985,19685463,del,HG00581,0,,8478
11,87877933,87879724,del,HG00419,0,,1791
11,59032826,59033226,del,HG01082,0,,400
11,63197938,63202776,del,NA19463,0,,4838
11,58809285,58809617,del,NA18570,0,,332
11,93020165,93029906,del,HG01177,0,,9741
11,71476921,71481770,del,HG01441,0,,4849
11,128042965,128043292,del,NA20802,0,,327
11,47526104,47527954,del,NA11843,0,,1850
11,40757745,40781150,del,HG00244,0,,23405
11,55309445,55309950,del,HG00243,0,,505
11,117295391,117295779,del,NA20527,0,,388
11,21827110,21829772,del,NA19660,0,,2662
11,104581202,104584835,del,NA19000,0,,3633
11,42979714,42980092,del,NA19093,0,,378
11,12192457,12206906,del,NA19701,0,,14449
11,54839553,54842257,del,HG01048,0,,2704
11,127749516,127751422,del,HG00140,0,,1906
11,20934202,20936687,del,HG00464,0,,2485
11,81449463,81764234,del,NA12763,0,,314771
11,39115470,39115795,del,NA20771,0,,325
11,44742629,44747211,del,NA19457,0,,4582
11,89543814,89544177,del,NA19759,0,,363
11,24443153,24452287,del,NA20536,0,,9134
11,3767480,3768124,del,NA19396,0,,644
11,84094438,84098239,del,NA11893,0,,3801
11,2557925,2558955,del,NA19210,0,,1030
11,83082358,83094108,del,HG00146,0,,11750
11,119719513,119719801,del,HG00273,0,,288
11,68546272,68546959,del,NA18599,0,,687
11,36708682,36713473,del,HG00114,0,,4791
11,18074267,18076137,del,NA18541,0,,1870
11,66304093,66305150,del,NA12761,0,,1057
11,67547534,67550719,del,NA20538,0,,3185
11,121372923,121380233,del,NA19077,0,,7310
11,8958026,8965119,del,NA18622,0,,7093
11,37706295,37709163,del,NA19072,0,,2868
11,42671245,42681050,del,NA19147,0,,9805
11,29139291,29140279,del,NA18620,0,,988
11,19094864,19095634,del,NA12286,0,,770
11,97818229,97878087,del,HG00595,0,,59858
11,101072459,101074370,del,NA19385,0,,1911
11,70931104,70931968,del,HG00366,0,,864
11,350509,943372,del,NA18873,0,,592863
11,7811173,7833378,del,NA19909,0,,22205
11,40334370,40338874,del,NA18916,0,,4504
11,31917261,31920609,del,NA19788,0,,3348
11,108339793,108341497,del,NA19379,0,,1704
11,50442018,50467165,del,NA19313,0,,25147
11,38026811,38029397,del,NA19719,0,,2586
11,99667251,99668988,del,NA19712,0,,1737
11,105292666,105298772,del,NA19819,0,,6106
11,24284962,24287788,del,NA18909,0,,2826
11,73420149,73426927,del,NA19083,0,,6778
11,1543358,1544132,del,NA18486,0,,774
11,84979403,84991943,del,NA19719,0,,12540
11,129635474,129639376,del,HG01080,0,,3902
11,116475410,116478292,del,NA20540,0,,2882
11,42110690,42115684,del,NA18534,0,,4994
11,65451471,65454603,del,NA19350,0,,3132
11,60851830,60853892,del,NA19058,0,,2062
11,119114009,119116284,del,HG00232,0,,2275
11,107238416,107245222,del,NA19375,0,,6806
11,81675266,81676672,del,NA18486,0,,1406
11,120073414,120074733,del,NA20322,0,,1319
11,66527647,66527976,del,NA18637,0,,329
11,805905,806965,del,HG00536,0,,1060
11,123908008,123921459,del,NA19377,0,,13451
11,51262045,51266299,del,NA19703,0,,4254
11,9938400,9939729,del,NA18502,0,,1329
11,67642224,67644843,del,NA19682,0,,2619
11,94095363,94106967,del,NA19835,0,,11604
11,103916612,103918250,del,HG00251,0,,1638
11,55761173,55782506,del,NA18984,0,,21333
11,63778283,63778557,del,NA19385,0,,274
11,112295398,112297238,del,NA19678,0,,1840
11,114475605,114477108,del,NA19819,0,,1503
11,86531810,86534981,del,HG00126,0,,3171
11,54956860,54972888,del,HG00273,0,,16028
11,34913427,34921155,del,NA11992,0,,7728
11,39657301,39660999,del,HG00443,0,,3698
11,110699435,110703870,del,NA19064,0,,4435
11,48985528,49908673,del,HG01350,0,,923145
11,120387640,120388366,del,NA19917,0,,726
11,25750491,25753635,del,NA19755,0,,3144
11,69400840,69401402,del,NA18516,0,,562
11,45356489,45357219,del,NA20317,0,,730
11,71912280,71912610,del,NA19701,0,,330
11,133869979,133870659,del,HG00339,0,,680
11,48953101,48962498,del,NA19403,0,,9397
11,111215148,111220540,del,NA18560,0,,5392
11,95931827,95940141,del,NA19657,0,,8314
11,23434105,23436650,del,HG01174,0,,2545
11,118418698,118419315,del,NA19444,0,,617
11,130920058,130922079,del,NA19385,0,,2021
11,128682716,128683410,del,HG00319,0,,694
11,68907246,68909000,del,HG00437,0,,1754
11,16223159,16223478,del,NA19758,0,,319
11,133319461,133322898,del,NA19398,0,,3437
11,101444614,101445452,del,NA19449,0,,838
11,26322472,26322715,del,NA19456,0,,243
11,10260047,10261313,del,NA18574,0,,1266
11,19492182,19495296,del,NA18502,0,,3114
11,42298023,42299991,del,NA18622,0,,1968
11,55434516,55453422,del,NA19077,0,,18906
11,123804697,123804868,del,NA18542,0,,171
11,107236016,107243922,del,HG00329,0,,7906
11,55365716,55458222,del,NA20754,0,,92506
11,54951619,54983097,del,NA20826,0,,31478
11,49709802,49757715,del,NA12717,0,,47913
11,74249042,74258316,del,HG01137,0,,9274
11,103949528,103949636,del,NA20790,0,,108
11,49026892,49053275,del,HG00608,0,,26383
11,58587131,58587988,del,HG00185,0,,857
11,131499997,131500529,del,NA19065,0,,532
11,654226,655159,del,NA18907,0,,933
11,107733057,107733253,del,HG01365,0,,196
11,47630942,47632189,del,NA18924,0,,1247
11,55069738,55072723,del,HG01083,0,,2985
11,79390431,79395819,del,NA18853,0,,5388
11,1915293,1936946,del,NA19463,0,,21653
11,58458020,58461924,del,NA19256,0,,3904
11,102749300,102753328,del,HG00442,0,,4028
11,33870097,33872867,del,HG00634,0,,2770
11,96972832,97048760,del,NA18912,0,,75928
11,80983352,81017823,del,NA19395,0,,34471
11,61649193,61653197,del,NA19471,0,,4004
11,127275014,127279989,del,NA18522,0,,4975
11,41709970,41717662,del,NA19316,0,,7692
11,49702438,49709919,del,NA18627,0,,7481
11,5784573,5809282,del,NA11993,0,,24709
11,6430872,6431067,del,NA18498,0,,195
11,116681716,116685090,del,NA18908,0,,3374
11,65723565,65727919,del,HG00537,0,,4354
11,30171983,30176875,del,NA19455,0,,4892
11,19891962,19900927,del,NA19474,0,,8965
11,100676468,100677694,del,NA18965,0,,1226
11,62135089,62153309,del,NA18628,0,,18220
11,935793,940156,del,HG01250,0,,4363
11,57851062,57857444,del,NA19904,0,,6382
11,92321802,92322160,del,NA18941,0,,358
11,1893130,1893412,del,NA20281,0,,282
11,25609508,25609755,del,NA18549,0,,247
11,60571430,60571921,del,NA19398,0,,491
11,65203959,65211052,del,HG00231,0,,7093
11,91493606,91497567,del,NA19070,0,,3961
11,57711211,57711329,del,HG00650,0,,118
11,107782416,107786972,del,NA20317,0,,4556
11,122861605,122864228,del,NA19332,0,,2623
11,16996169,16996593,del,HG00324,0,,424
11,64085529,64087525,del,NA18907,0,,1996
11,82837568,82846128,del,HG00319,0,,8560
11,106583241,106583381,del,HG00707,0,,140
11,47939375,47942764,del,NA18603,0,,3389
11,54894916,54899753,del,HG00243,0,,4837
11,1914317,1914472,del,HG00583,0,,155
11,131201906,131205126,del,NA18868,0,,3220
11,86007569,86012109,del,NA18948,0,,4540
11,93021139,93022160,del,NA19785,0,,1021
11,123678968,123681799,del,NA18907,0,,2831
11,80242902,80243028,del,HG00309,0,,126
11,114822449,114825644,del,NA19068,0,,3195
11,7258982,7259837,del,NA20760,0,,855
11,9637189,9639031,del,NA18544,0,,1842
11,102267772,102268985,del,HG00672,0,,1213
11,8444540,8446605,del,HG00734,0,,2065
11,85263027,85274775,del,HG00282,0,,11748
11,31967172,31969301,del,NA18487,0,,2129
11,81206242,81209614,del,NA19235,0,,3372
11,128830983,128834792,del,NA12282,0,,3809
11,100438650,100438795,del,NA18537,0,,145
11,107235716,107243922,del,NA19076,0,,8206
11,3125036,3125123,del,HG00671,0,,87
11,34510766,34513097,del,NA19921,0,,2331
11,51279409,51288814,del,NA19078,0,,9405
11,67474656,67754574,del,NA07051,0,,279918
11,126956146,126961282,del,HG00281,0,,5136
11,24285250,24288236,del,NA19359,0,,2986
11,13983602,14048685,del,HG00702,0,,65083
11,10292728,10293834,del,HG00239,0,,1106
11,20253289,20254373,del,NA19377,0,,1084
11,4508988,4562397,del,NA18566,0,,53409
11,3065884,3066753,del,HG00187,0,,869
11,54951486,54982964,del,NA18538,0,,31478
11,86285961,86286722,del,NA18499,0,,761
11,359835,360058,del,HG00258,0,,223
11,37125832,37136041,del,NA18564,0,,10209
11,625216,627822,del,NA18530,0,,2606
11,9439512,9439868,del,HG00346,0,,356
11,61768988,61770112,del,HG01188,0,,1124
11,49918694,49918894,del,NA19397,0,,200
11,71303815,71603833,del,NA19390,0,,300018
11,55446016,55459322,del,HG00331,0,,13306
11,63040007,63041106,del,NA19819,0,,1099
11,125107824,125107955,del,HG00258,0,,131
11,11875598,11876558,del,HG00732,0,,960
11,55001534,55019406,del,NA19712,0,,17872
11,65067412,65068163,del,HG00557,0,,751
11,50603927,50615106,del,NA18627,0,,11179
11,71974804,71975569,del,HG00131,0,,765
11,119259473,119259874,del,NA19396,0,,401
11,73790695,73792168,del,NA19093,0,,1473
11,25557440,25558592,del,HG00650,0,,1152
11,132083612,132083926,del,NA19332,0,,314
11,78388616,78394622,del,HG01351,0,,6006
11,130225196,130230286,del,NA19434,0,,5090
11,69492162,69496726,del,NA19114,0,,4564
11,48249254,48255043,del,HG01377,0,,5789
11,65903664,65904721,del,NA18870,0,,1057
11,18161064,18197122,del,HG01170,0,,36058
11,22249802,22254776,del,NA19920,0,,4974
11,37962045,37962370,del,NA11918,0,,325
11,57502487,57504094,del,HG00125,0,,1607
11,23575834,23584041,del,NA18542,0,,8207
11,92246216,92246122,del,HG00708,0,,-94
11,134630143,134630264,del,HG00442,0,,121
11,116735830,116737149,del,NA20760,0,,1319
11,50640255,50641111,del,NA18555,0,,856
11,21423019,21425481,del,NA19461,0,,2462
11,66842825,66844915,del,HG00330,0,,2090
11,39409659,39409883,del,NA18543,0,,224
11,92967999,92972694,del,NA18621,0,,4695
11,51562126,51566388,del,HG01107,0,,4262
11,45844265,45845402,del,HG01167,0,,1137
11,37666634,37666942,del,HG00705,0,,308
11,74517739,74518110,del,NA18871,0,,371
11,55364426,55444006,del,HG00359,0,,79580
11,47841136,47843472,del,NA18949,0,,2336
11,126437597,126438122,del,HG00117,0,,525
11,864834,1510867,del,NA20805,0,,646033
11,21842433,21843041,del,NA19453,0,,608
11,114479119,114480001,del,HG01137,0,,882
11,38847693,38849511,del,NA19394,0,,1818
11,79623173,79624600,del,NA19403,0,,1427
11,3648904,3651613,del,NA19076,0,,2709
11,29007202,29012888,del,NA19762,0,,5686
11,63785981,63786771,del,NA18555,0,,790
11,48942406,48943603,del,HG00537,0,,1197
11,117327561,117329306,del,HG01441,0,,1745
11,39725421,39728551,del,NA20753,0,,3130
11,60097422,60097940,del,HG00707,0,,518
11,63287144,63288356,del,NA19383,0,,1212
11,105757920,105810410,del,HG00256,0,,52490
11,90822871,90908329,del,HG00251,0,,85458
11,66930088,66933868,del,HG01437,0,,3780
11,55248983,55253763,del,NA18627,0,,4780
11,94883658,94884132,del,NA19347,0,,474
11,106786238,106789572,del,NA20808,0,,3334
11,116044667,116048149,del,HG00260,0,,3482
11,72914096,72915035,del,NA19835,0,,939
11,31617369,31620113,del,NA19009,0,,2744
11,97377203,97436624,del,HG00608,0,,59421
11,8871273,8871550,del,HG01522,0,,277
11,121877985,121880828,del,NA19065,0,,2843
11,91161920,91162517,del,NA12751,0,,597
11,118902190,118904191,del,NA20792,0,,2001
11,128084279,128086655,del,NA19346,0,,2376
11,4668549,4669159,del,NA19707,0,,610
11,127749541,127751584,del,HG00262,0,,2043
11,57754444,57762107,del,NA19391,0,,7663
11,58253694,58254026,del,NA19311,0,,332
11,12401725,12402349,del,NA20344,0,,624
11,60837256,60845028,del,NA18572,0,,7772
11,20195702,20195842,del,HG00330,0,,140
11,1654205,1656528,del,NA12400,0,,2323
11,127276866,127279822,del,NA19467,0,,2956
11,1078820,1079535,del,HG00158,0,,715
11,66658083,66658976,del,NA19379,0,,893
11,5637317,5638940,del,NA19059,0,,1623
11,83143316,83143522,del,HG01375,0,,206
11,21187109,21215852,del,NA19397,0,,28743
11,134444860,134448606,del,HG00592,0,,3746
11,9619036,9620809,del,NA18983,0,,1773
11,9023269,9023427,del,NA18508,0,,158
11,105293469,105298905,del,NA19467,0,,5436
11,75256614,75261207,del,NA19762,0,,4593
11,20604651,20606386,del,HG01183,0,,1735
11,61607700,61608072,del,NA19678,0,,372
11,96001924,96003394,del,HG00593,0,,1470
11,89495739,89507199,del,NA18549,0,,11460
11,103447869,103447993,del,NA19360,0,,124
11,25773216,25773022,del,HG00443,0,,-194
11,134178072,134178192,del,HG01389,0,,120
11,71062757,71067426,del,NA19390,0,,4669
11,101289993,101290317,del,HG00256,0,,324
11,28254707,28256395,del,NA19060,0,,1688
11,108079923,108088019,del,HG00583,0,,8096
11,133157858,133161322,del,NA19834,0,,3464
11,42272885,42275761,del,NA19399,0,,2876
11,36180043,36182301,del,NA11933,0,,2258
11,95107577,95109871,del,NA19436,0,,2294
11,125391397,125394338,del,HG00705,0,,2941
11,49006357,49011348,del,HG00173,0,,4991
11,64190341,64192932,del,NA07346,0,,2591
11,95832122,95833069,del,NA19471,0,,947
11,101376975,101383689,del,NA19247,0,,6714
11,96001958,96003633,del,NA19717,0,,1675
11,89961164,90014135,del,HG00146,0,,52971
11,31703141,31759321,del,HG00131,0,,56180
11,65573288,65580378,del,NA19835,0,,7090
11,118733249,118733419,del,NA19360,0,,170
11,130496397,130496642,del,NA19818,0,,245
11,107236016,107244822,del,HG00650,0,,8806
11,21158936,21160321,del,NA19473,0,,1385
11,12695416,12697522,del,HG00312,0,,2106
11,5270039,5274919,del,HG00457,0,,4880
11,60808854,60813995,del,HG00463,0,,5141
11,134760065,134774548,del,NA20807,0,,14483
11,103851738,103856457,del,NA18487,0,,4719
11,63622165,63622671,del,NA18956,0,,506
11,125719438,125719592,del,NA19403,0,,154
11,25082552,25085726,del,HG00239,0,,3174
11,11023877,11024123,del,HG01390,0,,246
11,134601978,134607661,del,HG00249,0,,5683
11,115886598,115890755,del,NA19443,0,,4157
11,120658975,120665230,del,NA18511,0,,6255
11,78504552,78508486,del,HG00708,0,,3934
11,11379618,11381027,del,NA12348,0,,1409
11,62218417,62218949,del,HG01082,0,,532
11,883923,889918,del,HG00242,0,,5995
11,5637566,5639522,del,HG00619,0,,1956
11,42673192,42679098,del,NA19398,0,,5906
11,71850376,71888702,del,NA20524,0,,38326
11,49077645,49104123,del,NA19457,0,,26478
11,75195458,75203656,del,NA18999,0,,8198
11,77230225,77232879,del,NA20786,0,,2654
11,71872235,71872967,del,NA19920,0,,732
11,18443474,18444675,del,NA06994,0,,1201
11,120194463,120194724,del,NA19099,0,,261
11,65306116,65307922,del,HG00313,0,,1806
11,94082700,94378590,del,HG00578,0,,295890
11,70301041,70301308,del,NA19372,0,,267
11,56707539,56712239,del,HG00537,0,,4700
11,107336046,107348197,del,NA19700,0,,12151
11,83464416,83467722,del,NA19818,0,,3306
11,49442332,49442643,del,NA18856,0,,311
11,68401542,68406811,del,NA19004,0,,5269
11,24895182,24895609,del,NA20524,0,,427
11,90756321,90829248,del,NA18986,0,,72927
11,115659660,115660839,del,NA18916,0,,1179
11,54894954,54899744,del,NA18632,0,,4790
11,117804237,117810158,del,HG00108,0,,5921
11,9435128,9435491,del,NA18858,0,,363
11,107234416,107243972,del,NA19198,0,,9556
11,27271326,27273785,del,HG00530,0,,2459
11,105723492,105723823,del,HG01102,0,,331
11,11822987,11824623,del,NA19248,0,,1636
11,132992200,133004453,del,HG01441,0,,12253
11,69660882,69661101,del,HG00737,0,,219
11,16534953,16535490,del,NA11918,0,,537
11,131939102,131939772,del,HG00641,0,,670
11,86305216,86306522,del,NA19732,0,,1306
11,75253042,75253162,del,HG01124,0,,120
11,48685509,48686208,del,HG00583,0,,699
11,47620027,47623407,del,NA19235,0,,3380
11,85888923,85899331,del,HG00315,0,,10408
11,57642641,57650770,del,HG00253,0,,8129
11,48883475,48889305,del,NA12827,0,,5830
11,115483947,115487947,del,NA20525,0,,4000
11,46142416,46144622,del,HG00611,0,,2206
11,65137288,65137906,del,NA12383,0,,618
11,117180910,117182930,del,HG00689,0,,2020
11,27560930,27573303,del,HG00614,0,,12373
11,76566950,76568066,del,HG01183,0,,1116
11,95038133,95038234,del,NA18623,0,,101
11,3903597,3906552,del,HG00525,0,,2955
11,44729806,44733523,del,HG00427,0,,3717
11,126265854,126267438,del,NA19471,0,,1584
11,43771641,43782650,del,NA19661,0,,11009
11,41729750,41729939,del,HG01113,0,,189
11,86347532,86350863,del,NA19439,0,,3331
11,15617421,15619331,del,HG00536,0,,1910
11,56407940,56408257,del,NA18505,0,,317
11,47365494,47366455,del,NA19681,0,,961
11,67802381,67803213,del,HG00436,0,,832
11,134732898,134734112,del,NA10851,0,,1214
11,110371864,110373240,del,HG00276,0,,1376
11,41818196,41819022,del,HG00559,0,,826
11,82600046,82600164,del,NA18505,0,,118
11,47887667,47888194,del,HG00158,0,,527
11,130257440,130257796,del,HG00239,0,,356
11,62245016,62249626,del,NA07048,0,,4610
11,61759316,61759877,del,NA19700,0,,561
11,107236016,107245222,del,HG01101,0,,9206
11,28464842,28469598,del,NA19371,0,,4756
11,5720454,5720797,del,HG00116,0,,343
11,130978581,130984887,del,NA19063,0,,6306
11,4801131,4910580,del,NA20807,0,,109449
11,90582288,90583533,del,NA19385,0,,1245
11,92024016,92027022,del,HG00251,0,,3006
11,25831432,25901753,del,NA19439,0,,70321
11,19919445,19924049,del,HG00702,0,,4604
11,77403266,77403588,del,NA18572,0,,322
11,32389255,32390658,del,NA18522,0,,1403
11,58257133,58257837,del,NA20800,0,,704
11,23749839,23754799,del,NA19704,0,,4960
11,55001527,55014821,del,HG01495,0,,13294
11,81330313,81333865,del,NA18602,0,,3552
11,62050374,62050519,del,NA12749,0,,145
11,5760066,5763772,del,NA20502,0,,3706
11,1654716,1656022,del,NA19473,0,,1306
11,84537700,84570874,del,HG01168,0,,33174
11,107125566,107127972,del,NA19438,0,,2406
11,49709806,49755098,del,HG01060,0,,45292
11,102751104,102752802,del,NA18577,0,,1698
11,126959242,126966923,del,NA19379,0,,7681
11,118653382,118654015,del,NA20804,0,,633
11,5873984,5883493,del,NA19315,0,,9509
11,2158116,2161722,del,NA19835,0,,3606
11,19833794,19834395,del,HG00185,0,,601
11,116668365,116673688,del,NA19462,0,,5323
11,42156149,42156478,del,NA18537,0,,329
11,50779564,50783300,del,NA18614,0,,3736
11,40036400,40041858,del,NA18573,0,,5458
11,134731116,134734022,del,HG00629,0,,2906
11,38797750,38808613,del,NA19474,0,,10863
11,55363166,55363840,del,NA19701,0,,674
11,70074479,70083709,del,NA20512,0,,9230
11,90133516,90139422,del,HG01083,0,,5906
11,4994260,4998395,del,NA19318,0,,4135
11,120000339,120002431,del,HG00581,0,,2092
11,63454975,63460126,del,NA19381,0,,5151
11,108802517,108804124,del,NA19238,0,,1607
11,55391317,55395063,del,NA18609,0,,3746
11,68962277,68962479,del,HG00272,0,,202
11,58594188,58596019,del,NA19443,0,,1831
11,34921812,34922964,del,NA18873,0,,1152
11,1962886,1963065,del,NA18596,0,,179
11,116681216,116685041,del,HG01052,0,,3825
11,50767103,50771966,del,NA19382,0,,4863
11,6881365,6882044,del,NA18541,0,,679
11,3488379,3492291,del,HG00272,0,,3912
11,81330610,81333890,del,NA18602,0,,3280
11,84723183,84723395,del,NA19160,0,,212
11,86697357,86706833,del,NA19777,0,,9476
11,740291,744579,del,NA19470,0,,4288
11,78890557,78892058,del,NA20543,0,,1501
11,740365,744683,del,NA19116,0,,4318
11,57215068,57216851,del,NA19338,0,,1783
11,58916861,58917160,del,NA18550,0,,299
11,220727,220878,del,NA18558,0,,151
11,50589491,50596487,del,HG01108,0,,6996
11,91227296,91232097,del,NA19788,0,,4801
11,93901478,93910271,del,NA19434,0,,8793
11,71215059,71248543,del,HG00638,0,,33484
11,127855724,127881655,del,NA19390,0,,25931
11,125296515,125296512,del,HG00327,0,,-3
11,631464,632307,del,NA19463,0,,843
11,111160437,111162620,del,NA18623,0,,2183
11,134151610,134214625,del,NA19713,0,,63015
11,61441406,61441498,del,NA18613,0,,92
11,45777022,45777890,del,NA19438,0,,868
11,105357026,105357240,del,NA07037,0,,214
11,79972709,79983297,del,NA19648,0,,10588
11,121351773,121352469,del,HG01048,0,,696
11,85502658,85504268,del,NA19448,0,,1610
11,11027884,11030664,del,NA18552,0,,2780
11,48130777,48133854,del,NA18910,0,,3077
11,90193706,90195997,del,HG01108,0,,2291
11,23860742,23860886,del,NA20508,0,,144
11,70976337,70976468,del,HG01492,0,,131
11,118549154,118562068,del,HG00126,0,,12914
11,120834949,120837329,del,NA19675,0,,2380
11,34261135,34262483,del,NA19440,0,,1348
11,98347250,98349151,del,HG00334,0,,1901
11,98766253,98807666,del,NA12891,0,,41413
11,25245625,25255968,del,NA20810,0,,10343
11,42077725,42077913,del,NA18573,0,,188
11,22980441,22981232,del,NA19347,0,,791
11,62261160,62262433,del,NA19107,0,,1273
11,54957008,54972864,del,HG00315,0,,15856
11,36647457,36654821,del,NA18923,0,,7364
11,59942312,59942686,del,HG01125,0,,374
11,81924526,82049104,del,NA20771,0,,124578
11,132079398,132081445,del,NA12717,0,,2047
11,63439963,63444716,del,NA19065,0,,4753
11,62836465,62844291,del,NA19347,0,,7826
11,50475460,50480112,del,NA18964,0,,4652
11,57224216,57229122,del,HG00443,0,,4906
11,123078523,123079082,del,HG01377,0,,559
11,129455358,129455587,del,HG00344,0,,229
11,46970094,46970668,del,HG00313,0,,574
11,85307637,85309210,del,HG01342,0,,1573
11,81187943,81189483,del,NA19107,0,,1540
11,22470878,22472765,del,HG00366,0,,1887
11,3648922,3650721,del,NA19189,0,,1799
11,71875412,71876385,del,NA18546,0,,973
11,118059966,118061844,del,NA19909,0,,1878
11,68985853,69000468,del,NA18557,0,,14615
11,75357959,75359505,del,NA19213,0,,1546
11,15529797,15536538,del,HG00436,0,,6741
11,7134706,7136485,del,HG01148,0,,1779
11,116736007,116737205,del,HG00254,0,,1198
11,9503742,9509130,del,NA19920,0,,5388
11,69454316,69458322,del,NA19189,0,,4006
11,111640013,111642390,del,HG01461,0,,2377
11,62133732,62152387,del,HG00111,0,,18655
11,118488097,118491606,del,HG00556,0,,3509
11,71912265,71912733,del,HG00475,0,,468
11,113805809,113806182,del,NA18558,0,,373
11,50467896,50470311,del,NA19916,0,,2415
11,50494682,50532360,del,NA18633,0,,37678
11,134679610,134684539,del,NA19334,0,,4929
11,91788450,91788991,del,NA19394,0,,541
11,58458020,58461930,del,NA18912,0,,3910
11,90407838,90415647,del,NA18539,0,,7809
11,89526733,89529171,del,NA19070,0,,2438
11,63188467,63204924,del,HG01124,0,,16457
11,63568469,63569164,del,NA18510,0,,695
11,77283451,77286953,del,HG00327,0,,3502
11,98264806,98268987,del,HG00342,0,,4181
11,131719695,131724561,del,NA18562,0,,4866
11,24459965,24460758,del,NA19453,0,,793
11,48886834,48887699,del,NA19652,0,,865
11,59112471,59119102,del,NA19147,0,,6631
11,108664164,108668073,del,NA18626,0,,3909
11,76403738,76403933,del,NA19376,0,,195
11,106619475,106622269,del,NA11994,0,,2794
11,98652039,98659073,del,HG00449,0,,7034
11,7209295,7209612,del,HG00478,0,,317
11,10367990,10370850,del,NA20768,0,,2860
11,48942035,48943913,del,NA18545,0,,1878
11,64373716,64377022,del,HG00284,0,,3306
11,49834448,49837785,del,NA19777,0,,3337
11,95979361,95981501,del,HG00327,0,,2140
11,122277481,122281499,del,HG00118,0,,4018
11,98266714,98269846,del,NA19678,0,,3132
11,5521630,5523171,del,NA12044,0,,1541
11,55434493,55457655,del,HG00160,0,,23162
11,6600865,6601075,del,NA20348,0,,210
11,7790334,7792009,del,HG00189,0,,1675
11,97576915,97577256,del,HG00336,0,,341
11,90568073,90571073,del,NA19444,0,,3000
11,81675813,81676936,del,NA19129,0,,1123
11,67153434,67155524,del,NA19982,0,,2090
11,124078839,124079324,del,NA19471,0,,485
11,47761837,47763238,del,NA20276,0,,1401
11,468997,469493,del,NA19082,0,,496
11,39821067,39826459,del,NA19712,0,,5392
11,85263155,85274454,del,HG00237,0,,11299
11,7905989,7906566,del,NA18579,0,,577
11,96861120,96861850,del,HG00108,0,,730
11,55445866,55456751,del,HG00359,0,,10885
11,112617743,112618148,del,NA20755,0,,405
11,81752395,81754665,del,NA18572,0,,2270
11,50358678,50360182,del,NA18542,0,,1504
11,65642107,65643519,del,HG00259,0,,1412
11,78388616,78392522,del,HG00607,0,,3906
11,11301406,11305588,del,NA18501,0,,4182
11,73541941,73544403,del,NA18511,0,,2462
11,58166981,58168149,del,NA11843,0,,1168
11,120228531,120230203,del,NA19916,0,,1672
11,71337196,71610552,del,NA12718,0,,273356
11,109396625,109400914,del,NA18871,0,,4289
11,130223243,130230349,del,NA19114,0,,7106
11,19541349,19542173,del,HG01060,0,,824
11,21644284,21645481,del,HG00626,0,,1197
11,103915966,103918822,del,HG01389,0,,2856
11,119952617,119954718,del,NA12340,0,,2101
11,55433916,55459622,del,NA18571,0,,25706
11,51288424,51290659,del,NA19707,0,,2235
11,55365916,55464422,del,NA12275,0,,98506
11,68696198,68696374,del,NA19372,0,,176
11,70806891,70807051,del,HG00111,0,,160
11,50612612,50615487,del,NA19399,0,,2875
11,24902969,24904276,del,NA19350,0,,1307
11,116044430,116048064,del,HG00260,0,,3634
11,80306160,80313125,del,NA18602,0,,6965
11,45132763,45132956,del,NA12890,0,,193
11,39716726,39718931,del,NA18985,0,,2205
11,117327618,117329344,del,HG01441,0,,1726
11,59929145,59929390,del,NA19390,0,,245
11,55783928,55787300,del,NA19462,0,,3372
11,49497818,49504514,del,NA19445,0,,6696
11,73138013,73138396,del,NA19469,0,,383
11,98248208,98248611,del,NA19130,0,,403
11,132959669,132960622,del,NA19726,0,,953
11,131596224,131597168,del,NA18856,0,,944
11,88235644,88236794,del,NA20805,0,,1150
11,4802521,4802832,del,HG00245,0,,311
11,1971844,1971962,del,NA18561,0,,118
11,23450446,23463039,del,NA18487,0,,12593
11,921437,924870,del,HG00264,0,,3433
11,67874459,67881200,del,NA19338,0,,6741
11,27789523,27789816,del,NA18537,0,,293
11,38457183,38463940,del,NA19396,0,,6757
11,48834073,48857778,del,NA20795,0,,23705
11,33797441,33801843,del,HG00657,0,,4402
11,9637404,9639009,del,NA18544,0,,1605
11,17134354,17135510,del,NA19316,0,,1156
11,94940304,94943143,del,HG01067,0,,2839
11,40716916,40718572,del,HG00698,0,,1656
11,363139,363234,del,HG00249,0,,95
11,102303584,102307485,del,HG00321,0,,3901
11,33280523,33285848,del,NA19063,0,,5325
11,3944722,3945548,del,NA19429,0,,826
11,87918544,87918861,del,NA18502,0,,317
11,41096564,41096686,del,NA18488,0,,122
11,44643165,44644661,del,NA18576,0,,1496
11,1461916,1466122,del,HG01061,0,,4206
11,127622607,127655955,del,NA18576,0,,33348
11,67330062,67332451,del,NA11995,0,,2389
11,134886668,134892665,del,HG00654,0,,5997
11,112125279,112125623,del,NA18612,0,,344
11,83143380,83143660,del,NA18618,0,,280
11,42674165,42679438,del,NA18504,0,,5273
11,109976699,109977025,del,NA19119,0,,326
11,90193916,90194972,del,NA18632,0,,1056
11,121351316,121352660,del,NA20348,0,,1344
11,48327471,48328174,del,HG00151,0,,703
11,94073872,94074708,del,NA19311,0,,836
11,90905039,90913118,del,NA12249,0,,8079
11,1078751,1079374,del,NA19777,0,,623
11,3238738,3244086,del,HG00638,0,,5348
11,3651801,3652244,del,NA19707,0,,443
11,25606578,25629108,del,NA19456,0,,22530
11,4520055,4522491,del,HG00556,0,,2436
11,101959887,101968719,del,HG00534,0,,8832
11,65933898,65939330,del,NA19834,0,,5432
11,77254343,77256055,del,NA19379,0,,1712
11,124532167,124539137,del,NA19467,0,,6970
11,100784434,100787830,del,HG00260,0,,3396
11,18401245,18407009,del,NA19213,0,,5764
11,29884171,29885984,del,NA19401,0,,1813
11,22298211,22299509,del,NA18868,0,,1298
11,37874298,37875143,del,NA20797,0,,845
11,101565787,101575258,del,NA19223,0,,9471
11,13928477,13929244,del,NA18982,0,,767
11,69815793,69822354,del,HG01124,0,,6561
11,34220761,34226041,del,NA18947,0,,5280
11,99667289,99669041,del,NA19712,0,,1752
11,67506872,67735783,del,HG00258,0,,228911
11,116880908,116881405,del,NA18624,0,,497
11,49116301,49119638,del,NA19725,0,,3337
11,106396535,106405155,del,HG01061,0,,8620
11,41830835,41832750,del,NA19002,0,,1915
11,60868557,60868877,del,NA19443,0,,320
11,223822,223967,del,HG01047,0,,145
11,71044107,71045778,del,HG00335,0,,1671
11,107784116,107788410,del,NA20754,0,,4294
11,85617809,85618045,del,NA19675,0,,236
11,1752179,1752452,del,NA19652,0,,273
11,8958084,8965159,del,NA18622,0,,7075
11,99519038,99569553,del,NA12045,0,,50515
11,37593131,37593773,del,NA19819,0,,642
11,5637043,5638940,del,NA18621,0,,1897
11,83141875,83147402,del,HG00671,0,,5527
11,54884795,54892205,del,HG01516,0,,7410
11,16587162,16587299,del,NA19732,0,,137
11,27831094,27831932,del,NA19725,0,,838
11,69902069,69903197,del,HG00638,0,,1128
11,81556171,81556538,del,HG01137,0,,367
11,60445398,60445815,del,NA19661,0,,417
11,47401560,47403153,del,NA20289,0,,1593
11,117274820,117283344,del,HG01198,0,,8524
11,54885415,54892294,del,HG01366,0,,6879
11,43479397,43485307,del,NA19471,0,,5910
11,86332363,86334018,del,NA19355,0,,1655
11,20569190,20571247,del,HG00702,0,,2057
11,34249375,34249700,del,HG00684,0,,325
11,38179743,38189101,del,NA19444,0,,9358
11,39292621,39292755,del,HG01070,0,,134
11,92934841,92938741,del,HG01095,0,,3900
11,12907735,12908918,del,NA19082,0,,1183
11,36506537,36508676,del,NA19711,0,,2139
11,126636240,126636906,del,HG00737,0,,666
11,41632618,41635526,del,NA19449,0,,2908
11,194412,252166,dup,HG01440,0,,57754
11,195766,233956,dup,HG01440,0,,38190
11,239862,274286,dup,HG01794,0,,34424
11,732330,768730,dup,HG03363,0,,36400
11,756680,767369,dup,NA18544,0,,10689
11,851409,1030159,dup,HG03830,0,,178750
11,857076,1043855,dup,HG00251,0,,186779
11,860117,882352,dup,HG00629,0,,22235
11,876861,979340,dup,HG00251,0,,102479
11,966063,1001637,dup,HG00266,0,,35574
11,1002638,1016158,dup,HG00596,0,,13520
11,1033571,1042342,dup,HG00251,0,,8771
11,1041593,1081878,dup,HG03830,0,,40285
11,1151445,1156913,dup,HG00097,0,,5468
11,1217361,1221360,dup,HG00097,0,,3999
11,1233797,1244668,dup,HG03722,0,,10871
11,1243869,1256729,dup,HG00128,0,,12860
11,1272083,1299557,dup,HG03722,0,,27474
11,1443073,1461583,dup,HG00355,0,,18510
11,1669482,1683375,dup,NA18630,0,,13893
11,1923073,1938356,dup,HG02804,0,,15283
11,2324446,2349678,dup,HG01142,0,,25232
11,3004585,3040808,dup,HG00154,0,,36223
11,3238750,3361018,dup,HG00097,0,,122268
11,3418459,3615090,dup,HG01241,0,,196631
11,3628855,3753273,dup,NA19309,0,,124418
11,3630844,3701704,dup,NA20509,0,,70860
11,3949196,3972751,dup,HG02805,0,,23555
11,4175301,4215588,dup,NA19144,0,,40287
11,4255506,4278147,dup,HG00097,0,,22641
11,4330577,4350830,dup,HG00288,0,,20253
11,4387484,4537823,dup,HG03126,0,,150339
11,4387984,4471473,dup,HG03126,0,,83489
11,4389866,4451139,dup,HG03126,0,,61273
11,4519222,4591853,dup,HG03132,0,,72631
11,4807560,4911702,dup,NA20521,0,,104142
11,4968456,4975835,dup,HG00096,0,,7379
11,5145500,5161964,dup,HG04146,0,,16464
11,5216398,5245731,dup,HG00581,0,,29333
11,5247799,5270839,dup,HG00581,0,,23040
11,5271453,5275145,dup,HG00442,0,,3692
11,5429313,5493288,dup,NA18966,0,,63975
11,5484584,5496363,dup,HG01851,0,,11779
11,5485253,5593047,dup,HG01851,0,,107794
11,5597908,5624329,dup,HG01851,0,,26421
11,5626310,5699500,dup,HG01851,0,,73190
11,5882844,5918291,dup,HG00406,0,,35447
11,5892747,5961013,dup,HG00406,0,,68266
11,6056270,6087880,dup,HG01886,0,,31610
11,6481264,6511597,dup,NA18870,0,,30333
11,7536916,7707187,dup,HG01853,0,,170271
11,7545083,7650780,dup,HG01853,0,,105697
11,7656781,7709891,dup,HG01853,0,,53110
11,7688071,7808881,dup,HG01435,0,,120810
11,7712928,7800354,dup,HG01435,0,,87426
11,7812280,7832579,dup,HG00105,0,,20299
11,7834153,7891697,dup,HG01435,0,,57544
11,7893508,7968229,dup,HG01853,0,,74721
11,10456666,10534456,dup,HG03875,0,,77790
11,10712136,10766121,dup,HG03162,0,,53985
11,10963665,10985204,dup,HG02009,0,,21539
11,10964480,10985798,dup,HG00142,0,,21318
11,11963296,11988661,dup,NA19755,0,,25365
11,11972327,11992676,dup,NA19755,0,,20349
11,12342543,12427176,dup,HG03709,0,,84633
11,12354568,12409251,dup,HG03709,0,,54683
11,12410702,12449995,dup,HG03709,0,,39293
11,12430696,13040532,dup,HG03709,0,,609836
11,12624888,12661362,dup,HG03709,0,,36474
11,12744011,12946642,dup,HG03709,0,,202631
11,12872599,13057451,dup,HG03709,0,,184852
11,14520404,14571537,dup,HG02221,0,,51133
11,14873676,14919955,dup,NA12889,0,,46279
11,16534612,16548818,dup,HG02882,0,,14206
11,16549519,16568957,dup,HG02012,0,,19438
11,16907793,16931028,dup,NA18956,0,,23235
11,16968875,17002052,dup,HG02084,0,,33177
11,18069786,18083002,dup,NA20760,0,,13216
11,18084878,18107520,dup,NA19222,0,,22642
11,18401419,18406168,dup,HG01886,0,,4749
11,18662965,18687585,dup,HG01525,0,,24620
11,18941736,18963997,dup,HG00100,0,,22261
11,20898533,20934937,dup,HG02384,0,,36404
11,20903923,21040261,dup,HG02384,0,,136338
11,21051699,21151776,dup,HG02384,0,,100077
11,21156947,21307599,dup,HG01161,0,,150652
11,21186933,21217159,dup,HG01161,0,,30226
11,21214576,21224624,dup,HG02384,0,,10048
11,21235192,21307218,dup,HG02384,0,,72026
11,21309970,21591587,dup,HG02384,0,,281617
11,21329857,21454355,dup,HG02384,0,,124498
11,21468334,21483364,dup,HG01061,0,,15030
11,21489386,21587020,dup,HG02384,0,,97634
11,21608114,21693597,dup,NA19328,0,,85483
11,21626599,21702463,dup,HG03006,0,,75864
11,21703263,21714454,dup,NA19328,0,,11191
11,21730878,21744946,dup,HG02409,0,,14068
11,22093574,22204971,dup,HG01810,0,,111397
11,22098571,22175543,dup,HG01810,0,,76972
11,22391192,22475970,dup,HG01810,0,,84778
11,22825125,22888038,dup,NA19077,0,,62913
11,22870993,22936467,dup,NA19077,0,,65474
11,22949155,23107706,dup,NA19077,0,,158551
11,23147359,23156401,dup,HG02793,0,,9042
11,23153927,23284348,dup,NA19077,0,,130421
11,23188417,23227727,dup,NA19077,0,,39310
11,23243399,23268765,dup,NA19077,0,,25366
11,23576378,23581977,dup,HG03805,0,,5599
11,23698532,23711724,dup,HG01626,0,,13192
11,23854434,23898245,dup,NA20514,0,,43811
11,24230591,24311061,dup,HG02364,0,,80470
11,24234721,24285323,dup,HG02040,0,,50602
11,24288309,24302666,dup,HG00452,0,,14357
11,24391732,24415864,dup,HG01491,0,,24132
11,25078434,25082283,dup,HG00119,0,,3849
11,25129111,25257275,dup,HG03175,0,,128164
11,25129111,25315252,dup,HG03175,0,,186141
11,25263593,25308303,dup,HG03175,0,,44710
11,25374105,25378573,dup,HG04200,0,,4468
11,25635975,25705338,dup,HG02870,0,,69363
11,25786566,25907163,dup,HG03817,0,,120597
11,25830341,25874208,dup,HG03817,0,,43867
11,26983712,27251286,dup,HG03235,0,,267574
11,26985625,27130385,dup,HG03235,0,,144760
11,27132470,27250276,dup,HG03235,0,,117806
11,29425685,29433007,dup,HG00449,0,,7322
11,30743457,30798879,dup,HG00334,0,,55422
11,30953998,30957604,dup,HG00590,0,,3606
11,31397081,31473381,dup,HG01447,0,,76300
11,31534573,31831106,dup,HG01447,0,,296533
11,31553906,31603918,dup,HG03640,0,,50012
11,31702942,31761733,dup,HG00131,0,,58791
11,31850736,31866230,dup,HG01447,0,,15494
11,31861612,31904031,dup,HG01447,0,,42419
11,31871774,31900111,dup,HG01447,0,,28337
11,31923130,32109661,dup,HG01447,0,,186531
11,31925075,31950859,dup,HG01447,0,,25784
11,32583666,32602867,dup,HG01550,0,,19201
11,33015740,33047981,dup,HG02058,0,,32241
11,33304507,33318417,dup,NA18973,0,,13910
11,33338485,33392603,dup,HG04195,0,,54118
11,33374966,33480402,dup,HG01974,0,,105436
11,33415321,33564626,dup,HG01974,0,,149305
11,33478590,33498559,dup,HG01938,0,,19969
11,33496623,33588018,dup,HG01974,0,,91395
11,34089698,34114606,dup,HG01522,0,,24908
11,35245494,35257951,dup,HG00406,0,,12457
11,35814594,35825717,dup,NA20886,0,,11123
11,36087836,36109175,dup,HG03928,0,,21339
11,36557579,36580876,dup,HG02620,0,,23297
11,36729187,36798444,dup,NA12287,0,,69257
11,36730382,36789580,dup,NA12287,0,,59198
11,37337519,37376162,dup,HG02852,0,,38643
11,37764401,37841815,dup,HG01402,0,,77414
11,37767249,37844756,dup,HG01402,0,,77507
11,37954183,38021569,dup,HG03782,0,,67386
11,39340574,39349718,dup,HG02136,0,,9144
11,39657337,39660939,dup,HG00443,0,,3602
11,40422898,40614501,dup,NA20758,0,,191603
11,41111199,41171154,dup,HG03708,0,,59955
11,41337174,41347623,dup,HG01108,0,,10449
11,41760696,41774232,dup,HG03976,0,,13536
11,42443156,42516549,dup,HG01031,0,,73393
11,42443655,42520026,dup,HG01031,0,,76371
11,42445125,42496997,dup,HG01031,0,,51872
11,42475400,42529793,dup,HG01031,0,,54393
11,42674106,42679454,dup,HG01883,0,,5348
11,42812829,42818734,dup,HG00096,0,,5905
11,42897102,42904063,dup,HG01140,0,,6961
11,42967415,42976408,dup,HG00148,0,,8993
11,43502163,43517794,dup,NA21102,0,,15631
11,43664833,43687379,dup,NA20803,0,,22546
11,43686566,43700973,dup,NA20803,0,,14407
11,43950895,43967762,dup,HG03950,0,,16867
11,44729793,44733764,dup,HG00112,0,,3971
11,45781050,45790610,dup,HG01608,0,,9560
11,46198107,46334419,dup,HG02734,0,,136312
11,46202442,46321769,dup,HG02734,0,,119327
11,46249492,46528884,dup,HG00142,0,,279392
11,46317010,46341059,dup,HG02734,0,,24049
11,46414435,46434425,dup,NA20504,0,,19990
11,46610353,46616404,dup,NA18747,0,,6051
11,46673212,46703201,dup,NA20866,0,,29989
11,47847528,47984977,dup,HG03575,0,,137449
11,47856829,47872075,dup,HG03575,0,,15246
11,47906024,47911096,dup,HG00448,0,,5072
11,47925439,47937950,dup,HG00448,0,,12511
11,48125130,48176265,dup,HG00556,0,,51135
11,48133178,48205956,dup,HG00556,0,,72778
11,48185151,48347240,dup,HG03485,0,,162089
11,48374452,48423318,dup,HG00250,0,,48866
11,48430144,48458590,dup,HG00250,0,,28446
11,48457182,48503264,dup,HG00250,0,,46082
11,48497513,48545467,dup,HG00250,0,,47954
11,48548081,48571055,dup,HG00250,0,,22974
11,48567385,48592884,dup,HG00250,0,,25499
11,48605360,48664500,dup,HG00250,0,,59140
11,48661230,48706350,dup,HG00250,0,,45120
11,48921931,48982862,dup,HG03611,0,,60931
11,49602101,49634107,dup,HG04155,0,,32006
11,49632122,49676774,dup,NA20761,0,,44652
11,49709566,49756724,dup,HG00099,0,,47158
11,49765031,49777286,dup,NA19756,0,,12255
11,49774713,49787626,dup,NA20761,0,,12913
11,49799628,49814700,dup,NA21093,0,,15072
11,49845548,49871803,dup,HG02286,0,,26255
11,49867703,49882802,dup,HG01954,0,,15099
11,49897967,49914391,dup,HG02736,0,,16424
11,49910775,50042705,dup,NA20761,0,,131930
11,50038859,50057532,dup,HG02002,0,,18673
11,50111591,50180455,dup,HG00651,0,,68864
11,50211199,50256332,dup,HG00651,0,,45133
11,50262501,50347538,dup,HG01260,0,,85037
11,50345849,50404924,dup,HG02107,0,,59075
11,50417993,50473014,dup,NA19331,0,,55021
11,50589440,50608474,dup,HG01108,0,,19034
11,51353224,51367675,dup,HG00096,0,,14451
11,51367676,51381377,dup,HG02232,0,,13701
11,51378943,51408099,dup,HG02232,0,,29156
11,51427483,51477490,dup,HG02232,0,,50007
11,51455413,51509425,dup,HG02232,0,,54012
11,51537043,51564931,dup,HG02232,0,,27888
11,55031988,55038453,dup,HG00099,0,,6465
11,55040241,55117209,dup,HG00599,0,,76968
11,55122635,55193264,dup,HG00599,0,,70629
11,55189130,55323795,dup,HG00599,0,,134665
11,55340458,55364291,dup,HG00346,0,,23833
11,55368372,55426969,dup,HG00097,0,,58597
11,55434292,55443935,dup,HG00097,0,,9643
11,55445715,55457586,dup,HG00097,0,,11871
11,55459122,55609227,dup,HG00731,0,,150105
11,55605806,55700205,dup,HG00346,0,,94399
11,55661427,55734781,dup,HG00565,0,,73354
11,55708545,55833999,dup,HG02977,0,,125454
11,55720183,55746495,dup,HG02977,0,,26312
11,55752698,55880394,dup,HG02977,0,,127696
11,55821010,56016913,dup,HG01620,0,,195903
11,55842595,55940929,dup,HG00346,0,,98334
11,55944547,56005238,dup,HG00346,0,,60691
11,56434418,56439206,dup,HG00351,0,,4788
11,58599759,58603886,dup,HG02573,0,,4127
11,58792858,58810245,dup,HG02621,0,,17387
11,58814995,58855468,dup,HG00428,0,,40473
11,59853421,59868667,dup,HG03786,0,,15246
11,60007745,60027246,dup,HG03616,0,,19501
11,60104139,60108693,dup,NA20528,0,,4554
11,60932935,60943588,dup,HG01861,0,,10653
11,61014139,61017922,dup,HG01796,0,,3783
11,61204473,61225309,dup,NA20775,0,,20836
11,61767929,61800986,dup,NA18940,0,,33057
11,61814718,61831350,dup,HG01770,0,,16632
11,61835505,61850166,dup,NA18940,0,,14661
11,61985280,62003413,dup,NA20763,0,,18133
11,62092889,62157092,dup,HG00142,0,,64203
11,62094032,62122119,dup,HG02256,0,,28087
11,62134138,62149053,dup,HG00674,0,,14915
11,62272046,62298243,dup,HG00142,0,,26197
11,62273865,62297944,dup,HG02721,0,,24079
11,62717715,62791521,dup,HG00142,0,,73806
11,62719948,62789397,dup,NA19375,0,,69449
11,63186456,63199776,dup,HG02150,0,,13320
11,63198026,63202706,dup,HG00110,0,,4680
11,63317246,63352664,dup,HG00142,0,,35418
11,63325931,63349762,dup,HG02397,0,,23831
11,64176311,64213156,dup,NA21086,0,,36845
11,64776914,64787180,dup,HG01921,0,,10266
11,64790939,64804578,dup,HG01356,0,,13639
11,65590288,65603234,dup,HG03473,0,,12946
11,67484812,67505595,dup,HG00410,0,,20783
11,67509751,67575995,dup,HG00410,0,,66244
11,67648070,67732868,dup,HG00410,0,,84798
11,69414097,69433420,dup,HG01054,0,,19323
11,71232146,71250413,dup,HG00638,0,,18267
11,71237818,71276082,dup,HG02084,0,,38264
11,71249134,71274035,dup,HG02084,0,,24901
11,71476985,71481718,dup,HG00103,0,,4733
11,71598568,71612732,dup,HG03069,0,,14164
11,71852383,71890984,dup,HG00142,0,,38601
11,71861980,71889192,dup,HG03898,0,,27212
11,72924208,72948228,dup,HG02819,0,,24020
11,73580167,73602688,dup,HG02878,0,,22521
11,73797996,73803389,dup,HG02187,0,,5393
11,73932302,74064118,dup,NA18582,0,,131816
11,73936645,74539988,dup,HG00142,0,,603343
11,73937630,74024535,dup,NA18582,0,,86905
11,74027538,74539358,dup,NA18582,0,,511820
11,74082127,74175434,dup,NA18582,0,,93307
11,74408179,74528843,dup,NA18582,0,,120664
11,74935508,75045070,dup,HG00141,0,,109562
11,75015547,75019296,dup,HG01618,0,,3749
11,75873456,75899932,dup,HG02299,0,,26476
11,76950038,76964992,dup,HG02573,0,,14954
11,78235497,78372326,dup,HG02778,0,,136829
11,78236242,78370672,dup,HG00142,0,,134430
11,78247389,78303501,dup,HG02778,0,,56112
11,79008321,79036283,dup,HG00255,0,,27962
11,79013310,79023496,dup,HG00255,0,,10186
11,80897822,80906149,dup,HG01882,0,,8327
11,81428361,81528339,dup,NA12763,0,,99978
11,81541274,81716140,dup,HG02561,0,,174866
11,81731987,81768614,dup,NA12763,0,,36627
11,81797905,81856569,dup,HG03304,0,,58664
11,81856334,81862981,dup,HG00102,0,,6647
11,81864732,81882059,dup,HG00101,0,,17327
11,81908879,81929788,dup,HG00267,0,,20909
11,81923498,82051961,dup,NA18988,0,,128463
11,82916441,82931742,dup,HG01802,0,,15301
11,83556795,83595223,dup,HG00580,0,,38428
11,83557416,83601321,dup,HG01846,0,,43905
11,83826381,83843573,dup,HG01205,0,,17192
11,83965910,84045055,dup,HG02095,0,,79145
11,84029240,84051838,dup,HG02095,0,,22598
11,84046978,84095887,dup,HG02095,0,,48909
11,84101233,84122523,dup,HG02095,0,,21290
11,84136420,84230443,dup,HG01620,0,,94023
11,85117123,85284969,dup,NA19351,0,,167846
11,85756921,85913084,dup,HG02085,0,,156163
11,85933760,85956519,dup,HG02085,0,,22759
11,86179867,86304300,dup,HG00626,0,,124433
11,86317475,86352123,dup,HG02085,0,,34648
11,86371765,86756607,dup,HG02085,0,,384842
11,86779083,86903416,dup,HG02085,0,,124333
11,86882148,86922525,dup,NA20346,0,,40377
11,87042596,87080100,dup,HG03086,0,,37504
11,87046706,87080480,dup,HG02085,0,,33774
11,87096972,87267877,dup,HG02085,0,,170905
11,87302596,87335580,dup,NA19403,0,,32984
11,87582049,87612368,dup,NA20877,0,,30319
11,87604118,87668357,dup,NA20856,0,,64239
11,87619540,87671975,dup,NA20877,0,,52435
11,87738386,87814417,dup,HG01807,0,,76031
11,87787390,87830338,dup,HG01807,0,,42948
11,88532263,88535747,dup,HG00253,0,,3484
11,89415867,89443466,dup,HG00404,0,,27599
11,89442231,89460925,dup,HG00404,0,,18694
11,89464878,89469812,dup,HG00404,0,,4934
11,89827814,89840049,dup,HG02470,0,,12235
11,89964374,90022002,dup,HG00146,0,,57628
11,89964728,90016193,dup,HG00146,0,,51465
11,90016793,90038745,dup,NA19756,0,,21952
11,90220884,90244109,dup,HG01613,0,,23225
11,90348349,90372710,dup,HG01986,0,,24361
11,91228065,91231097,dup,HG00560,0,,3032
11,91355597,91390226,dup,HG01961,0,,34629
11,91495232,91541922,dup,HG02150,0,,46690
11,91810711,91827560,dup,HG00559,0,,16849
11,93218472,93677483,dup,NA19377,0,,459011
11,93683277,93688526,dup,HG00131,0,,5249
11,93695312,93701967,dup,HG00410,0,,6655
11,93700468,93768130,dup,NA19377,0,,67662
11,93790612,93810542,dup,HG00631,0,,19930
11,93858709,93902670,dup,HG04006,0,,43961
11,93900725,93910170,dup,HG01369,0,,9445
11,93908871,93948644,dup,HG04006,0,,39773
11,93960550,94097024,dup,HG01756,0,,136474
11,93988789,94004797,dup,HG00171,0,,16008
11,94000586,94048232,dup,HG01756,0,,47646
11,94072636,94087179,dup,HG01066,0,,14543
11,94083848,94098003,dup,NA19315,0,,14155
11,94411236,94426915,dup,HG03025,0,,15679
11,94556567,94585672,dup,HG03025,0,,29105
11,94562726,94588707,dup,HG03025,0,,25981
11,94618862,94624451,dup,HG03696,0,,5589
11,94981755,95060257,dup,HG02728,0,,78502
11,96144896,96162282,dup,HG00554,0,,17386
11,96685773,96696680,dup,HG01865,0,,10907
11,96821458,96829354,dup,NA19147,0,,7896
11,96847602,96880488,dup,HG02952,0,,32886
11,97062702,97224386,dup,NA18988,0,,161684
11,97070518,97144149,dup,HG02594,0,,73631
11,97248934,97380631,dup,HG02594,0,,131697
11,97398140,97402509,dup,HG01670,0,,4369
11,97626931,97702857,dup,HG03619,0,,75926
11,97815990,97882552,dup,NA18945,0,,66562
11,98202156,98208233,dup,HG01536,0,,6077
11,98480803,98494410,dup,HG01198,0,,13607
11,99520349,99572189,dup,HG03686,0,,51840
11,99789700,100112804,dup,NA19377,0,,323104
11,99792663,99879545,dup,NA19377,0,,86882
11,100129563,100196199,dup,NA19377,0,,66636
11,100283822,100347605,dup,HG01794,0,,63783
11,100289638,100393720,dup,HG01794,0,,104082
11,100333375,100387486,dup,HG01794,0,,54111
11,100784283,100787880,dup,HG00171,0,,3597
11,101399878,101437495,dup,HG04038,0,,37617
11,102501027,102507149,dup,HG01605,0,,6122
11,102785098,102789444,dup,HG01170,0,,4346
11,102936632,103082930,dup,HG00259,0,,146298
11,102936888,103027712,dup,HG00259,0,,90824
11,103140974,103211718,dup,HG00259,0,,70744
11,103297509,103320542,dup,HG03247,0,,23033
11,103326186,103457249,dup,HG01105,0,,131063
11,103851802,103856480,dup,HG01070,0,,4678
11,104315974,104320840,dup,HG01058,0,,4866
11,104339053,104384242,dup,HG01786,0,,45189
11,104942834,104974891,dup,HG00707,0,,32057
11,105444278,105465764,dup,NA20901,0,,21486
11,106927736,107102720,dup,HG02360,0,,174984
11,106940899,107202602,dup,HG02360,0,,261703
11,107128096,107232040,dup,HG03742,0,,103944
11,107553665,107672108,dup,HG00238,0,,118443
11,107572305,107708976,dup,HG00238,0,,136671
11,107611704,107823923,dup,HG02049,0,,212219
11,107717715,107737083,dup,HG02049,0,,19368
11,107750515,107765833,dup,HG02049,0,,15318
11,107765040,107772106,dup,HG01608,0,,7066
11,107774466,107778832,dup,HG00851,0,,4366
11,107788279,107805160,dup,HG02049,0,,16881
11,107828329,107835746,dup,HG03645,0,,7417
11,108229471,108245053,dup,HG03694,0,,15582
11,108253630,108265982,dup,HG01121,0,,12352
11,108379733,108451534,dup,HG00692,0,,71801
11,108478680,108720005,dup,HG03668,0,,241325
11,108551837,108630800,dup,HG03668,0,,78963
11,108678031,108710187,dup,HG00234,0,,32156
11,108765793,108900679,dup,HG03668,0,,134886
11,108921304,108979390,dup,HG03652,0,,58086
11,109003621,109030382,dup,HG01967,0,,26761
11,109048015,109061651,dup,HG02681,0,,13636
11,109396675,109400880,dup,HG01915,0,,4205
11,109578169,109617584,dup,NA21112,0,,39415
11,111091345,111139393,dup,NA19700,0,,48048
11,111163944,111168192,dup,HG00335,0,,4248
11,111172275,111210460,dup,NA19700,0,,38185
11,111215240,111218488,dup,HG00171,0,,3248
11,111746452,111757313,dup,HG02757,0,,10861
11,112426841,112525045,dup,HG03195,0,,98204
11,112970913,112982567,dup,HG01111,0,,11654
11,114439070,114474140,dup,NA18532,0,,35070
11,114517470,114524094,dup,HG04090,0,,6624
11,114521249,114995411,dup,NA19917,0,,474162
11,116054255,116059466,dup,HG02188,0,,5211
11,117195842,117226786,dup,HG00142,0,,30944
11,117199217,117219565,dup,HG01789,0,,20348
11,118372815,118407172,dup,HG00326,0,,34357
11,118527158,118578914,dup,HG02769,0,,51756
11,118527435,118583089,dup,HG00142,0,,55654
11,120435256,120447146,dup,HG02051,0,,11890
11,121068577,121080475,dup,NA18961,0,,11898
11,121678788,121739894,dup,HG01284,0,,61106
11,121727435,121736709,dup,HG01284,0,,9274
11,122697010,122716050,dup,HG02325,0,,19040
11,123577691,123595291,dup,HG01341,0,,17600
11,124085997,124097575,dup,HG00589,0,,11578
11,124423252,124430990,dup,HG00138,0,,7738
11,124610196,124622345,dup,NA18924,0,,12149
11,126235306,126251893,dup,HG01865,0,,16587
11,127253901,127302594,dup,HG02585,0,,48693
11,128571756,128581922,dup,HG03189,0,,10166
11,129446489,129457380,dup,HG00142,0,,10891
11,129616641,129698754,dup,NA19038,0,,82113
11,130847229,130856897,dup,HG03120,0,,9668
11,131923548,131930173,dup,NA20864,0,,6625
11,132150781,132162870,dup,NA20795,0,,12089
11,132815510,132946208,dup,NA20763,0,,130698
11,132824077,132903627,dup,NA20763,0,,79550
11,132935444,132970380,dup,HG01308,0,,34936
11,132953768,133158580,dup,HG00142,0,,204812
11,132954727,133268340,dup,NA20763,0,,313613
11,133567019,133585263,dup,HG03649,0,,18244
11,133648392,133734481,dup,NA20534,0,,86089
11,133655110,133699785,dup,NA20534,0,,44675
11,133711017,133746117,dup,NA20534,0,,35100
11,134146846,134214583,dup,HG01353,0,,67737
11,134157740,134199113,dup,HG01353,0,,41373
11,134222958,134355175,dup,HG04195,0,,132217
11,134227064,134305456,dup,HG04195,0,,78392
11,134308019,134360049,dup,HG04195,0,,52030
11,134345522,134377546,dup,HG00341,0,,32024
11,134346368,134613348,dup,HG00341,0,,266980
11,134347903,134721844,dup,HG00142,0,,373941
11,134371797,134401227,dup,HG00341,0,,29430
11,134413964,134504037,dup,HG00341,0,,90073
11,134572928,134603619,dup,HG00341,0,,30691
11,134601920,134607017,dup,HG00097,0,,5097
11,134613743,134627210,dup,HG00341,0,,13467
11,134621447,134725032,dup,HG00159,0,,103585
11,134638336,134705193,dup,HG00341,0,,66857
11,134742043,134748783,dup,HG03313,0,,6740
11,134747084,134757237,dup,HG02153,0,,10153
11,134786635,134794834,dup,HG01149,0,,8199
11,134803800,134894568,dup,HG02790,0,,90768
11,134815388,134841217,dup,HG01149,0,,25829
11,134833317,134891558,dup,HG02790,0,,58241
11,134895634,134904309,dup,HG00240,0,,8675
11,134920082,134945587,dup,HG02064,0,,25505
12,9559461,9559829,del,NA18999,0,,368
12,59797986,59798238,del,NA18916,0,,252
12,52441715,52442125,del,NA19313,0,,410
12,124064425,124065310,del,NA19470,0,,885
12,101134961,101136905,del,NA20818,0,,1944
12,54074808,54076766,del,NA19440,0,,1958
12,39186965,39187070,del,NA19704,0,,105
12,7951242,8058199,del,HG01197,0,,106957
12,60102485,60103917,del,NA19189,0,,1432
12,25285419,25285878,del,NA19355,0,,459
12,73988039,73997773,del,NA20512,0,,9734
12,73349716,73427358,del,NA18871,0,,77642
12,5629363,5632200,del,NA19473,0,,2837
12,45548915,45549347,del,NA19393,0,,432
12,30478416,30481222,del,HG01516,0,,2806
12,132987034,132987458,del,NA19785,0,,424
12,128525771,128526955,del,NA19700,0,,1184
12,39555926,39556762,del,NA19172,0,,836
12,6814066,6825022,del,HG00610,0,,10956
12,128300300,128310761,del,NA19313,0,,10461
12,64399464,64405792,del,NA19129,0,,6328
12,7822816,7824372,del,NA19451,0,,1556
12,131530912,131531256,del,NA20314,0,,344
12,40301698,40315814,del,NA18867,0,,14116
12,37991952,38016419,del,NA18943,0,,24467
12,111158968,111159902,del,NA12842,0,,934
12,29011916,29017022,del,NA19818,0,,5106
12,34098887,34108952,del,NA19904,0,,10065
12,58028028,58029252,del,HG00403,0,,1224
12,20487386,20489594,del,NA19471,0,,2208
12,32160489,32161674,del,NA20773,0,,1185
12,132300772,132302426,del,HG01075,0,,1654
12,122110444,122118124,del,NA12843,0,,7680
12,75111574,75115469,del,NA19474,0,,3895
12,8893758,8899150,del,NA19713,0,,5392
12,71567212,71574836,del,HG01082,0,,7624
12,11227116,11250622,del,HG00177,0,,23506
12,23153825,23157797,del,HG01461,0,,3972
12,126905101,126905415,del,NA19755,0,,314
12,41899444,41899690,del,HG00464,0,,246
12,3340950,3346832,del,HG00565,0,,5882
12,86426103,86432915,del,HG00237,0,,6812
12,32547064,32550158,del,HG01080,0,,3094
12,46981219,46990831,del,HG00671,0,,9612
12,72243568,72244421,del,NA18858,0,,853
12,133528916,133682022,del,HG00592,0,,153106
12,133163746,133163933,del,HG00513,0,,187
12,14213811,14216703,del,NA19461,0,,2892
12,98956856,98963027,del,HG00731,0,,6171
12,132987537,132988592,del,HG01461,0,,1055
12,20243378,20243552,del,HG00323,0,,174
12,121425900,121426001,del,HG00589,0,,101
12,8825667,8827335,del,NA19213,0,,1668
12,16942363,16943734,del,NA18989,0,,1371
12,99993630,100008799,del,HG00148,0,,15169
12,74452209,74464582,del,HG00611,0,,12373
12,9559095,9561221,del,NA20513,0,,2126
12,31191505,31193146,del,NA19783,0,,1641
12,82994333,82994603,del,HG01359,0,,270
12,77838822,77838924,del,NA20790,0,,102
12,118569126,118571151,del,NA19391,0,,2025
12,129872301,129873460,del,HG00275,0,,1159
12,16883304,16884114,del,NA19385,0,,810
12,131410826,131412160,del,HG00442,0,,1334
12,128037977,128038294,del,HG00671,0,,317
12,112851204,112852540,del,HG00265,0,,1336
12,27711400,27711531,del,HG00543,0,,131
12,118946774,118949725,del,NA06989,0,,2951
12,12414150,12416305,del,NA19661,0,,2155
12,130295340,130298201,del,HG00699,0,,2861
12,132130216,132137422,del,HG01051,0,,7206
12,109557052,109558967,del,NA19818,0,,1915
12,123072458,123075655,del,HG01356,0,,3197
12,55449805,55450351,del,HG01083,0,,546
12,133471924,133472262,del,HG00309,0,,338
12,118447113,118448488,del,NA19436,0,,1375
12,70872266,70878218,del,NA12272,0,,5952
12,113071989,113072197,del,NA18602,0,,208
12,114083776,114086294,del,NA18908,0,,2518
12,13017634,13017948,del,HG00152,0,,314
12,62907472,62907867,del,NA18972,0,,395
12,93894803,93895679,del,HG01456,0,,876
12,119901803,119902118,del,NA18534,0,,315
12,16018667,16021661,del,NA20807,0,,2994
12,85074644,85074750,del,HG00285,0,,106
12,21861574,21861929,del,NA19240,0,,355
12,92748043,92798318,del,NA18619,0,,50275
12,1687690,1688503,del,HG00641,0,,813
12,31943520,31943809,del,NA18948,0,,289
12,47909325,47909767,del,HG00640,0,,442
12,56270368,56272606,del,NA19235,0,,2238
12,104730690,104732447,del,NA12413,0,,1757
12,99794016,99801822,del,NA19446,0,,7806
12,80302615,80303902,del,HG00111,0,,1287
12,10573018,10588454,del,HG00565,0,,15436
12,127591889,127604369,del,NA19373,0,,12480
12,72397806,72398309,del,HG00533,0,,503
12,117232143,117232951,del,NA19921,0,,808
12,128425037,128428940,del,NA19395,0,,3903
12,7977845,7978146,del,NA20585,0,,301
12,13910300,13910488,del,NA19240,0,,188
12,121152291,121153351,del,NA19332,0,,1060
12,124852139,124855404,del,NA18620,0,,3265
12,114321268,114330978,del,NA18940,0,,9710
12,72149691,72152937,del,HG01170,0,,3246
12,132875242,132877356,del,HG00731,0,,2114
12,122115024,122128609,del,NA19074,0,,13585
12,4043657,4044793,del,HG00608,0,,1136
12,2241174,2257996,del,HG00114,0,,16822
12,34404238,34412363,del,NA19360,0,,8125
12,5470921,5471946,del,NA12249,0,,1025
12,74216045,74216451,del,HG00653,0,,406
12,119440692,119442816,del,HG00592,0,,2124
12,17607308,17607812,del,HG00328,0,,504
12,37976336,37979287,del,NA19780,0,,2951
12,31636848,31637389,del,NA19085,0,,541
12,95285603,95287032,del,HG01366,0,,1429
12,122109718,122118849,del,NA12843,0,,9131
12,91241635,91246246,del,HG00258,0,,4611
12,126997209,127019790,del,NA20521,0,,22581
12,59935796,59946632,del,NA12286,0,,10836
12,125688980,125689425,del,HG01465,0,,445
12,113150685,113150828,del,NA18559,0,,143
12,20885073,20885749,del,NA18566,0,,676
12,34732838,34739357,del,HG00693,0,,6519
12,59935796,59946763,del,NA20126,0,,10967
12,111511023,111512707,del,NA19463,0,,1684
12,38143482,38146394,del,HG00736,0,,2912
12,58785515,58788131,del,NA19900,0,,2616
12,43045302,43045900,del,NA06994,0,,598
12,32644353,32646817,del,NA18632,0,,2464
12,96010266,96013372,del,HG00320,0,,3106
12,104619460,104621414,del,NA19901,0,,1954
12,81399923,81400254,del,NA19319,0,,331
12,98347919,98348288,del,HG01550,0,,369
12,105369052,105373545,del,NA19676,0,,4493
12,16147586,16151430,del,HG00512,0,,3844
12,23083141,23084173,del,NA18871,0,,1032
12,131928480,131928587,del,HG00275,0,,107
12,63947900,64142923,del,HG01465,0,,195023
12,99016639,99017960,del,NA19428,0,,1321
12,127487908,127495093,del,NA18861,0,,7185
12,122414721,122415735,del,NA19716,0,,1014
12,122138081,122142150,del,NA19256,0,,4069
12,122697340,122699404,del,HG00372,0,,2064
12,93504293,93505387,del,NA19076,0,,1094
12,60745770,60757101,del,NA20810,0,,11331
12,39893369,39894698,del,HG00329,0,,1329
12,33859037,33859896,del,NA19456,0,,859
12,123932670,123935012,del,NA19346,0,,2342
12,120858990,120859284,del,NA07346,0,,294
12,121124996,121128890,del,NA12763,0,,3894
12,10407412,10407721,del,NA18560,0,,309
12,65017471,65018357,del,NA19210,0,,886
12,103839895,103847703,del,NA18606,0,,7808
12,128673720,128673863,del,NA19704,0,,143
12,52395068,52395834,del,HG01465,0,,766
12,117640942,117643523,del,HG00373,0,,2581
12,50422513,50424280,del,HG00464,0,,1767
12,34251621,34262712,del,NA19834,0,,11091
12,122634656,122650525,del,HG01095,0,,15869
12,53086336,53087701,del,NA20344,0,,1365
12,52212016,52215622,del,NA19457,0,,3606
12,129509500,129510133,del,NA19700,0,,633
12,82091155,82098253,del,NA18910,0,,7098
12,6254557,6260680,del,HG00278,0,,6123
12,114501659,114502380,del,NA06986,0,,721
12,49841169,49843111,del,HG00150,0,,1942
12,82592006,82592435,del,NA18874,0,,429
12,74678138,74679791,del,NA19066,0,,1653
12,30918285,30918792,del,HG00181,0,,507
12,52864406,52883287,del,NA18874,0,,18881
12,123391252,123395677,del,NA18950,0,,4425
12,34516952,34517286,del,HG00740,0,,334
12,128840477,128843285,del,NA19789,0,,2808
12,2546909,2547294,del,HG00436,0,,385
12,105680980,105681599,del,HG00595,0,,619
12,117289429,117293391,del,NA20770,0,,3962
12,126238273,126243173,del,HG00613,0,,4900
12,24442374,24442688,del,HG00331,0,,314
12,29844381,29846435,del,HG00731,0,,2054
12,11250768,11253283,del,HG00629,0,,2515
12,86293007,86294246,del,NA19137,0,,1239
12,112012893,112027471,del,HG00254,0,,14578
12,43020190,43027490,del,NA19080,0,,7300
12,67536817,67537052,del,NA11993,0,,235
12,377496,384834,del,NA12891,0,,7338
12,292251,297948,del,NA12878,0,,5697
12,132566150,132568068,del,NA19920,0,,1918
12,51376806,51380329,del,HG00151,0,,3523
12,121704408,121705405,del,NA18542,0,,997
12,16306791,16307373,del,NA19375,0,,582
12,63863589,63869279,del,NA18636,0,,5690
12,86315670,86318686,del,NA19247,0,,3016
12,30043761,30043947,del,NA12749,0,,186
12,125484279,125487078,del,HG00327,0,,2799
12,124807857,124808158,del,NA18523,0,,301
12,119353496,119353653,del,HG01353,0,,157
12,38548999,38549587,del,NA19712,0,,588
12,89693670,89694492,del,NA18555,0,,822
12,79572316,79573522,del,HG00699,0,,1206
12,41028039,41029015,del,NA19472,0,,976
12,11167374,11222571,del,HG00133,0,,55197
12,1073566,1079305,del,NA19332,0,,5739
12,32808261,32808442,del,NA19404,0,,181
12,30237245,30243566,del,NA20513,0,,6321
12,55610291,55614418,del,NA19346,0,,4127
12,9016852,9017883,del,NA19749,0,,1031
12,40874775,40876463,del,NA18486,0,,1688
12,15409543,15417595,del,NA19000,0,,8052
12,6847724,6848509,del,HG01183,0,,785
12,11658999,11659982,del,HG00111,0,,983
12,108757272,108757745,del,NA18973,0,,473
12,54987496,54989077,del,NA18573,0,,1581
12,10629029,10630129,del,NA18523,0,,1100
12,94143282,94144106,del,HG00183,0,,824
12,16420123,16421290,del,NA20299,0,,1167
12,133047201,133047353,del,HG01456,0,,152
12,34800903,34807742,del,HG00262,0,,6839
12,131110949,131111429,del,NA12273,0,,480
12,133517316,133526822,del,NA19398,0,,9506
12,2070006,2071715,del,HG01108,0,,1709
12,11113782,11114213,del,NA19444,0,,431
12,72977697,72977860,del,HG00583,0,,163
12,125100099,125103464,del,HG00245,0,,3365
12,7822643,7824321,del,HG00278,0,,1678
12,76223916,76230768,del,NA18592,0,,6852
12,131059366,131059622,del,NA19429,0,,256
12,77487671,77493469,del,HG01190,0,,5798
12,122342207,122343980,del,NA19376,0,,1773
12,84266926,84765859,del,NA18565,0,,498933
12,129889244,129889855,del,NA20756,0,,611
12,8406004,8408709,del,HG00589,0,,2705
12,70594846,70597577,del,NA20799,0,,2731
12,119901894,119902169,del,HG00689,0,,275
12,40446356,40456431,del,NA18989,0,,10075
12,115035699,115035866,del,NA19396,0,,167
12,133378447,133424580,del,NA20503,0,,46133
12,56758131,56777604,del,NA18874,0,,19473
12,41674864,41675210,del,HG01356,0,,346
12,118082268,118082769,del,NA12890,0,,501
12,104867616,104870122,del,HG01187,0,,2506
12,3063660,3063899,del,NA19703,0,,239
12,34519774,34522983,del,NA12878,0,,3209
12,2865050,2870069,del,HG00285,0,,5019
12,111044673,111049250,del,NA19338,0,,4577
12,112872117,112875260,del,HG00422,0,,3143
12,8558716,8591022,del,NA12249,0,,32306
12,98631330,98631792,del,NA18504,0,,462
12,11226816,11250622,del,HG01519,0,,23806
12,131866827,131867785,del,HG00512,0,,958
12,10581590,10597017,del,HG01137,0,,15427
12,125119244,125124426,del,NA19236,0,,5182
12,53551268,53552080,del,NA19247,0,,812
12,56461859,56462442,del,NA18917,0,,583
12,123018284,123018498,del,NA19908,0,,214
12,240363,242168,del,HG01055,0,,1805
12,51145531,51147580,del,HG01136,0,,2049
12,91722042,91723859,del,NA19657,0,,1817
12,87249971,87250150,del,HG00463,0,,179
12,113847733,113848682,del,NA19916,0,,949
12,95387046,95387274,del,NA18620,0,,228
12,90487102,90491694,del,NA19054,0,,4592
12,61092354,61093360,del,NA19916,0,,1006
12,59685512,59689182,del,NA19982,0,,3670
12,23097547,23097879,del,HG00464,0,,332
12,30209076,30215102,del,NA19079,0,,6026
12,72281299,72283319,del,NA19717,0,,2020
12,97802566,97802779,del,NA12843,0,,213
12,12569797,12570972,del,HG01440,0,,1175
12,56952997,56955625,del,NA19788,0,,2628
12,101861473,101862031,del,NA12889,0,,558
12,129261113,129261461,del,HG00657,0,,348
12,55751345,55753332,del,NA18603,0,,1987
12,130575364,130575477,del,HG01374,0,,113
12,6814870,6824709,del,HG00421,0,,9839
12,19758623,19772324,del,NA19350,0,,13701
12,69255775,69256517,del,NA19446,0,,742
12,117086865,117088204,del,NA11933,0,,1339
12,63946729,63946956,del,HG01055,0,,227
12,7885009,7886550,del,NA19380,0,,1541
12,45125193,45136610,del,HG00111,0,,11417
12,74140636,74141804,del,NA19434,0,,1168
12,1864011,1864326,del,HG00319,0,,315
12,38180056,38190602,del,NA19382,0,,10546
12,124823596,124824045,del,NA19391,0,,449
12,31007761,31008689,del,NA19908,0,,928
12,4074941,4075289,del,NA19470,0,,348
12,3143013,3143400,del,HG01356,0,,387
12,49412916,49414922,del,HG00704,0,,2006
12,55584022,55584914,del,NA19396,0,,892
12,118754866,118783860,del,HG00250,0,,28994
12,67728352,67733812,del,NA19440,0,,5460
12,72655662,72657191,del,NA18552,0,,1529
12,29010949,29017376,del,NA19982,0,,6427
12,108863883,108866240,del,NA19190,0,,2357
12,65017462,65018479,del,NA19319,0,,1017
12,127579403,127585803,del,NA19066,0,,6400
12,59935794,59952859,del,NA18563,0,,17065
12,13177429,13178189,del,HG00418,0,,760
12,11341898,11342212,del,NA18559,0,,314
12,113019385,113020447,del,HG01383,0,,1062
12,11174368,11201053,del,HG01498,0,,26685
12,38335745,38341239,del,HG00737,0,,5494
12,92497623,92497918,del,NA07357,0,,295
12,83621839,83628337,del,NA19755,0,,6498
12,30009651,30009807,del,HG00148,0,,156
12,85036304,85040678,del,HG00254,0,,4374
12,22047473,22047575,del,NA20807,0,,102
12,44223640,44281893,del,HG00237,0,,58253
12,9129793,9132924,del,NA19374,0,,3131
12,1581846,1587867,del,HG00595,0,,6021
12,45903153,45909939,del,HG00310,0,,6786
12,12211426,12216722,del,NA19057,0,,5296
12,33358279,33360391,del,NA18631,0,,2112
12,99793947,99802770,del,HG00553,0,,8823
12,127855958,127859053,del,NA19704,0,,3095
12,102835960,102839019,del,HG00232,0,,3059
12,76900699,76901812,del,NA19982,0,,1113
12,132814538,132816250,del,HG01133,0,,1712
12,96188635,96191309,del,NA18626,0,,2674
12,81421038,81425469,del,NA19783,0,,4431
12,46709223,46710464,del,NA19380,0,,1241
12,21008159,21025694,del,HG01052,0,,17535
12,83844044,83844608,del,NA18489,0,,564
12,88140441,88143903,del,NA20770,0,,3462
12,94559356,94560089,del,HG00125,0,,733
12,19915953,19916819,del,NA18633,0,,866
12,56031874,56034464,del,NA19395,0,,2590
12,19458969,19463394,del,NA19331,0,,4425
12,10937766,10938086,del,NA18576,0,,320
12,12531470,12542500,del,NA19818,0,,11030
12,115736005,115745682,del,NA18999,0,,9677
12,4562161,4563830,del,NA20802,0,,1669
12,122282903,122283439,del,NA19399,0,,536
12,31723396,31724121,del,NA19700,0,,725
12,18348618,18356191,del,HG00620,0,,7573
12,60412345,60413508,del,NA12776,0,,1163
12,9559202,9559735,del,HG00329,0,,533
12,99985796,100034417,del,NA18546,0,,48621
12,60521839,60525035,del,NA07051,0,,3196
12,40874876,40876533,del,NA12275,0,,1657
12,3057743,3062195,del,HG01082,0,,4452
12,26105471,26106549,del,NA19462,0,,1078
12,53367460,53368151,del,HG00313,0,,691
12,133140322,133140564,del,HG01492,0,,242
12,34742149,34760733,del,NA19060,0,,18584
12,131147916,131150295,del,NA19448,0,,2379
12,83238745,83244583,del,NA19376,0,,5838
12,89274586,89275579,del,NA18610,0,,993
12,52544612,52547938,del,NA11930,0,,3326
12,101756303,101756957,del,HG00537,0,,654
12,84516627,84581852,del,HG00650,0,,65225
12,78099017,78100738,del,NA20127,0,,1721
12,20604271,20606171,del,NA12830,0,,1900
12,132170146,132171522,del,HG01083,0,,1376
12,53283758,53285723,del,HG00589,0,,1965
12,6907383,6907639,del,NA19469,0,,256
12,15899293,15906503,del,NA19448,0,,7210
12,28095647,28098405,del,NA18552,0,,2758
12,90411038,90415248,del,NA19065,0,,4210
12,99818195,99819682,del,HG00262,0,,1487
12,111226932,111238112,del,NA18909,0,,11180
12,105941235,105944466,del,HG00656,0,,3231
12,126162529,126163484,del,NA19463,0,,955
12,38050773,38108477,del,NA19449,0,,57704
12,122634629,122650399,del,NA19982,0,,15770
12,53056470,53065104,del,NA18867,0,,8634
12,24311900,24312489,del,HG00140,0,,589
12,115085866,115087100,del,NA18486,0,,1234
12,71121650,71121895,del,HG00252,0,,245
12,39847007,39853333,del,HG00620,0,,6326
12,51949284,51950876,del,NA18867,0,,1592
12,32407062,32407168,del,HG00334,0,,106
12,40006889,40007216,del,NA19240,0,,327
12,55917483,55924732,del,HG01462,0,,7249
12,98438014,98445775,del,HG01102,0,,7761
12,100474793,100475929,del,HG00442,0,,1136
12,11148239,11205516,del,NA19681,0,,57277
12,125013668,125015920,del,HG01072,0,,2252
12,1924424,1924868,del,NA20282,0,,444
12,73793442,73818494,del,HG01066,0,,25052
12,74210719,74211419,del,NA19713,0,,700
12,98979881,98980194,del,NA18917,0,,313
12,30508187,30508634,del,NA18596,0,,447
12,38342322,38349001,del,HG00137,0,,6679
12,8151841,8152174,del,NA18916,0,,333
12,43977016,43979322,del,HG01079,0,,2306
12,102102406,102107086,del,HG00637,0,,4680
12,30237245,30243570,del,NA18542,0,,6325
12,117020632,117029482,del,NA19235,0,,8850
12,38729586,38730833,del,NA18507,0,,1247
12,22592754,22599756,del,HG00268,0,,7002
12,518373,519043,del,NA18868,0,,670
12,125642691,125653091,del,NA19445,0,,10400
12,27266650,27784349,del,NA12763,0,,517699
12,90971838,90974616,del,NA18526,0,,2778
12,11191127,11257020,del,HG00345,0,,65893
12,54028693,54030817,del,HG01351,0,,2124
12,125334397,125334707,del,NA12249,0,,310
12,11167520,11222703,del,NA18579,0,,55183
12,66756152,66756991,del,NA18523,0,,839
12,120334943,120336086,del,HG01052,0,,1143
12,93210557,93211081,del,NA12489,0,,524
12,11181811,11212757,del,HG00476,0,,30946
12,112296441,112297176,del,NA18867,0,,735
12,80680770,80681332,del,NA19225,0,,562
12,102276116,102277522,del,NA19060,0,,1406
12,15243950,15244525,del,NA06984,0,,575
12,29298643,29298863,del,NA18856,0,,220
12,133247774,133248180,del,NA19448,0,,406
12,128673266,128673420,del,HG00256,0,,154
12,73153180,73156894,del,NA18620,0,,3714
12,7702264,7717565,del,HG00151,0,,15301
12,49824127,49827188,del,HG00705,0,,3061
12,132875410,132876499,del,NA18617,0,,1089
12,117641216,117642872,del,NA18571,0,,1656
12,108634808,108637565,del,NA18961,0,,2757
12,54840542,54841218,del,HG00531,0,,676
12,97889406,97891975,del,NA19067,0,,2569
12,10703487,10703814,del,NA18635,0,,327
12,72189158,72190573,del,NA19403,0,,1415
12,74453020,74456236,del,NA19463,0,,3216
12,40874928,40876677,del,NA11994,0,,1749
12,6818770,6820993,del,NA18999,0,,2223
12,41081569,41082376,del,NA18610,0,,807
12,25647329,25654770,del,HG01070,0,,7441
12,2331584,2332185,del,NA19904,0,,601
12,38150758,38152129,del,HG01097,0,,1371
12,47732578,47733456,del,HG00275,0,,878
12,60753216,60757902,del,NA19327,0,,4686
12,41183195,41183501,del,HG01375,0,,306
12,111612030,111613966,del,HG00419,0,,1936
12,63757120,63761792,del,NA20761,0,,4672
12,42506539,42507689,del,NA19316,0,,1150
12,119463343,119464447,del,NA19315,0,,1104
12,32431633,32441715,del,NA19982,0,,10082
12,103840480,103848425,del,NA18606,0,,7945
12,126997967,127009664,del,HG00285,0,,11697
12,95770249,95775990,del,NA18599,0,,5741
12,34517028,34517402,del,NA19346,0,,374
12,75208674,75222302,del,HG00608,0,,13628
12,7844057,7852704,del,NA19457,0,,8647
12,32330651,32335723,del,NA11995,0,,5072
12,97992249,97993559,del,NA19434,0,,1310
12,107579162,107579373,del,HG00335,0,,211
12,129987896,129992151,del,NA19107,0,,4255
12,1402589,1402734,del,NA19375,0,,145
12,43020190,43027457,del,HG01461,0,,7267
12,17607351,17607820,del,HG00244,0,,469
12,17445099,17445383,del,NA19313,0,,284
12,132619530,132620844,del,NA18963,0,,1314
12,31900410,31914739,del,NA20773,0,,14329
12,101286887,101290230,del,NA19904,0,,3343
12,14087597,14087789,del,HG01183,0,,192
12,112979374,112979658,del,NA19240,0,,284
12,115377480,115380403,del,NA12342,0,,2923
12,1402262,1402711,del,HG00122,0,,449
12,8893758,8899180,del,NA18505,0,,5422
12,31952159,31954486,del,NA19338,0,,2327
12,56002280,56004244,del,HG00321,0,,1964
12,124824145,124824277,del,NA12830,0,,132
12,72725140,72725309,del,NA19137,0,,169
12,89747524,89753429,del,NA19338,0,,5905
12,125156586,125156805,del,NA20543,0,,219
12,17179964,17182601,del,NA19703,0,,2637
12,130058313,130062274,del,NA18874,0,,3961
12,75025532,75028867,del,HG00542,0,,3335
12,19901598,19901910,del,HG00133,0,,312
12,69268875,69269301,del,HG00428,0,,426
12,77674024,77674725,del,NA18508,0,,701
12,82971914,82972506,del,NA19457,0,,592
12,31517262,31519777,del,NA07346,0,,2515
12,21017141,21036750,del,NA12399,0,,19609
12,45125156,45136552,del,HG00111,0,,11396
12,11581881,11583081,del,NA19316,0,,1200
12,128932242,128932541,del,HG00315,0,,299
12,82856112,82858570,del,NA18605,0,,2458
12,9632216,9732122,del,NA19469,0,,99906
12,58509627,58513742,del,NA19435,0,,4115
12,131335266,131335374,del,HG00125,0,,108
12,59936016,59947422,del,NA19172,0,,11406
12,2806878,2852404,del,NA18986,0,,45526
12,114274708,114274913,del,NA19451,0,,205
12,8498842,8506072,del,NA19916,0,,7230
12,84282276,84284109,del,NA19900,0,,1833
12,129755732,129758882,del,NA19921,0,,3150
12,68802186,68804607,del,HG00345,0,,2421
12,56863978,56864701,del,HG00693,0,,723
12,133445367,133445796,del,HG01067,0,,429
12,8804914,8807410,del,NA19399,0,,2496
12,118130285,118134970,del,NA20771,0,,4685
12,40874876,40876415,del,NA19395,0,,1539
12,119988544,119993260,del,NA20512,0,,4716
12,12807254,12807934,del,NA19131,0,,680
12,70058780,70058998,del,HG00246,0,,218
12,111750408,111752329,del,HG00560,0,,1921
12,38219480,38221543,del,HG00524,0,,2063
12,74644577,74648055,del,NA19397,0,,3478
12,55203290,55208916,del,NA18547,0,,5626
12,27447366,27448533,del,NA18986,0,,1167
12,123838017,123838703,del,NA19002,0,,686
12,98063020,98065920,del,NA18867,0,,2900
12,127420245,127420609,del,NA18853,0,,364
12,130575408,130575540,del,HG00422,0,,132
12,128770338,128770530,del,HG01083,0,,192
12,129448155,129452909,del,NA18549,0,,4754
12,77010822,77011168,del,NA20529,0,,346
12,127581016,127585622,del,NA18532,0,,4606
12,10584346,10599780,del,NA18867,0,,15434
12,131131936,131133867,del,NA19755,0,,1931
12,61332513,61333365,del,HG01350,0,,852
12,2987469,2991857,del,HG00638,0,,4388
12,25088960,25131879,del,NA12046,0,,42919
12,48725466,48728380,del,NA11933,0,,2914
12,8824021,8833605,del,NA20507,0,,9584
12,34493873,34494062,del,NA18612,0,,189
12,93886263,93917637,del,NA19704,0,,31374
12,33824092,33824595,del,NA19457,0,,503
12,133356311,133356581,del,NA19372,0,,270
12,34207411,34216816,del,NA18498,0,,9405
12,57156869,57174573,del,NA19678,0,,17704
12,31777023,31778784,del,NA19256,0,,1761
12,31827994,31830069,del,NA19707,0,,2075
12,96036922,96038960,del,NA19700,0,,2038
12,59935216,59948322,del,HG00126,0,,13106
12,41494665,41517807,del,NA19147,0,,23142
12,87001742,87002533,del,NA19059,0,,791
12,82095906,82099287,del,HG00264,0,,3381
12,6818761,6821002,del,NA19072,0,,2241
12,1230870,1231688,del,NA18489,0,,818
12,81078649,81091471,del,HG00584,0,,12822
12,91658378,91659877,del,NA19108,0,,1499
12,14853583,14854318,del,NA19172,0,,735
12,11068046,11068299,del,NA19004,0,,253
12,132815716,132821422,del,NA19468,0,,5706
12,12532148,12542147,del,NA07048,0,,9999
12,20779059,20779230,del,NA19116,0,,171
12,26409854,26413020,del,HG00475,0,,3166
12,4853675,4853917,del,HG01101,0,,242
12,84612547,84614070,del,NA18508,0,,1523
12,8388951,8398473,del,HG00583,0,,9522
12,73424878,73446941,del,NA19374,0,,22063
12,38050815,38104977,del,NA19172,0,,54162
12,132957614,132958258,del,HG01551,0,,644
12,133032396,133032659,del,NA19675,0,,263
12,18894069,18894367,del,NA18501,0,,298
12,7875595,7881618,del,HG00590,0,,6023
12,60434954,60439901,del,NA19395,0,,4947
12,5700039,5706656,del,NA18630,0,,6617
12,9632516,9732722,del,HG01136,0,,100206
12,94443405,94447376,del,NA19468,0,,3971
12,34515475,34515584,del,NA12878,0,,109
12,51216437,51218464,del,HG00247,0,,2027
12,72222026,72222765,del,NA19704,0,,739
12,127213066,127213200,del,HG00318,0,,134
12,57185324,57187473,del,NA20515,0,,2149
12,118918410,118927251,del,NA20522,0,,8841
12,133502916,133682222,del,NA18530,0,,179306
12,13725905,13726553,del,NA20766,0,,648
12,48910594,48911244,del,NA20589,0,,650
12,133139716,133140422,del,NA20299,0,,706
12,22322335,22326743,del,NA19452,0,,4408
12,51151690,51152221,del,NA19664,0,,531
12,113473804,113478889,del,NA19247,0,,5085
12,119145692,119145910,del,NA19130,0,,218
12,80614359,80614535,del,HG01168,0,,176
12,43211870,43212853,del,NA19448,0,,983
12,122282863,122283380,del,NA18874,0,,517
12,83780675,83785464,del,NA19360,0,,4789
12,32554515,32559937,del,NA19360,0,,5422
12,126998017,127013351,del,NA20529,0,,15334
12,866475,876410,del,HG00368,0,,9935
12,53423929,53424055,del,HG00536,0,,126
12,27914143,27916783,del,HG01491,0,,2640
12,116887550,116887749,del,NA18505,0,,199
12,100078232,100088071,del,HG00654,0,,9839
12,260213,260372,del,HG00249,0,,159
12,11225816,11250622,del,NA19093,0,,24806
12,102275948,102277154,del,NA11830,0,,1206
12,121602144,121605285,del,HG01350,0,,3141
12,131266418,131266597,del,HG00254,0,,179
12,78798943,78800743,del,NA20586,0,,1800
12,1982051,1985908,del,NA19393,0,,3857
12,28854227,28860682,del,NA19082,0,,6455
12,78375998,78376183,del,NA19716,0,,185
12,100634140,100639869,del,NA18537,0,,5729
12,19704476,19708027,del,HG00345,0,,3551
12,82139715,82144319,del,NA18572,0,,4604
12,5853200,5853406,del,NA19360,0,,206
12,9053126,9053947,del,NA20299,0,,821
12,30615653,30616217,del,NA18952,0,,564
12,47677013,47679801,del,NA19236,0,,2788
12,16631111,16632316,del,NA19789,0,,1205
12,53056509,53065085,del,NA18867,0,,8576
12,63642940,63643334,del,NA19213,0,,394
12,7832762,7832950,del,NA19360,0,,188
12,116352529,116353439,del,NA19393,0,,910
12,84349745,84351424,del,NA12716,0,,1679
12,1351247,1353903,del,NA19380,0,,2656
12,51278001,51279961,del,NA20530,0,,1960
12,124795816,124795936,del,HG00271,0,,120
12,84593108,84596011,del,NA20540,0,,2903
12,34845594,34849903,del,HG00134,0,,4309
12,6538387,6538775,del,NA20513,0,,388
12,114950290,114952090,del,NA19908,0,,1800
12,66651889,66653071,del,HG01374,0,,1182
12,59935216,59947722,del,NA20519,0,,12506
12,34553179,34553339,del,NA19395,0,,160
12,121377938,121379067,del,HG00475,0,,1129
12,45967248,45967629,del,NA18973,0,,381
12,23989916,23991722,del,HG00702,0,,1806
12,46631160,46632073,del,NA19239,0,,913
12,51152247,51153238,del,NA19440,0,,991
12,44153639,44157285,del,NA18597,0,,3646
12,84711882,84719634,del,NA18603,0,,7752
12,7671074,7677228,del,NA18567,0,,6154
12,55487916,55492522,del,HG00418,0,,4606
12,15568483,15573622,del,NA19472,0,,5139
12,33295416,33307222,del,NA20806,0,,11806
12,119513499,119513818,del,NA19318,0,,319
12,99818191,99820038,del,NA12763,0,,1847
12,105693279,105695279,del,HG00326,0,,2000
12,121535883,121542305,del,NA19452,0,,6422
12,22344307,22345126,del,NA19452,0,,819
12,69022377,69033179,del,NA19431,0,,10802
12,56060986,56063538,del,NA19469,0,,2552
12,70872916,70878922,del,NA20760,0,,6006
12,40875044,40876391,del,NA20805,0,,1347
12,129871702,129871849,del,HG01082,0,,147
12,11518486,11557672,del,NA19701,0,,39186
12,55727209,55728183,del,HG00513,0,,974
12,69557756,69559691,del,HG00419,0,,1935
12,14052323,14052818,del,HG01465,0,,495
12,11161324,11275786,del,NA12005,0,,114462
12,54613278,54614253,del,NA19072,0,,975
12,10721231,10722949,del,HG00671,0,,1718
12,27242633,27754640,del,NA18487,0,,512007
12,58385215,58394200,del,NA19456,0,,8985
12,5666211,5666449,del,HG01066,0,,238
12,59937266,59951122,del,HG00136,0,,13856
12,132836496,132836588,del,HG00375,0,,92
12,2365207,2367146,del,NA18487,0,,1939
12,34207116,34216672,del,NA19256,0,,9556
12,122893530,122895661,del,HG01051,0,,2131
12,122112294,122118769,del,HG01136,0,,6475
12,60873405,60879255,del,NA12383,0,,5850
12,86695694,86703066,del,NA19376,0,,7372
12,128276683,128277409,del,HG00177,0,,726
12,71886564,71889653,del,NA19457,0,,3089
12,25855216,25862159,del,HG01359,0,,6943
12,31906781,31912127,del,NA19663,0,,5346
12,75322494,75322715,del,NA18610,0,,221
12,44586431,44594119,del,NA19190,0,,7688
12,88994483,88995204,del,NA18544,0,,721
12,131933843,131938647,del,NA19313,0,,4804
12,1437990,1438610,del,NA07357,0,,620
12,34355952,34361452,del,NA18502,0,,5500
12,128957843,128958125,del,HG00530,0,,282
12,132633756,132635292,del,HG00277,0,,1536
12,88627866,88628576,del,HG00512,0,,710
12,34441804,34442017,del,NA19393,0,,213
12,32051399,32059342,del,HG00112,0,,7943
12,122222963,122224676,del,NA19443,0,,1713
12,130060287,130060618,del,NA20291,0,,331
12,131243444,131243715,del,NA19707,0,,271
12,121832604,121834275,del,HG00436,0,,1671
12,60064750,60066245,del,NA19916,0,,1495
12,125049116,125053622,del,NA18546,0,,4506
12,10813066,10813239,del,HG00127,0,,173
12,10299355,10299513,del,NA20340,0,,158
12,103839127,103847017,del,NA19451,0,,7890
12,133516916,133526822,del,NA18959,0,,9906
12,86500309,86503996,del,NA19819,0,,3687
12,90512325,90512631,del,NA19129,0,,306
12,59373902,59374227,del,NA19661,0,,325
12,131664882,131673988,del,HG00442,0,,9106
12,95723179,95723386,del,HG00140,0,,207
12,866800,874783,del,HG01191,0,,7983
12,60444276,60447761,del,NA19373,0,,3485
12,122113058,122129644,del,NA18961,0,,16586
12,51463133,51463539,del,NA19818,0,,406
12,18306811,18317898,del,HG00179,0,,11087
12,53375623,53378691,del,NA18510,0,,3068
12,7968678,7969197,del,NA19731,0,,519
12,49470012,49470492,del,HG00158,0,,480
12,89611824,89612206,del,NA19108,0,,382
12,9180857,9181921,del,NA18523,0,,1064
12,133472130,133472480,del,NA18940,0,,350
12,33385104,33398299,del,NA18596,0,,13195
12,94197437,94202671,del,HG01067,0,,5234
12,84030571,84032786,del,HG00266,0,,2215
12,89274501,89275907,del,NA18610,0,,1406
12,122119589,122130399,del,NA19074,0,,10810
12,129133249,129133477,del,NA19700,0,,228
12,8132616,8133622,del,NA19396,0,,1006
12,71886716,71890022,del,NA19985,0,,3306
12,46472954,46473861,del,NA19716,0,,907
12,41143349,41143606,del,NA20826,0,,257
12,80971087,80979736,del,NA19469,0,,8649
12,30233557,30233826,del,NA18520,0,,269
12,87410425,87427696,del,NA19238,0,,17271
12,98669927,98672090,del,NA12058,0,,2163
12,7822416,7824622,del,NA19717,0,,2206
12,116965679,116965967,del,NA18517,0,,288
12,109647710,109648180,del,NA19009,0,,470
12,11172059,11227712,del,NA12058,0,,55653
12,22248540,22252013,del,NA18488,0,,3473
12,106148230,106148813,del,NA20503,0,,583
12,47028576,47033308,del,NA19334,0,,4732
12,115794139,115802332,del,HG00708,0,,8193
12,33770166,33774940,del,NA12829,0,,4774
12,27425661,27426433,del,NA18606,0,,772
12,45011174,45011496,del,HG00259,0,,322
12,27648142,27655163,del,NA19712,0,,7021
12,54402216,54413322,del,HG00315,0,,11106
12,119047166,119049067,del,NA19238,0,,1901
12,38660720,38670752,del,NA18617,0,,10032
12,80435951,80438510,del,NA19917,0,,2559
12,100288344,100291787,del,NA12283,0,,3443
12,98955401,98959000,del,NA12892,0,,3599
12,122849684,122850139,del,NA19360,0,,455
12,10571416,10584922,del,NA18615,0,,13506
12,116369467,116376920,del,NA20507,0,,7453
12,71501025,71504196,del,HG00698,0,,3171
12,133032533,133032677,del,NA18990,0,,144
12,108399501,108484975,del,NA12348,0,,85474
12,40874767,40876424,del,HG01097,0,,1657
12,74249517,74254886,del,HG01079,0,,5369
12,93886363,93917762,del,NA19704,0,,31399
12,57952065,57952213,del,HG00580,0,,148
12,44259458,44260336,del,NA20322,0,,878
12,1365576,1366369,del,NA19438,0,,793
12,79454023,79455123,del,HG00613,0,,1100
12,33853139,33853354,del,HG00274,0,,215
12,56179124,56181148,del,NA19474,0,,2024
12,53929068,53929756,del,NA18907,0,,688
12,18723270,18725094,del,HG00180,0,,1824
12,124725447,124726709,del,NA11831,0,,1262
12,68998915,69000117,del,HG00614,0,,1202
12,325185,325375,del,HG01136,0,,190
12,44153395,44157336,del,NA18597,0,,3941
12,131517264,131517530,del,NA19445,0,,266
12,86290462,86290901,del,NA19375,0,,439
12,50546256,50549874,del,NA19717,0,,3618
12,100156080,100156287,del,HG00437,0,,207
12,17589243,17601361,del,NA19704,0,,12118
12,34358016,34361772,del,NA19901,0,,3756
12,131093927,131094224,del,NA19684,0,,297
12,1073578,1079276,del,NA19818,0,,5698
12,127404667,127406359,del,NA19394,0,,1692
12,79855991,79856861,del,NA18907,0,,870
12,9633016,9732922,del,HG01182,0,,99906
12,33715118,33716965,del,NA18621,0,,1847
12,34463040,34463366,del,NA18868,0,,326
12,117217628,117219325,del,HG00342,0,,1697
12,2868190,2869456,del,NA19657,0,,1266
12,30478283,30480989,del,NA20539,0,,2706
12,100675959,100676260,del,HG00261,0,,301
12,38974623,38974902,del,NA20544,0,,279
12,20996824,21146949,del,NA18582,0,,150125
12,42697832,42700093,del,NA07037,0,,2261
12,7716353,7721238,del,NA19456,0,,4885
12,3869550,3870624,del,NA12778,0,,1074
12,79885236,79887701,del,NA19256,0,,2465
12,11231616,11250622,del,HG01098,0,,19006
12,32443055,32443160,del,HG00261,0,,105
12,6241436,6248077,del,NA12750,0,,6641
12,59675088,59678722,del,HG01173,0,,3634
12,121316737,121320926,del,NA19384,0,,4189
12,17616391,17617613,del,HG00273,0,,1222
12,55193016,55194991,del,NA18868,0,,1975
12,122031896,122033281,del,NA19746,0,,1385
12,20337038,20339608,del,HG00176,0,,2570
12,109632295,109632427,del,HG00284,0,,132
12,14258601,14258932,del,NA19009,0,,331
12,75056482,75056650,del,NA19704,0,,168
12,58305975,58319026,del,HG01365,0,,13051
12,133368224,133368639,del,NA19818,0,,415
12,3349402,3357612,del,NA18638,0,,8210
12,17168134,17172261,del,HG01174,0,,4127
12,101419644,101423234,del,NA07000,0,,3590
12,62129493,62131560,del,HG01366,0,,2067
12,132988616,132990222,del,NA20524,0,,1606
12,30371317,30371742,del,NA19729,0,,425
12,120733016,120737222,del,HG00534,0,,4206
12,113303389,113303601,del,NA19377,0,,212
12,64420441,64421664,del,NA19332,0,,1223
12,129584343,129584564,del,NA19239,0,,221
12,6506256,6508046,del,NA19453,0,,1790
12,122893784,122895715,del,HG01051,0,,1931
12,56061037,56062864,del,NA19456,0,,1827
12,82030118,82032514,del,HG01052,0,,2396
12,12541503,12549205,del,NA19313,0,,7702
12,130409171,130409281,del,HG00237,0,,110
12,7799641,7800591,del,HG01069,0,,950
12,98141600,98142457,del,NA18592,0,,857
12,100936602,100944490,del,HG00118,0,,7888
12,89223634,89224948,del,NA19720,0,,1314
12,63863580,63869334,del,HG00625,0,,5754
12,132842571,132842769,del,HG01173,0,,198
12,62200798,62210960,del,NA19376,0,,10162
12,3076017,3077236,del,HG00672,0,,1219
12,130383660,130383974,del,NA20586,0,,314
12,1028785,1029591,del,NA19379,0,,806
12,90890336,90899186,del,HG01108,0,,8850
12,87530505,87533520,del,HG01198,0,,3015
12,67927349,67928121,del,HG00149,0,,772
12,53972988,53974856,del,HG00361,0,,1868
12,126825401,126825492,del,NA11920,0,,91
12,9632516,9733122,del,NA06994,0,,100606
12,122914410,122916612,del,NA20341,0,,2202
12,27084331,27087158,del,NA19470,0,,2827
12,27878934,27882825,del,NA19430,0,,3891
12,133164495,133164584,del,HG01350,0,,89
12,52354757,52354890,del,HG00530,0,,133
12,129230074,129233186,del,NA20826,0,,3112
12,79188735,79192539,del,NA18871,0,,3804
12,5221822,5223453,del,NA19664,0,,1631
12,115230488,115233038,del,NA18548,0,,2550
12,77115335,77118232,del,NA19107,0,,2897
12,20811933,20816643,del,NA19916,0,,4710
12,43167808,43175416,del,HG00179,0,,7608
12,2516563,2516872,del,HG00256,0,,309
12,78674497,78674601,del,NA19394,0,,104
12,25961485,25963551,del,NA20535,0,,2066
12,11428180,11473808,del,HG00325,0,,45628
12,38104020,38114614,del,HG00731,0,,10594
12,1480724,1480875,del,NA19375,0,,151
12,3570829,3572203,del,NA19457,0,,1374
12,9559206,9560485,del,NA19070,0,,1279
12,58675302,58678812,del,NA19701,0,,3510
12,82215444,82225359,del,HG01462,0,,9915
12,82104482,82109042,del,HG01080,0,,4560
12,60660065,60661295,del,NA19901,0,,1230
12,103242069,103242366,del,NA18620,0,,297
12,18491363,18491711,del,NA18505,0,,348
12,4388761,4389330,del,NA20811,0,,569
12,11770841,11771532,del,NA19404,0,,691
12,33296553,33307366,del,NA20828,0,,10813
12,30237416,30244022,del,NA12775,0,,6606
12,68442705,68452356,del,HG00525,0,,9651
12,128604293,128604525,del,HG00142,0,,232
12,50687252,50689013,del,HG00236,0,,1761
12,11169139,11224767,del,HG00332,0,,55628
12,2869693,2870947,del,NA18520,0,,1254
12,66791974,66794130,del,NA20322,0,,2156
12,11186831,11216963,del,HG00362,0,,30132
12,30348862,30349932,del,HG00637,0,,1070
12,133352967,133353076,del,HG01101,0,,109
12,93417923,93419831,del,NA19256,0,,1908
12,34070491,34079341,del,NA19461,0,,8850
12,63946355,64141424,del,HG00123,0,,195069
12,129652466,129653791,del,NA07000,0,,1325
12,50553919,50558999,del,HG00443,0,,5080
12,114632070,114638006,del,HG01462,0,,5936
12,119901842,119902028,del,NA19376,0,,186
12,50097342,50098428,del,NA19235,0,,1086
12,112592727,112593357,del,NA18635,0,,630
12,34632672,34632813,del,HG00702,0,,141
12,37993555,37999159,del,HG01051,0,,5604
12,49878851,49879966,del,NA19474,0,,1115
12,39477923,39483137,del,HG01360,0,,5214
12,133456908,133461058,del,NA19213,0,,4150
12,118170644,118173339,del,HG00734,0,,2695
12,30233700,30233849,del,HG00369,0,,149
12,111976288,111980008,del,NA11893,0,,3720
12,64280105,64280331,del,NA19372,0,,226
12,27161006,27162397,del,NA19055,0,,1391
12,69174849,69174903,del,NA19257,0,,54
12,56217682,56219447,del,HG00566,0,,1765
12,121401684,121401973,del,NA19704,0,,289
12,117005305,117007586,del,HG00581,0,,2281
12,18385200,18393782,del,NA19713,0,,8582
12,39097787,39102873,del,HG01378,0,,5086
12,113223059,113223850,del,NA18952,0,,791
12,31529095,31531405,del,HG01048,0,,2310
12,115893210,115897251,del,NA19461,0,,4041
12,72326672,72332325,del,NA18541,0,,5653
12,110099460,110099975,del,NA20775,0,,515
12,6688208,6688343,del,HG01052,0,,135
12,126994385,127005892,del,NA12413,0,,11507
12,104846642,104847901,del,HG01048,0,,1259
12,128673260,128673925,del,NA20534,0,,665
12,89439336,89444895,del,NA19726,0,,5559
12,131730234,131828839,del,NA20785,0,,98605
12,117640993,117642506,del,HG01366,0,,1513
12,110863162,110864023,del,NA18948,0,,861
12,49824162,49824588,del,HG00252,0,,426
12,51918973,51936610,del,NA19719,0,,17637
12,133771505,133771657,del,NA20529,0,,152
12,124709001,124709118,del,NA12045,0,,117
12,9555972,9556713,del,NA18989,0,,741
12,115085835,115087098,del,NA18909,0,,1263
12,29161676,29164837,del,NA19116,0,,3161
12,111976288,111980097,del,NA12750,0,,3809
12,131756112,131762276,del,HG00583,0,,6164
12,10572937,10588373,del,HG01069,0,,15436
12,47911023,47911401,del,NA19099,0,,378
12,98946142,98948085,del,NA19434,0,,1943
12,131131216,131133772,del,NA19779,0,,2556
12,11192444,11218061,del,NA19782,0,,25617
12,129871741,129871849,del,HG00553,0,,108
12,22917340,22923146,del,HG01060,0,,5806
12,128811297,128812053,del,NA19210,0,,756
12,96010453,96012414,del,NA19780,0,,1961
12,111168593,111169575,del,NA12842,0,,982
12,127004368,127005783,del,NA19901,0,,1415
12,32640508,32647574,del,NA20756,0,,7066
12,91241838,91244689,del,HG01108,0,,2851
12,19683994,19687749,del,NA19064,0,,3755
12,106670757,106671373,del,NA19108,0,,616
12,74254289,74307155,del,NA18534,0,,52866
12,31908616,31912272,del,NA19393,0,,3656
12,44207141,44208642,del,NA19731,0,,1501
12,11167218,11222377,del,NA20506,0,,55159
12,22530184,22530614,del,NA18576,0,,430
12,132055054,132057295,del,NA18516,0,,2241
12,93750088,93751550,del,NA19372,0,,1462
12,24456753,24459304,del,NA19684,0,,2551
12,54245397,54245696,del,HG00328,0,,299
12,126820935,126829484,del,NA19920,0,,8549
12,2461758,2461891,del,HG01492,0,,133
12,2952921,2953366,del,NA19676,0,,445
12,13941609,13941706,del,HG00281,0,,97
12,108857722,108869477,del,NA20527,0,,11755
12,84371303,84378390,del,NA19313,0,,7087
12,85363398,85364474,del,NA18856,0,,1076
12,110307464,110307644,del,HG00335,0,,180
12,24570745,24583271,del,HG01073,0,,12526
12,131514101,131514808,del,NA18501,0,,707
12,101841456,101860726,del,NA19681,0,,19270
12,70872266,70878217,del,NA18564,0,,5951
12,12241645,12248089,del,NA18627,0,,6444
12,125952494,125952820,del,NA18599,0,,326
12,74571808,74572021,del,NA18867,0,,213
12,64571526,64572049,del,NA19062,0,,523
12,68898951,68903176,del,NA19684,0,,4225
12,12252827,12254646,del,NA12843,0,,1819
12,29111723,29112433,del,HG00261,0,,710
12,13000469,13015290,del,HG00338,0,,14821
12,125484204,125487026,del,HG00327,0,,2822
12,66207059,66207351,del,NA18853,0,,292
12,40817586,40821649,del,NA19355,0,,4063
12,108530499,108530553,del,NA19129,0,,54
12,122483061,122485164,del,HG01191,0,,2103
12,130232230,130234016,del,NA19648,0,,1786
12,44207154,44208404,del,HG01441,0,,1250
12,6519548,6520455,del,NA19436,0,,907
12,132170963,132171209,del,NA19385,0,,246
12,32148618,32152989,del,NA18868,0,,4371
12,24940922,24941624,del,HG00152,0,,702
12,31112834,31115220,del,NA19703,0,,2386
12,38311347,38317912,del,HG01105,0,,6565
12,96766306,96779355,del,HG00653,0,,13049
12,1194247,1200053,del,HG00343,0,,5806
12,57097211,57097506,del,HG01384,0,,295
12,38921388,38923540,del,NA19088,0,,2152
12,72822864,72861127,del,NA20503,0,,38263
12,86735407,86775888,del,NA19909,0,,40481
12,71602357,71604473,del,HG00185,0,,2116
12,522685,523536,del,NA19678,0,,851
12,13257320,13259822,del,HG00473,0,,2502
12,41525551,41541832,del,NA19390,0,,16281
12,59934848,59946674,del,HG00267,0,,11826
12,45273177,45282539,del,NA19376,0,,9362
12,95387007,95387143,del,NA18624,0,,136
12,44691831,44692913,del,NA18867,0,,1082
12,125895275,125895592,del,HG01108,0,,317
12,47431783,47434366,del,HG01377,0,,2583
12,6822376,6822683,del,NA19312,0,,307
12,129132483,129133548,del,NA18871,0,,1065
12,11228016,11251722,del,NA20811,0,,23706
12,68791788,68796889,del,NA18559,0,,5101
12,123931418,123933375,del,HG01197,0,,1957
12,33264419,33266357,del,HG01170,0,,1938
12,115080016,115082331,del,NA19355,0,,2315
12,92222667,92230069,del,HG00326,0,,7402
12,80088769,80089541,del,HG00626,0,,772
12,292228,297965,del,NA20772,0,,5737
12,40180820,40186356,del,NA19384,0,,5536
12,41893119,41894932,del,NA19334,0,,1813
12,38049953,38103428,del,NA19175,0,,53475
12,120355588,120357807,del,NA18511,0,,2219
12,23939521,23940088,del,HG00334,0,,567
12,60102390,60103947,del,NA18853,0,,1557
12,97951160,97951797,del,HG00625,0,,637
12,38278987,38295905,del,NA19428,0,,16918
12,130876625,130877914,del,NA19732,0,,1289
12,103320593,103320829,del,HG01174,0,,236
12,32452381,32456128,del,NA19445,0,,3747
12,77105591,77114043,del,NA20544,0,,8452
12,127588221,127589749,del,HG00698,0,,1528
12,127443333,127456825,del,NA19332,0,,13492
12,73989516,73999122,del,NA20521,0,,9606
12,132987034,132988592,del,HG00693,0,,1558
12,34490527,34492475,del,HG00525,0,,1948
12,45273168,45283536,del,NA19904,0,,10368
12,9558520,9559255,del,NA19451,0,,735
12,30504387,30508050,del,NA19921,0,,3663
12,49709175,49710524,del,HG00176,0,,1349
12,98974051,98974362,del,HG01051,0,,311
12,127199963,127200311,del,HG01383,0,,348
12,34253808,34264757,del,NA19472,0,,10949
12,128183668,128187035,del,NA20809,0,,3367
12,95344056,95344366,del,NA19383,0,,310
12,128562030,128563744,del,NA19835,0,,1714
12,7858944,7859088,del,NA19114,0,,144
12,61345404,61352411,del,HG00524,0,,7007
12,116689240,116692587,del,NA19819,0,,3347
12,82026458,82028680,del,HG00278,0,,2222
12,38155146,38168069,del,HG00119,0,,12923
12,115893260,115896851,del,NA19350,0,,3591
12,34006061,34634365,del,NA19338,0,,628304
12,11756272,11759326,del,HG01191,0,,3054
12,38032783,38034317,del,NA19398,0,,1534
12,51598010,51598149,del,NA12043,0,,139
12,71213555,71214136,del,NA19908,0,,581
12,56875516,56875739,del,NA19901,0,,223
12,61042234,61048777,del,HG00690,0,,6543
12,75099188,75101743,del,NA19056,0,,2555
12,126996385,126999037,del,NA19360,0,,2652
12,129883792,129883932,del,NA19819,0,,140
12,129386170,129389367,del,NA20518,0,,3197
12,102775541,102785783,del,HG00421,0,,10242
12,43438583,43445553,del,HG00189,0,,6970
12,1402566,1402750,del,HG00256,0,,184
12,34845384,34849127,del,NA07051,0,,3743
12,72121163,72121298,del,NA19374,0,,135
12,11175080,11201765,del,HG00362,0,,26685
12,94301755,94317546,del,HG01066,0,,15791
12,9722034,9723028,del,HG01456,0,,994
12,85272559,85273621,del,HG00736,0,,1062
12,14945386,14945508,del,HG01125,0,,122
12,92606011,92607556,del,HG01167,0,,1545
12,9500532,9507187,del,HG00108,0,,6655
12,106694687,106695679,del,NA19904,0,,992
12,133073401,133073506,del,HG00479,0,,105
12,33509999,33511048,del,HG00183,0,,1049
12,68023817,68025804,del,NA12383,0,,1987
12,17740954,17741223,del,HG01080,0,,269
12,31152431,31152978,del,HG00593,0,,547
12,15425234,15448401,del,NA20778,0,,23167
12,15456162,15461161,del,HG00614,0,,4999
12,30310711,30311040,del,HG00310,0,,329
12,34256034,34267094,del,HG00369,0,,11060
12,80823356,80828244,del,NA18596,0,,4888
12,128004167,128004465,del,NA19701,0,,298
12,66958880,66970927,del,NA12716,0,,12047
12,11171844,11227497,del,NA18961,0,,55653
12,133049491,133050517,del,HG01075,0,,1026
12,50973716,50975516,del,NA18945,0,,1800
12,34791924,34807854,del,HG00183,0,,15930
12,2017891,2018055,del,NA18562,0,,164
12,46467977,46483973,del,NA18610,0,,15996
12,121602430,121605237,del,HG01350,0,,2807
12,74104878,74105333,del,NA19435,0,,455
12,128568316,128570322,del,HG00596,0,,2006
12,30744545,30746239,del,HG01048,0,,1694
12,69629974,69630297,del,HG00319,0,,323
12,99793816,99801322,del,NA20775,0,,7506
12,75419814,75421043,del,NA12045,0,,1229
12,40277872,40280906,del,HG00708,0,,3034
12,131024176,131024481,del,HG00610,0,,305
12,25263989,25267874,del,HG01134,0,,3885
12,128429410,128431520,del,NA19395,0,,2110
12,49842073,49847766,del,NA19384,0,,5693
12,34548450,34548822,del,HG00369,0,,372
12,147081,151800,dup,HG00130,0,,4719
12,177787,187378,dup,HG00096,0,,9591
12,186269,213313,dup,NA19731,0,,27044
12,223587,341969,dup,HG00593,0,,118382
12,224814,271595,dup,NA19731,0,,46781
12,266463,360671,dup,HG00593,0,,94208
12,433339,455690,dup,NA18522,0,,22351
12,461367,516543,dup,HG02140,0,,55176
12,521249,567046,dup,HG02140,0,,45797
12,526518,671005,dup,HG03836,0,,144487
12,556255,579495,dup,HG02140,0,,23240
12,577373,594523,dup,HG03193,0,,17150
12,589652,613181,dup,HG02140,0,,23529
12,623073,680246,dup,HG02140,0,,57173
12,689771,729439,dup,HG02140,0,,39668
12,771546,782995,dup,HG00759,0,,11449
12,780999,796504,dup,HG00759,0,,15505
12,811155,823480,dup,HG02140,0,,12325
12,828083,847446,dup,HG02140,0,,19363
12,868378,874490,dup,HG00102,0,,6112
12,886071,967457,dup,HG00537,0,,81386
12,895373,974285,dup,HG00452,0,,78912
12,975486,989939,dup,HG00452,0,,14453
12,989440,1047462,dup,HG00452,0,,58022
12,1054871,1251104,dup,HG00452,0,,196233
12,1256087,1350740,dup,HG00452,0,,94653
12,1304098,1351677,dup,HG00452,0,,47579
12,1516142,1595078,dup,NA20876,0,,78936
12,1554930,1578776,dup,NA20876,0,,23846
12,1948573,1986432,dup,NA19435,0,,37859
12,2794747,2852533,dup,HG02489,0,,57786
12,2794791,2851129,dup,HG00150,0,,56338
12,2794940,2846277,dup,HG02489,0,,51337
12,2905507,3011952,dup,HG02143,0,,106445
12,2906074,2946337,dup,HG02143,0,,40263
12,2998120,3059693,dup,HG02143,0,,61573
12,3050861,3114017,dup,HG02143,0,,63156
12,3065852,3080285,dup,HG02143,0,,14433
12,3075054,3112725,dup,HG02143,0,,37671
12,3660084,3704139,dup,HG03120,0,,44055
12,3660424,3706906,dup,HG00623,0,,46482
12,3660489,3697647,dup,HG03120,0,,37158
12,4855256,4874453,dup,HG00766,0,,19197
12,4869011,4874274,dup,HG00766,0,,5263
12,4987621,5023126,dup,HG03869,0,,35505
12,5025046,5028075,dup,HG01595,0,,3029
12,5392262,5402409,dup,HG00182,0,,10147
12,6543017,6574397,dup,NA19172,0,,31380
12,6646212,6653781,dup,HG01702,0,,7569
12,7601229,7607575,dup,HG01863,0,,6346
12,7918225,7924651,dup,HG00610,0,,6426
12,7936292,7946492,dup,NA11918,0,,10200
12,7978736,7998090,dup,HG01047,0,,19354
12,8000122,8216726,dup,HG00260,0,,216604
12,8003256,8024985,dup,HG00260,0,,21729
12,8069303,8083308,dup,HG00260,0,,14005
12,8092314,8103253,dup,HG00260,0,,10939
12,8109082,8117587,dup,HG00260,0,,8505
12,8143531,8154399,dup,HG02367,0,,10868
12,8185676,8208371,dup,HG02367,0,,22695
12,8360756,8389845,dup,HG00101,0,,29089
12,8538977,8546383,dup,HG00277,0,,7406
12,8940166,8947674,dup,HG00109,0,,7508
12,9453856,9465440,dup,NA18966,0,,11584
12,9571703,9583302,dup,HG01049,0,,11599
12,9588262,9623059,dup,NA19401,0,,34797
12,9756845,9763905,dup,NA12413,0,,7060
12,9868055,9899379,dup,HG03755,0,,31324
12,10295925,10332128,dup,NA20320,0,,36203
12,10581418,10586833,dup,HG00102,0,,5415
12,10872985,11033811,dup,HG01256,0,,160826
12,10874860,10910331,dup,HG01256,0,,35471
12,11137059,11141895,dup,HG01988,0,,4836
12,11192464,11210849,dup,HG02061,0,,18385
12,11222191,11249671,dup,HG00096,0,,27480
12,11455522,11480273,dup,HG01063,0,,24751
12,11484364,11506531,dup,HG02493,0,,22167
12,11515723,11544432,dup,HG00105,0,,28709
12,11554028,11565771,dup,NA20520,0,,11743
12,11719160,11733765,dup,NA20757,0,,14605
12,11787726,11798344,dup,HG01501,0,,10618
12,12135134,12147362,dup,NA12828,0,,12228
12,12306143,12311042,dup,HG03803,0,,4899
12,12658442,12673935,dup,HG03442,0,,15493
12,13068712,13080944,dup,HG03714,0,,12232
12,15132272,15143389,dup,HG01702,0,,11117
12,17174630,17245667,dup,HG03800,0,,71037
12,17177234,17225042,dup,HG03800,0,,47808
12,17381463,17439237,dup,HG01991,0,,57774
12,17956430,17965424,dup,HG00101,0,,8994
12,19088102,19123160,dup,HG04156,0,,35058
12,19103397,19151364,dup,HG04156,0,,47967
12,19126843,19179990,dup,HG04156,0,,53147
12,19458890,19463255,dup,HG03212,0,,4365
12,19467503,19487332,dup,HG00743,0,,19829
12,19467987,19584284,dup,HG01104,0,,116297
12,19496230,19505242,dup,HG00743,0,,9012
12,19522558,19544156,dup,HG00743,0,,21598
12,19746915,19763553,dup,NA20852,0,,16638
12,20639008,20670585,dup,HG01985,0,,31577
12,20639956,20668518,dup,HG01985,0,,28562
12,20844553,20887103,dup,HG03007,0,,42550
12,20983701,21032319,dup,HG00759,0,,48618
12,21069193,21486864,dup,HG01531,0,,417671
12,21574535,21616836,dup,HG01435,0,,42301
12,21816721,21845577,dup,NA11893,0,,28856
12,22098423,22105872,dup,HG03890,0,,7449
12,22179899,22195304,dup,HG00583,0,,15405
12,22517683,22556339,dup,HG03235,0,,38656
12,23153644,23157643,dup,HG01085,0,,3999
12,23594057,23619638,dup,HG00766,0,,25581
12,24370402,24377701,dup,HG02697,0,,7299
12,24541622,24579069,dup,HG03765,0,,37447
12,25093204,25133309,dup,NA12045,0,,40105
12,25633776,25637253,dup,HG01064,0,,3477
12,27305560,27416532,dup,NA19717,0,,110972
12,27320542,27457164,dup,NA19717,0,,136622
12,27428927,27556050,dup,NA19717,0,,127123
12,27604283,27784677,dup,NA19717,0,,180394
12,27648174,27655202,dup,HG00099,0,,7028
12,27654603,27695962,dup,NA19717,0,,41359
12,28697569,28747736,dup,HG03649,0,,50167
12,28957970,28969747,dup,HG01357,0,,11777
12,28999893,29019335,dup,HG01871,0,,19442
12,29077969,29121573,dup,HG03117,0,,43604
12,29161653,29164673,dup,HG00102,0,,3020
12,29205179,29226560,dup,HG00329,0,,21381
12,29980595,29991364,dup,HG01781,0,,10769
12,30317282,30386255,dup,HG03578,0,,68973
12,30389254,30415201,dup,HG03578,0,,25947
12,30390878,30420692,dup,NA20318,0,,29814
12,31101322,31127185,dup,NA19374,0,,25863
12,31265759,31407880,dup,HG00097,0,,142121
12,31355615,31417662,dup,HG00120,0,,62047
12,31721189,31729549,dup,HG03604,0,,8360
12,31792399,31800350,dup,NA12155,0,,7951
12,32001888,32044390,dup,HG00105,0,,42502
12,32572407,32602791,dup,HG02464,0,,30384
12,32573463,32606760,dup,HG00623,0,,33297
12,32798860,32802662,dup,HG01890,0,,3802
12,33324243,33328742,dup,HG02536,0,,4499
12,33400931,33423789,dup,HG01507,0,,22858
12,33422144,33504413,dup,HG04162,0,,82269
12,33427568,33500792,dup,HG04029,0,,73224
12,33504414,33577843,dup,HG02721,0,,73429
12,33518071,33578857,dup,HG02721,0,,60786
12,33570727,33863436,dup,HG02398,0,,292709
12,33572934,33590466,dup,HG02398,0,,17532
12,33871454,33956744,dup,NA07357,0,,85290
12,33960036,34022652,dup,HG02069,0,,62616
12,33971463,34042366,dup,HG02069,0,,70903
12,34036473,34102523,dup,HG00759,0,,66050
12,34056794,34162522,dup,HG02069,0,,105728
12,34098927,34108938,dup,HG01241,0,,10011
12,34109998,34200683,dup,HG02069,0,,90685
12,34207531,34216771,dup,HG00742,0,,9240
12,34227037,34253318,dup,HG02069,0,,26281
12,34248438,34262760,dup,HG00346,0,,14322
12,34264868,34315217,dup,HG02069,0,,50349
12,34311449,34353521,dup,HG02069,0,,42072
12,34384934,34402538,dup,HG02069,0,,17604
12,34406361,34412651,dup,HG02439,0,,6290
12,34409897,34431935,dup,HG02069,0,,22038
12,37872349,37948412,dup,HG01599,0,,76063
12,37966291,37979521,dup,HG01599,0,,13230
12,38422853,38491325,dup,HG00318,0,,68472
12,38558033,38614543,dup,HG00318,0,,56510
12,38603768,38654931,dup,HG00318,0,,51163
12,38681926,38758571,dup,HG00318,0,,76645
12,38759834,38934995,dup,HG03081,0,,175161
12,38798113,38803684,dup,HG01577,0,,5571
12,38832507,38927367,dup,HG00318,0,,94860
12,38943924,38954520,dup,HG03081,0,,10596
12,38956382,38968706,dup,HG03695,0,,12324
12,38968007,38974780,dup,HG00171,0,,6773
12,39455655,39482265,dup,NA18505,0,,26610
12,39457903,39474468,dup,NA18505,0,,16565
12,39539508,39596286,dup,HG02943,0,,56778
12,39554445,39586992,dup,HG02943,0,,32547
12,39680761,39698796,dup,HG01853,0,,18035
12,39846971,39853289,dup,HG00620,0,,6318
12,40042723,40147030,dup,HG03826,0,,104307
12,40817484,40821567,dup,HG01272,0,,4083
12,41780697,41821115,dup,HG01844,0,,40418
12,42071359,42098721,dup,HG00115,0,,27362
12,42363174,42378579,dup,NA12348,0,,15405
12,43167719,43178915,dup,HG00360,0,,11196
12,43976111,43995409,dup,HG03202,0,,19298
12,44675650,44685980,dup,HG03900,0,,10330
12,45329420,45348139,dup,HG01953,0,,18719
12,45350784,45372756,dup,NA19749,0,,21972
12,45776605,45788955,dup,HG03629,0,,12350
12,47028610,47033309,dup,HG00409,0,,4699
12,48536734,48672282,dup,NA18563,0,,135548
12,48660642,48720345,dup,HG00599,0,,59703
12,48672233,48701215,dup,HG00599,0,,28982
12,48713990,48758474,dup,NA18563,0,,44484
12,49675433,49692162,dup,HG00255,0,,16729
12,49675487,49691462,dup,HG00243,0,,15975
12,50767280,50784684,dup,NA18948,0,,17404
12,50878105,50881928,dup,HG01870,0,,3823
12,51434719,51460229,dup,NA18867,0,,25510
12,51665294,51673526,dup,HG01372,0,,8232
12,51793489,51803540,dup,HG02286,0,,10051
12,51918773,51946224,dup,NA19719,0,,27451
12,52033512,52044563,dup,HG01668,0,,11051
12,53081854,53229464,dup,HG00403,0,,147610
12,55725599,55738035,dup,HG03844,0,,12436
12,55917477,55924780,dup,HG01462,0,,7303
12,56050229,56062085,dup,HG02799,0,,11856
12,56062036,56069863,dup,HG03910,0,,7827
12,57243523,57248459,dup,NA18981,0,,4936
12,57258242,57277386,dup,HG01610,0,,19144
12,57333947,57382632,dup,HG01536,0,,48685
12,58486956,58505318,dup,NA18934,0,,18362
12,59657908,59796662,dup,NA19027,0,,138754
12,59668333,59709688,dup,NA19027,0,,41355
12,59707043,59717411,dup,NA19027,0,,10368
12,59720916,59765426,dup,NA19027,0,,44510
12,59811761,60004241,dup,NA19027,0,,192480
12,59838192,59848753,dup,NA19027,0,,10561
12,59856416,59921329,dup,NA19027,0,,64913
12,59949236,60003050,dup,NA19027,0,,53814
12,60855263,60969547,dup,NA21112,0,,114284
12,61402852,61425433,dup,HG01882,0,,22581
12,61430199,61448892,dup,NA19024,0,,18693
12,61446861,61538800,dup,NA20544,0,,91939
12,61458715,61480582,dup,NA20544,0,,21867
12,61522754,61603944,dup,HG02322,0,,81190
12,61602046,61617652,dup,NA20317,0,,15606
12,61606228,61620454,dup,NA20318,0,,14226
12,62832763,62836504,dup,HG02731,0,,3741
12,63812336,63825376,dup,HG01029,0,,13040
12,63939158,64117235,dup,HG03716,0,,178077
12,64399335,64406084,dup,HG02461,0,,6749
12,64694280,64719500,dup,NA20339,0,,25220
12,66524454,66555470,dup,HG03888,0,,31016
12,66671717,66701902,dup,NA18749,0,,30185
12,66863291,66909803,dup,HG03644,0,,46512
12,67515269,67594953,dup,HG03595,0,,79684
12,67656747,67750887,dup,HG01522,0,,94140
12,67825010,67987464,dup,HG03520,0,,162454
12,67871466,67902191,dup,HG03520,0,,30725
12,68124203,68206040,dup,NA19056,0,,81837
12,68716141,68719703,dup,HG03009,0,,3562
12,69005732,69017054,dup,HG01815,0,,11322
12,69270547,69276160,dup,HG03006,0,,5613
12,70509540,70519699,dup,HG00275,0,,10159
12,70627064,70646629,dup,HG00651,0,,19565
12,71497481,71511742,dup,HG00592,0,,14261
12,72176805,72283578,dup,NA18591,0,,106773
12,72825352,72842809,dup,HG02325,0,,17457
12,73131945,73240987,dup,NA20888,0,,109042
12,73425108,73447873,dup,NA19374,0,,22765
12,73684340,73704821,dup,HG04093,0,,20481
12,73810891,74095489,dup,HG02113,0,,284598
12,74260975,74307628,dup,NA18534,0,,46653
12,74261366,74331459,dup,HG03271,0,,70093
12,74312352,74324542,dup,HG03271,0,,12190
12,74408150,74466363,dup,HG03817,0,,58213
12,75737128,75769819,dup,NA19236,0,,32691
12,76379758,76391792,dup,HG03963,0,,12034
12,76494811,76499472,dup,HG03199,0,,4661
12,76513925,76643491,dup,NA20127,0,,129566
12,76523299,76606514,dup,NA20127,0,,83215
12,76601927,76619304,dup,HG01200,0,,17377
12,76642138,76679688,dup,HG01200,0,,37550
12,77863428,78042452,dup,HG03433,0,,179024
12,79270193,79352033,dup,HG02675,0,,81840
12,79459598,79630720,dup,HG01599,0,,171122
12,79700286,79717070,dup,HG03851,0,,16784
12,80153371,80162648,dup,HG03668,0,,9277
12,80286430,80311946,dup,NA19315,0,,25516
12,80479003,80544309,dup,HG00593,0,,65306
12,80805017,80814516,dup,HG01398,0,,9499
12,80812767,80821089,dup,HG01398,0,,8322
12,80823090,80828286,dup,HG00478,0,,5196
12,80832246,80859151,dup,HG01398,0,,26905
12,80853609,80870080,dup,HG03689,0,,16471
12,80875312,80910329,dup,HG01398,0,,35017
12,80955374,81010522,dup,HG02271,0,,55148
12,81406297,81456636,dup,HG02537,0,,50339
12,81732513,81788513,dup,HG02537,0,,56000
12,82536285,82561974,dup,NA20504,0,,25689
12,82703610,82721371,dup,NA18965,0,,17761
12,82719557,82724982,dup,HG02661,0,,5425
12,83400090,83416407,dup,HG02012,0,,16317
12,83627055,83647972,dup,HG02979,0,,20917
12,83999911,84008303,dup,HG01583,0,,8392
12,84004754,84014905,dup,HG01583,0,,10151
12,84026275,84195588,dup,NA12058,0,,169313
12,84026755,84264603,dup,NA12058,0,,237848
12,84256133,84337933,dup,NA19475,0,,81800
12,84256233,84303772,dup,NA19475,0,,47539
12,84350273,84456793,dup,NA19475,0,,106520
12,84463346,84619866,dup,NA19475,0,,156520
12,84476453,84540185,dup,NA19475,0,,63732
12,84653589,84860266,dup,NA19475,0,,206677
12,85036102,85040751,dup,HG00126,0,,4649
12,85403933,85475061,dup,HG01624,0,,71128
12,85406792,85435901,dup,HG01624,0,,29109
12,85433202,85441703,dup,HG01624,0,,8501
12,85441079,85483553,dup,HG01624,0,,42474
12,85498992,85514115,dup,HG01624,0,,15123
12,85860962,85864656,dup,HG01840,0,,3694
12,85917115,85982210,dup,HG00157,0,,65095
12,86435093,86441693,dup,HG03039,0,,6600
12,87106690,87173848,dup,HG03809,0,,67158
12,87110567,87124247,dup,HG01402,0,,13680
12,87134453,87162012,dup,HG03809,0,,27559
12,87315649,87402731,dup,HG01985,0,,87082
12,87463010,87499478,dup,HG03689,0,,36468
12,87721086,87732307,dup,HG00598,0,,11221
12,87939423,87973466,dup,HG03986,0,,34043
12,88208205,88220910,dup,HG03991,0,,12705
12,88768973,88815636,dup,HG01168,0,,46663
12,90466902,90481985,dup,HG03572,0,,15083
12,91906229,91955069,dup,NA19031,0,,48840
12,92305718,92328854,dup,HG00259,0,,23136
12,92380073,92424731,dup,NA19355,0,,44658
12,92479929,92505385,dup,NA19355,0,,25456
12,92510322,92533525,dup,HG01896,0,,23203
12,92567804,92590480,dup,NA19355,0,,22676
12,93343432,93349666,dup,HG00406,0,,6234
12,93645034,93653699,dup,HG01971,0,,8665
12,93844273,93848089,dup,HG00106,0,,3816
12,94293202,94321123,dup,HG01066,0,,27921
12,94313945,94363418,dup,HG00266,0,,49473
12,94328049,94363005,dup,HG03691,0,,34956
12,95246826,95260651,dup,HG00742,0,,13825
12,95542001,95572800,dup,HG03297,0,,30799
12,96264306,96291086,dup,HG01176,0,,26780
12,96265171,96309832,dup,HG01176,0,,44661
12,96295068,96305895,dup,HG02687,0,,10827
12,96384630,96409994,dup,HG00335,0,,25364
12,97023679,97072737,dup,HG03914,0,,49058
12,97413675,97432451,dup,HG01253,0,,18776
12,98225000,98266135,dup,HG03809,0,,41135
12,98225406,98247610,dup,HG03809,0,,22204
12,98252069,98259560,dup,HG03809,0,,7491
12,98395858,98413497,dup,HG00174,0,,17639
12,98440926,98445826,dup,HG01102,0,,4900
12,98581833,98598208,dup,HG02142,0,,16375
12,98688776,98727757,dup,HG03771,0,,38981
12,98691067,98753650,dup,HG03771,0,,62583
12,98691552,98753065,dup,HG01357,0,,61513
12,99445096,99515661,dup,HG01086,0,,70565
12,99459494,99521968,dup,HG01086,0,,62474
12,99521382,99695654,dup,HG01086,0,,174272
12,100065017,100127593,dup,NA20287,0,,62576
12,100102773,100152684,dup,NA21111,0,,49911
12,100278022,100465014,dup,HG00173,0,,186992
12,100609456,100636066,dup,HG02308,0,,26610
12,101286799,101290273,dup,HG02554,0,,3474
12,101835043,101839891,dup,HG00422,0,,4848
12,101841547,101860054,dup,NA19681,0,,18507
12,102434608,102449985,dup,HG02652,0,,15377
12,102955970,102980586,dup,NA19350,0,,24616
12,103071196,103104379,dup,NA20827,0,,33183
12,103072928,103099918,dup,NA20827,0,,26990
12,103688885,103701390,dup,HG03960,0,,12505
12,103780528,103823848,dup,HG00115,0,,43320
12,104079827,104093859,dup,HG03195,0,,14032
12,104332106,104336635,dup,HG01431,0,,4529
12,104558148,104578777,dup,NA18645,0,,20629
12,104589865,104599528,dup,HG01976,0,,9663
12,104597022,104644702,dup,HG01976,0,,47680
12,104610218,104620960,dup,HG01976,0,,10742
12,104641125,104737678,dup,NA18645,0,,96553
12,104744790,104753987,dup,HG02792,0,,9197
12,104758063,104766670,dup,HG02522,0,,8607
12,104775810,104805955,dup,NA18645,0,,30145
12,105181620,105198677,dup,HG01259,0,,17057
12,105181620,105210924,dup,HG00160,0,,29304
12,105192366,105210924,dup,HG01259,0,,18558
12,105941259,105944507,dup,HG00458,0,,3248
12,107943941,107962454,dup,HG03611,0,,18513
12,108342319,108357264,dup,HG03890,0,,14945
12,109298352,109308563,dup,HG01392,0,,10211
12,109922814,110138659,dup,HG00623,0,,215845
12,110023078,110049218,dup,HG01804,0,,26140
12,110023459,110041271,dup,HG01804,0,,17812
12,110683318,110695713,dup,HG02141,0,,12395
12,111136224,111146473,dup,HG01879,0,,10249
12,111227626,111238360,dup,HG01956,0,,10734
12,111286859,111418188,dup,HG03469,0,,131329
12,112117221,112169121,dup,HG02816,0,,51900
12,112121972,112134629,dup,HG02816,0,,12657
12,112180758,112315743,dup,HG00133,0,,134985
12,112181539,112281304,dup,HG00133,0,,99765
12,112299473,112310743,dup,HG00133,0,,11270
12,112805209,112815445,dup,HG01092,0,,10236
12,112821379,112832003,dup,HG01092,0,,10624
12,113116446,113134472,dup,HG04061,0,,18026
12,113426508,114276615,dup,HG00623,0,,850107
12,113973948,113979980,dup,HG01302,0,,6032
12,114141894,114158354,dup,HG01392,0,,16460
12,115024963,115044682,dup,HG02108,0,,19719
12,116776981,117252742,dup,HG00623,0,,475761
12,116832978,116872470,dup,HG01991,0,,39492
12,117210659,117214974,dup,HG02661,0,,4315
12,117495162,117782761,dup,HG00623,0,,287599
12,117831498,117836937,dup,HG00137,0,,5439
12,118074075,118088578,dup,NA19062,0,,14503
12,120019461,120049038,dup,HG04183,0,,29577
12,120025454,120078871,dup,HG04183,0,,53417
12,120877766,120888734,dup,HG00160,0,,10968
12,121500914,121595375,dup,HG00360,0,,94461
12,121504730,121580178,dup,NA18625,0,,75448
12,122067498,122082033,dup,HG02546,0,,14535
12,122417571,122430103,dup,HG01855,0,,12532
12,122748410,122758684,dup,HG00096,0,,10274
12,122953930,122960482,dup,HG03886,0,,6552
12,123185580,123198603,dup,HG00329,0,,13023
12,124112990,124195616,dup,HG02219,0,,82626
12,124113006,124197018,dup,HG00623,0,,84012
12,124495947,124500196,dup,HG00097,0,,4249
12,124554106,124687278,dup,HG00266,0,,133172
12,124556564,124597150,dup,HG03388,0,,40586
12,124556747,124689000,dup,HG03388,0,,132253
12,124608637,124614529,dup,HG01761,0,,5892
12,124621178,124682031,dup,HG03388,0,,60853
12,124708209,124717709,dup,HG01101,0,,9500
12,124773247,125234007,dup,HG00623,0,,460760
12,124774314,125032964,dup,NA20529,0,,258650
12,124775241,124834310,dup,HG00619,0,,59069
12,125057301,125117441,dup,NA20529,0,,60140
12,125149633,125231664,dup,NA19031,0,,82031
12,125507329,125518187,dup,HG02395,0,,10858
12,125888215,125920678,dup,HG02780,0,,32463
12,126138526,126147342,dup,HG01606,0,,8816
12,126644057,126716267,dup,HG02181,0,,72210
12,126724988,126924702,dup,HG02181,0,,199714
12,126734366,126873479,dup,HG03916,0,,139113
12,126861515,126939476,dup,HG03916,0,,77961
12,126905747,126994789,dup,HG03916,0,,89042
12,127000155,127116948,dup,HG02429,0,,116793
12,127140068,127312635,dup,HG03916,0,,172567
12,127324515,127420169,dup,HG03916,0,,95654
12,127430503,127812976,dup,HG03916,0,,382473
12,127817403,128009847,dup,HG03916,0,,192444
12,127855872,127859044,dup,HG02282,0,,3172
12,127884064,127926397,dup,HG03916,0,,42333
12,128009348,128156555,dup,NA20828,0,,147207
12,128056558,128067957,dup,HG01107,0,,11399
12,128193320,128268919,dup,HG01628,0,,75599
12,128286974,128367846,dup,NA20828,0,,80872
12,128381865,128518731,dup,NA20828,0,,136866
12,128573068,128759803,dup,NA20828,0,,186735
12,129121198,129133926,dup,HG00351,0,,12728
12,129154811,129200756,dup,HG01894,0,,45945
12,129202582,129210637,dup,HG01124,0,,8055
12,129220201,129253919,dup,HG01894,0,,33718
12,129224421,129267529,dup,HG00623,0,,43108
12,129226320,129274333,dup,NA12400,0,,48013
12,129277872,129338460,dup,HG01894,0,,60588
12,129340287,129385617,dup,HG01894,0,,45330
12,129393888,129671876,dup,HG01894,0,,277988
12,129522014,129547632,dup,HG02546,0,,25618
12,129667746,129734199,dup,HG04029,0,,66453
12,129755826,129758849,dup,HG00553,0,,3023
12,130008238,130256986,dup,HG00183,0,,248748
12,130402334,130582861,dup,HG00128,0,,180527
12,130562770,130578375,dup,HG03619,0,,15605
12,130573772,130593605,dup,NA19431,0,,19833
12,130860279,131092219,dup,HG00237,0,,231940
12,130981985,131074740,dup,NA18593,0,,92755
12,130983714,131065967,dup,NA20809,0,,82253
12,131067868,131081818,dup,NA19189,0,,13950
12,131489660,131670477,dup,HG01985,0,,180817
12,131493654,131515712,dup,HG01985,0,,22058
12,131554989,131588344,dup,NA18915,0,,33355
12,131584201,131596265,dup,HG01985,0,,12064
12,131590345,131629415,dup,HG01518,0,,39070
12,131625516,131660426,dup,HG01518,0,,34910
12,131626338,131842208,dup,HG01518,0,,215870
12,131683278,131733569,dup,NA19777,0,,50291
12,131730193,131771063,dup,HG00344,0,,40870
12,131792603,131797314,dup,HG00344,0,,4711
12,131794728,131869230,dup,HG01518,0,,74502
12,131797677,131817211,dup,HG00344,0,,19534
12,131837306,131875360,dup,HG01985,0,,38054
12,131868085,131883091,dup,NA18537,0,,15006
12,131896506,131952303,dup,NA18522,0,,55797
12,131961124,131978744,dup,NA19777,0,,17620
12,131961199,132096512,dup,NA19777,0,,135313
12,131985642,132010336,dup,NA19777,0,,24694
12,132023158,132044308,dup,NA19777,0,,21150
12,132041271,132070347,dup,NA19777,0,,29076
12,132059878,132089418,dup,NA19777,0,,29540
12,132100845,132130003,dup,HG00593,0,,29158
12,132153039,132168717,dup,HG01851,0,,15678
12,132182383,132207955,dup,NA18537,0,,25572
12,132223156,132246206,dup,NA18537,0,,23050
12,132393647,132432079,dup,HG04182,0,,38432
12,132399735,132550284,dup,HG04182,0,,150549
12,132439918,132518670,dup,HG04182,0,,78752
12,132535769,132547919,dup,HG04182,0,,12150
12,132675254,132690452,dup,HG03947,0,,15198
12,132865096,132874284,dup,HG02060,0,,9188
12,132878388,132888722,dup,HG00384,0,,10334
12,132886473,132898164,dup,HG00628,0,,11691
12,132981410,132992831,dup,HG00383,0,,11421
12,133103075,133113241,dup,HG00130,0,,10166
12,133142386,133172848,dup,NA12272,0,,30462
12,133143643,133176721,dup,HG00099,0,,33078
12,133247492,133262604,dup,HG01360,0,,15112
12,133264628,133285370,dup,NA18934,0,,20742
12,133289727,133314530,dup,HG00628,0,,24803
12,133311724,133371074,dup,HG01360,0,,59350
12,133319157,133331211,dup,HG01360,0,,12054
12,133341372,133348052,dup,HG04131,0,,6680
12,133348121,133372953,dup,HG04131,0,,24832
12,133381575,133417472,dup,NA20503,0,,35897
12,133494602,133537098,dup,HG00657,0,,42496
12,133636164,133758072,dup,NA18523,0,,121908
12,133675549,133702415,dup,HG00108,0,,26866
12,133711407,133737269,dup,HG00108,0,,25862
12,133730975,133754417,dup,HG00108,0,,23442
12,133756277,133800881,dup,HG01805,0,,44604
12,133792329,133819361,dup,NA19238,0,,27032
13,71123959,71124509,del,HG01133,0,,550
13,45755064,45759555,del,NA19385,0,,4491
13,84629258,84698129,del,HG01354,0,,68871
13,78455959,78459651,del,NA19390,0,,3692
13,105953686,105956460,del,NA20775,0,,2774
13,69446821,69449858,del,HG00326,0,,3037
13,30985683,30986934,del,NA18486,0,,1251
13,38071940,38085577,del,NA20819,0,,13637
13,106705799,106718231,del,HG01462,0,,12432
13,29722594,29722914,del,HG01048,0,,320
13,82693731,82694975,del,NA19190,0,,1244
13,71068989,71088800,del,NA19908,0,,19811
13,27049516,27052022,del,NA19789,0,,2506
13,92857572,92860117,del,NA19082,0,,2545
13,113454514,113456623,del,HG00707,0,,2109
13,114219490,114219797,del,NA18501,0,,307
13,80816016,80816522,del,HG01148,0,,506
13,28273271,28273830,del,NA19725,0,,559
13,99293018,99294863,del,NA19379,0,,1845
13,57706716,57713222,del,NA18549,0,,6506
13,86579416,86580268,del,NA20544,0,,852
13,62654839,62657562,del,NA07000,0,,2723
13,87451422,87453549,del,NA19119,0,,2127
13,45396136,45397125,del,NA19440,0,,989
13,30781667,30784613,del,HG01095,0,,2946
13,54234770,54240251,del,NA11831,0,,5481
13,31529153,31543634,del,NA19012,0,,14481
13,98896547,98898520,del,NA19904,0,,1973
13,84530583,84602422,del,HG01354,0,,71839
13,68397304,68397955,del,HG00346,0,,651
13,69199259,69202982,del,HG01083,0,,3723
13,34132799,34138912,del,NA19236,0,,6113
13,20459948,20471174,del,NA19909,0,,11226
13,85800411,85803390,del,NA19087,0,,2979
13,33575750,33576748,del,NA19072,0,,998
13,50513118,50514888,del,HG00740,0,,1770
13,64412986,64414560,del,NA12341,0,,1574
13,74357260,74360259,del,NA20588,0,,2999
13,109794704,109796048,del,NA19385,0,,1344
13,67336012,67341405,del,NA19819,0,,5393
13,46906887,46907036,del,NA18486,0,,149
13,57944742,57951681,del,HG00651,0,,6939
13,110434116,110437622,del,HG00329,0,,3506
13,95985044,95997834,del,NA19449,0,,12790
13,68876817,68877375,del,HG01171,0,,558
13,108146381,108146567,del,NA19240,0,,186
13,41271111,41271423,del,HG00331,0,,312
13,35355297,35357642,del,NA19440,0,,2345
13,20690156,20705850,del,NA19452,0,,15694
13,71994765,72003364,del,HG00179,0,,8599
13,37245901,37246780,del,HG00543,0,,879
13,34390308,34390662,del,NA18916,0,,354
13,24426319,24432141,del,NA18574,0,,5822
13,19774525,20276067,del,HG01360,0,,501542
13,85182906,85193655,del,NA19057,0,,10749
13,51760755,51760872,del,NA18948,0,,117
13,108773921,108774745,del,HG00159,0,,824
13,60172490,60172823,del,NA19394,0,,333
13,92641008,92641352,del,HG00331,0,,344
13,92387266,92391372,del,NA19374,0,,4106
13,53098116,53112022,del,HG00274,0,,13906
13,108946816,108952722,del,NA19455,0,,5906
13,60786161,60786488,del,NA20504,0,,327
13,99686983,99688623,del,HG01066,0,,1640
13,72893649,72898441,del,HG00140,0,,4792
13,21697194,21697405,del,NA19005,0,,211
13,56366307,56366503,del,HG00143,0,,196
13,114885548,114885880,del,HG00584,0,,332
13,80681060,80686346,del,HG01378,0,,5286
13,36337306,36337307,del,HG00476,0,,1
13,47689476,47689790,del,HG00628,0,,314
13,84176411,84262043,del,NA18561,0,,85632
13,93009237,93018908,del,NA19107,0,,9671
13,26770647,26773382,del,NA19318,0,,2735
13,49309055,49312040,del,NA19908,0,,2985
13,85929515,85929693,del,NA18950,0,,178
13,83788224,83792577,del,NA19311,0,,4353
13,112869088,112869637,del,HG00281,0,,549
13,70401966,70406788,del,NA11830,0,,4822
13,55953639,55959512,del,HG00180,0,,5873
13,72477264,72480576,del,NA19468,0,,3312
13,104983195,104989875,del,NA18632,0,,6680
13,69737962,69741905,del,HG01061,0,,3943
13,102886569,102886838,del,HG00472,0,,269
13,25671983,25673219,del,NA20811,0,,1236
13,47038244,47039808,del,HG00111,0,,1564
13,24292902,24385283,del,NA18559,0,,92381
13,48491765,48496040,del,NA18502,0,,4275
13,40028469,40028791,del,NA19761,0,,322
13,83557602,83564036,del,NA19704,0,,6434
13,78116832,78120678,del,HG01067,0,,3846
13,101906943,101907262,del,HG01066,0,,319
13,64311711,64313253,del,NA18868,0,,1542
13,55634087,55634227,del,HG01366,0,,140
13,96952335,96958201,del,NA19449,0,,5866
13,23632497,23637302,del,HG00330,0,,4805
13,19201866,19204722,del,NA20754,0,,2856
13,57445399,57449169,del,HG00346,0,,3770
13,27084642,27085251,del,HG01149,0,,609
13,104091764,104092246,del,NA18968,0,,482
13,72522652,72525116,del,NA18909,0,,2464
13,24930129,24930676,del,NA19985,0,,547
13,93056847,93057422,del,NA19453,0,,575
13,63283516,63293161,del,HG00635,0,,9645
13,25928937,25942030,del,NA19625,0,,13093
13,45788857,45789111,del,NA18550,0,,254
13,32571925,32573153,del,HG00126,0,,1228
13,83165934,83172205,del,NA18577,0,,6271
13,67397416,67399922,del,HG00320,0,,2506
13,65183132,65196525,del,NA19012,0,,13393
13,110417935,110419164,del,HG00157,0,,1229
13,23559520,23560590,del,NA18548,0,,1070
13,21494532,21495260,del,HG00127,0,,728
13,71417516,71432522,del,NA18567,0,,15006
13,105273249,105273630,del,NA18505,0,,381
13,22929134,22933281,del,HG00537,0,,4147
13,76363160,76367972,del,NA19909,0,,4812
13,78594150,78594474,del,NA18972,0,,324
13,90248610,90249577,del,NA18908,0,,967
13,111978625,111978931,del,NA18973,0,,306
13,23630816,23637522,del,HG01197,0,,6706
13,28508416,28510422,del,HG00403,0,,2006
13,112093756,112093879,del,NA12154,0,,123
13,39379285,39383416,del,NA19072,0,,4131
13,38054369,38055815,del,NA19625,0,,1446
13,59706142,59706507,del,HG00160,0,,365
13,68977867,68978191,del,NA19316,0,,324
13,40432637,40439472,del,NA19381,0,,6835
13,19330793,19350084,del,NA20797,0,,19291
13,42642393,42647677,del,NA19172,0,,5284
13,107520840,107525341,del,NA19084,0,,4501
13,103687348,103688863,del,NA19435,0,,1515
13,35694799,35694961,del,NA19197,0,,162
13,78852369,78855952,del,NA18486,0,,3583
13,48072881,48073204,del,NA19770,0,,323
13,95003330,95004664,del,NA19399,0,,1334
13,58142114,58150538,del,NA18627,0,,8424
13,67133804,67134598,del,NA19455,0,,794
13,111134075,111134239,del,NA19360,0,,164
13,50737654,50739596,del,HG00421,0,,1942
13,108999946,109005736,del,HG00421,0,,5790
13,23545540,23553553,del,HG00146,0,,8013
13,38425328,38433009,del,NA18853,0,,7681
13,114219652,114220053,del,HG00651,0,,401
13,65352191,65353679,del,HG00118,0,,1488
13,34192591,34193321,del,HG00138,0,,730
13,112832774,112832914,del,HG01051,0,,140
13,45089734,45099302,del,HG00553,0,,9568
13,68936888,68937266,del,NA19985,0,,378
13,113325170,113326256,del,NA19704,0,,1086
13,50579128,50581707,del,NA19703,0,,2579
13,98529919,98533057,del,HG00188,0,,3138
13,54239167,54241689,del,NA12829,0,,2522
13,78454516,78459322,del,NA19247,0,,4806
13,84102133,84158665,del,HG01174,0,,56532
13,61955908,61956094,del,NA19393,0,,186
13,95196975,95201267,del,NA20828,0,,4292
13,55941178,55941468,del,HG01051,0,,290
13,103500923,103501895,del,HG00313,0,,972
13,30131950,30133609,del,NA19758,0,,1659
13,33963204,33966783,del,NA19451,0,,3579
13,47039029,47040197,del,HG00187,0,,1168
13,20198126,20199508,del,HG00557,0,,1382
13,85414724,85419707,del,NA18870,0,,4983
13,69390605,69391680,del,NA18504,0,,1075
13,88963941,88964792,del,HG01079,0,,851
13,114320240,114320458,del,HG00693,0,,218
13,104807535,104810017,del,NA19437,0,,2482
13,45955188,45957206,del,HG01061,0,,2018
13,22281804,22288687,del,NA19468,0,,6883
13,114168865,114168940,del,HG01073,0,,75
13,114882322,114882418,del,NA19394,0,,96
13,113383692,113383751,del,NA19138,0,,59
13,85363498,85370783,del,HG01124,0,,7285
13,108560528,108561485,del,NA19684,0,,957
13,22123693,22129914,del,NA11933,0,,6221
13,54691990,54699843,del,NA18577,0,,7853
13,93462405,93471606,del,NA19920,0,,9201
13,106660695,106667711,del,HG01384,0,,7016
13,92179629,92197467,del,HG00343,0,,17838
13,50976431,50978194,del,NA18596,0,,1763
13,23325558,23327239,del,HG01107,0,,1681
13,45951590,45954376,del,NA19313,0,,2786
13,19332616,19364922,del,HG00329,0,,32306
13,80882588,80884909,del,NA19102,0,,2321
13,81806016,81813522,del,NA19129,0,,7506
13,72026485,72035632,del,NA19712,0,,9147
13,72478160,72481349,del,NA06984,0,,3189
13,19341606,19360928,del,HG00734,0,,19322
13,105390979,105392851,del,NA18856,0,,1872
13,43928426,43928908,del,NA18948,0,,482
13,66454087,66456267,del,NA19663,0,,2180
13,90910924,90914103,del,NA18871,0,,3179
13,96919791,96925953,del,NA19311,0,,6162
13,102657979,102669627,del,NA19000,0,,11648
13,102421152,102459038,del,HG00276,0,,37886
13,106250149,106250300,del,HG00607,0,,151
13,95984375,95994432,del,NA19449,0,,10057
13,111479418,111479616,del,HG00237,0,,198
13,38048431,38049297,del,HG00698,0,,866
13,59086463,59088390,del,NA18615,0,,1927
13,106034600,106034781,del,HG00464,0,,181
13,19341818,19361139,del,HG00269,0,,19321
13,30955812,30958089,del,HG00478,0,,2277
13,65870976,65871131,del,HG00614,0,,155
13,31510655,31514668,del,NA19390,0,,4013
13,82968471,82968722,del,NA19377,0,,251
13,111329771,111330091,del,HG00698,0,,320
13,99235859,99240378,del,HG00262,0,,4519
13,82208912,82211844,del,NA20530,0,,2932
13,45419115,45420184,del,NA18527,0,,1069
13,23631466,23637422,del,HG00152,0,,5956
13,110451706,110464848,del,HG00475,0,,13142
13,97627466,97632692,del,HG01079,0,,5226
13,57865913,57892004,del,NA19900,0,,26091
13,19748086,19748858,del,NA19081,0,,772
13,100129220,100129520,del,HG00543,0,,300
13,89611677,89623727,del,NA19397,0,,12050
13,71169275,71172517,del,HG00272,0,,3242
13,70861673,70861998,del,NA18912,0,,325
13,96788586,96793182,del,NA20778,0,,4596
13,94106503,94106736,del,HG00464,0,,233
13,39949745,39949939,del,NA19395,0,,194
13,67219759,67222504,del,HG00543,0,,2745
13,60441812,60493570,del,NA18595,0,,51758
13,89799814,89842867,del,HG00690,0,,43053
13,43053191,43053835,del,NA18505,0,,644
13,25452870,25453203,del,NA19834,0,,333
13,25999631,25999743,del,NA19371,0,,112
13,22418952,22419854,del,NA19663,0,,902
13,98103891,98108408,del,HG01102,0,,4517
13,23632537,23637206,del,NA12399,0,,4669
13,108800120,108800234,del,HG01048,0,,114
13,110221650,110222424,del,HG00285,0,,774
13,104806766,104810272,del,NA18516,0,,3506
13,27877684,27878610,del,NA18535,0,,926
13,57091179,57091861,del,NA18959,0,,682
13,99623702,99623837,del,HG01125,0,,135
13,31025116,31031122,del,HG00421,0,,6006
13,113938785,113939676,del,NA18566,0,,891
13,98409910,98410408,del,NA19404,0,,498
13,96417958,96420032,del,HG01174,0,,2074
13,103599019,103603541,del,NA19398,0,,4522
13,93075414,93082096,del,HG00589,0,,6682
13,114279374,114280246,del,NA19732,0,,872
13,60881444,60881693,del,HG01465,0,,249
13,114882397,114882622,del,HG01051,0,,225
13,86985184,86994668,del,NA19332,0,,9484
13,84282855,84286484,del,NA19394,0,,3629
13,38476677,38478341,del,NA19076,0,,1664
13,114906059,114907799,del,HG00734,0,,1740
13,113458262,113458594,del,HG00133,0,,332
13,47035066,47042722,del,HG00592,0,,7656
13,49533616,49536322,del,HG01441,0,,2706
13,83209751,83213911,del,NA19982,0,,4160
13,112932446,112943323,del,NA07357,0,,10877
13,112868967,112869751,del,NA18632,0,,784
13,77965878,77973088,del,NA19917,0,,7210
13,21531958,21535627,del,NA19403,0,,3669
13,53522260,53523285,del,HG00155,0,,1025
13,34811550,34815507,del,NA18948,0,,3957
13,112818392,112818925,del,NA20340,0,,533
13,102440248,102443650,del,HG00464,0,,3402
13,101209254,101211552,del,NA18984,0,,2298
13,28531776,28532660,del,NA19428,0,,884
13,97607746,97618305,del,HG00463,0,,10559
13,39378516,39381472,del,NA18548,0,,2956
13,38071916,38086222,del,NA19057,0,,14306
13,70207869,70208093,del,HG00684,0,,224
13,61711867,61718609,del,NA19901,0,,6742
13,104527990,104534145,del,HG00159,0,,6155
13,96012614,96015411,del,NA19065,0,,2797
13,23633966,23637122,del,NA19780,0,,3156
13,65342247,65344430,del,NA06986,0,,2183
13,81359449,81361746,del,HG00512,0,,2297
13,41076832,41081310,del,NA19780,0,,4478
13,62431040,62431189,del,NA18511,0,,149
13,92387116,92394022,del,NA19153,0,,6906
13,24813644,24814254,del,NA19914,0,,610
13,19340516,19358822,del,NA19428,0,,18306
13,114160433,114160693,del,NA19102,0,,260
13,82462079,82462420,del,NA18486,0,,341
13,106226888,106307930,del,NA19783,0,,81042
13,108305418,108305673,del,NA12286,0,,255
13,65637808,65638210,del,HG00154,0,,402
13,53159550,53178045,del,NA19462,0,,18495
13,114214545,114214747,del,NA18923,0,,202
13,28693825,28697252,del,NA18868,0,,3427
13,23124049,23128053,del,HG00556,0,,4004
13,106244616,106245072,del,HG00657,0,,456
13,83801227,83801437,del,NA19315,0,,210
13,69699228,69699710,del,HG00422,0,,482
13,42437322,42437591,del,NA18520,0,,269
13,48376234,48384349,del,HG01488,0,,8115
13,69487606,69488296,del,HG01170,0,,690
13,112113670,112113776,del,HG00263,0,,106
13,70735727,70775448,del,HG00264,0,,39721
13,39108169,39114304,del,NA18619,0,,6135
13,76386557,76386935,del,HG00270,0,,378
13,44569454,44569887,del,NA19064,0,,433
13,63221802,63224278,del,NA19700,0,,2476
13,74479440,74479949,del,NA19436,0,,509
13,32151277,32154394,del,NA19384,0,,3117
13,95893196,95894037,del,HG01383,0,,841
13,78764968,78767836,del,NA20765,0,,2868
13,78966854,78970897,del,HG01374,0,,4043
13,84102366,84158972,del,NA19780,0,,56606
13,95781152,95783009,del,NA19350,0,,1857
13,85712878,85713923,del,NA18867,0,,1045
13,48778652,48785785,del,NA19381,0,,7133
13,114756555,114756753,del,HG00263,0,,198
13,50596829,50596972,del,NA20815,0,,143
13,57787108,57788379,del,NA20756,0,,1271
13,19369647,19376340,del,HG00277,0,,6693
13,83065149,83068494,del,HG01365,0,,3345
13,31703544,31705660,del,NA18953,0,,2116
13,76589496,76591993,del,NA18940,0,,2497
13,30215823,30221844,del,NA19204,0,,6021
13,46620548,46622991,del,HG00264,0,,2443
13,47116996,47117396,del,HG00343,0,,400
13,40118739,40125619,del,NA19469,0,,6880
13,87604552,87605439,del,NA19213,0,,887
13,71416146,71431696,del,NA18595,0,,15550
13,36798658,36802172,del,NA18870,0,,3514
13,49202832,49203554,del,HG00236,0,,722
13,88662250,88683329,del,HG00264,0,,21079
13,67947885,67953738,del,NA19471,0,,5853
13,57977660,57978560,del,NA20812,0,,900
13,63861912,63868444,del,HG00276,0,,6532
13,114135981,114137009,del,NA19904,0,,1028
13,91024137,91027607,del,HG00640,0,,3470
13,71912512,71917226,del,NA12751,0,,4714
13,107700909,107701444,del,HG01075,0,,535
13,43855636,43858497,del,NA20810,0,,2861
13,108444119,108448499,del,NA18577,0,,4380
13,41083188,41085016,del,NA19713,0,,1828
13,73299597,73300305,del,HG00620,0,,708
13,19785411,20292984,del,HG00692,0,,507573
13,67512237,67527812,del,NA12043,0,,15575
13,68971852,68973863,del,HG00590,0,,2011
13,94141320,94143870,del,HG00698,0,,2550
13,114505555,114506635,del,NA19318,0,,1080
13,67174779,67177421,del,HG01198,0,,2642
13,66166816,66167018,del,HG01108,0,,202
13,114990592,114991880,del,NA18559,0,,1288
13,64413125,64414814,del,NA19107,0,,1689
13,79202991,79208498,del,NA18570,0,,5507
13,111148932,111149073,del,HG00331,0,,141
13,94040838,94045557,del,HG00701,0,,4719
13,54899469,54901717,del,NA19057,0,,2248
13,71169284,71172508,del,HG00278,0,,3224
13,68135390,68136543,del,HG00158,0,,1153
13,42003514,42004444,del,HG00530,0,,930
13,20724989,20733704,del,NA18622,0,,8715
13,47754490,47755798,del,HG00689,0,,1308
13,55725127,55725731,del,NA19920,0,,604
13,83580566,83580422,del,HG00159,0,,-144
13,43053310,43053830,del,HG00275,0,,520
13,56242110,56248495,del,HG00252,0,,6385
13,23631766,23639122,del,NA20589,0,,7356
13,69945241,69946229,del,NA18563,0,,988
13,41862040,41873555,del,NA19431,0,,11515
13,21951457,21951801,del,HG01124,0,,344
13,25309491,25309863,del,NA18523,0,,372
13,38388896,38404473,del,NA19835,0,,15577
13,36266933,36270806,del,NA12717,0,,3873
13,23356662,23357507,del,NA18917,0,,845
13,35558630,35564872,del,NA12829,0,,6242
13,93000106,93000324,del,HG00734,0,,218
13,104009854,104010173,del,HG00704,0,,319
13,100505366,100505670,del,NA12275,0,,304
13,58450888,58454564,del,NA19398,0,,3676
13,80998746,81002558,del,NA18612,0,,3812
13,62410886,62414308,del,NA19002,0,,3422
13,110197610,110262737,del,HG00318,0,,65127
13,99306337,99306375,del,NA18582,0,,38
13,56887658,56890140,del,NA18983,0,,2482
13,77461446,77462692,del,NA20798,0,,1246
13,95984186,95994233,del,NA19449,0,,10047
13,34135730,34144821,del,NA18952,0,,9091
13,114031945,114036364,del,NA18638,0,,4419
13,72026522,72035688,del,NA19712,0,,9166
13,43300251,43302559,del,NA12004,0,,2308
13,111587241,111588967,del,HG00739,0,,1726
13,81805803,81814932,del,NA20291,0,,9129
13,100854122,100855506,del,HG00534,0,,1384
13,59227259,59235006,del,HG01488,0,,7747
13,65342427,65344423,del,NA19909,0,,1996
13,23725862,23726116,del,NA18910,0,,254
13,53281433,53281545,del,NA12761,0,,112
13,25633736,25633939,del,NA19393,0,,203
13,49141939,49142174,del,NA19473,0,,235
13,32473808,32479868,del,NA20504,0,,6060
13,47979466,47979896,del,NA19240,0,,430
13,99254189,99258524,del,NA19428,0,,4335
13,102282303,102283099,del,NA18636,0,,796
13,32532644,32538801,del,NA19190,0,,6157
13,97085569,97086826,del,NA19064,0,,1257
13,83949293,83949525,del,NA18557,0,,232
13,19073624,19074910,del,HG01342,0,,1286
13,112963432,112963807,del,NA18909,0,,375
13,71197946,71199992,del,NA18550,0,,2046
13,104606391,104607664,del,NA18858,0,,1273
13,70834711,70839587,del,HG00473,0,,4876
13,23325526,23327184,del,NA19704,0,,1658
13,93175016,93196972,del,NA19057,0,,21956
13,28698175,28699339,del,HG00542,0,,1164
13,75000243,75006384,del,NA19440,0,,6141
13,24631706,24633598,del,NA20535,0,,1892
13,51264873,51267751,del,HG00120,0,,2878
13,64412655,64413643,del,NA19701,0,,988
13,88469295,88472132,del,NA19917,0,,2837
13,114004751,114004896,del,NA19729,0,,145
13,45078358,45078924,del,NA11919,0,,566
13,83209729,83214092,del,NA19916,0,,4363
13,32531066,32539222,del,NA18596,0,,8156
13,105420809,105420915,del,NA18621,0,,106
13,96919790,96925823,del,NA19311,0,,6033
13,78503712,78509466,del,HG00580,0,,5754
13,86727192,86752512,del,NA19834,0,,25320
13,111465454,111465598,del,HG01108,0,,144
13,27049864,27055862,del,NA18559,0,,5998
13,22574676,22574770,del,NA18526,0,,94
13,57752666,57790922,del,NA18945,0,,38256
13,114586403,114586604,del,NA18489,0,,201
13,86673792,86676246,del,NA19137,0,,2454
13,113330727,113330857,del,HG00278,0,,130
13,54254721,54261660,del,NA19147,0,,6939
13,59920754,59921754,del,HG00256,0,,1000
13,101073731,101085401,del,HG01124,0,,11670
13,37871693,37875523,del,NA19311,0,,3830
13,22418098,22421898,del,NA19835,0,,3800
13,53098016,53111222,del,HG00247,0,,13206
13,40193651,40194559,del,NA11994,0,,908
13,114493091,114493635,del,HG00436,0,,544
13,19338233,19357537,del,HG00137,0,,19304
13,99545479,99548728,del,NA19355,0,,3249
13,82585157,82589987,del,NA20509,0,,4830
13,90011336,90013528,del,HG00270,0,,2192
13,87369532,87370393,del,NA19716,0,,861
13,28268139,28269048,del,NA19380,0,,909
13,86507928,86515039,del,HG00654,0,,7111
13,113458201,113458667,del,HG01365,0,,466
13,39747516,39751624,del,NA19712,0,,4108
13,31196958,31197770,del,HG01334,0,,812
13,25604228,25606139,del,NA19085,0,,1911
13,22804775,22805123,del,NA20783,0,,348
13,36438404,36438722,del,NA18853,0,,318
13,92386317,92392369,del,NA18486,0,,6052
13,112590897,112598285,del,NA19663,0,,7388
13,39057315,39060201,del,HG00531,0,,2886
13,46842637,46843035,del,NA19397,0,,398
13,42518977,42523990,del,NA19397,0,,5013
13,34132816,34139222,del,NA19703,0,,6406
13,48376119,48384233,del,HG01488,0,,8114
13,96020224,96024489,del,NA18522,0,,4265
13,61553033,61553865,del,HG00326,0,,832
13,43324621,43326916,del,NA18610,0,,2295
13,58589140,58599790,del,NA12750,0,,10650
13,53281532,53281621,del,NA18562,0,,89
13,114766856,114767082,del,HG00136,0,,226
13,42590930,42592383,del,HG00512,0,,1453
13,42103901,42105904,del,HG00690,0,,2003
13,71789884,71790438,del,NA19371,0,,554
13,76608862,76612757,del,NA19430,0,,3895
13,24069353,24069660,del,NA18621,0,,307
13,87250663,87320893,del,HG00448,0,,70230
13,47836249,47840587,del,NA18963,0,,4338
13,102067308,102067579,del,NA18924,0,,271
13,108191315,108191850,del,NA19917,0,,535
13,65259016,65271829,del,HG00656,0,,12813
13,81889193,81889386,del,HG00375,0,,193
13,114754120,114755038,del,NA19012,0,,918
13,38070395,38120730,del,NA19189,0,,50335
13,31043601,31043824,del,HG00589,0,,223
13,92550676,92552915,del,HG01079,0,,2239
13,48286416,48292922,del,HG01465,0,,6506
13,98600704,98602078,del,NA19376,0,,1374
13,56824086,56825169,del,HG00176,0,,1083
13,51444702,51446319,del,NA18499,0,,1617
13,19517536,19518395,del,NA19455,0,,859
13,36621783,36625722,del,HG00258,0,,3939
13,81280238,81281201,del,NA11992,0,,963
13,30127589,30135862,del,HG00560,0,,8273
13,100821994,100826104,del,NA19383,0,,4110
13,42155100,42155437,del,NA20289,0,,337
13,81867477,81873851,del,NA18560,0,,6374
13,112637977,112638176,del,NA19396,0,,199
13,31943655,31945956,del,HG00537,0,,2301
13,113679350,113680484,del,HG01461,0,,1134
13,114904116,114906122,del,HG00256,0,,2006
13,29915333,29920082,del,NA18552,0,,4749
13,36853414,36855502,del,NA20508,0,,2088
13,19340516,19360972,del,HG01383,0,,20456
13,96417987,96419580,del,HG01174,0,,1593
13,66893573,66899925,del,NA18908,0,,6352
13,57656888,57672799,del,HG00607,0,,15911
13,32671720,32674717,del,NA19434,0,,2997
13,64412940,64414724,del,HG01440,0,,1784
13,92949555,92949715,del,HG01188,0,,160
13,64415007,64416266,del,HG00403,0,,1259
13,41577531,41577669,del,HG00403,0,,138
13,64224636,64237600,del,NA20805,0,,12964
13,107711737,107713623,del,NA18614,0,,1886
13,39154253,39154704,del,NA19457,0,,451
13,32530616,32538822,del,HG00476,0,,8206
13,114050172,114054503,del,HG00637,0,,4331
13,64415459,64416008,del,NA19430,0,,549
13,23325531,23327239,del,NA18501,0,,1708
13,104883091,104883819,del,HG01149,0,,728
13,101205423,101208763,del,NA18984,0,,3340
13,57752537,57788863,del,NA18944,0,,36326
13,72807622,72812358,del,NA20278,0,,4736
13,43617959,43621660,del,HG00653,0,,3701
13,85048221,85049646,del,HG00285,0,,1425
13,78997609,78998719,del,NA12383,0,,1110
13,92111709,92111830,del,NA18606,0,,121
13,89421967,89422937,del,HG01170,0,,970
13,20249622,20250710,del,NA18574,0,,1088
13,76963996,76964276,del,NA06989,0,,280
13,91526434,91702303,del,NA19332,0,,175869
13,50474540,50477425,del,NA19311,0,,2885
13,61234663,61237782,del,HG00464,0,,3119
13,65553820,65562692,del,NA18548,0,,8872
13,69244702,69268757,del,HG00323,0,,24055
13,32014699,32014829,del,HG00583,0,,130
13,95829406,95836836,del,NA12058,0,,7430
13,49310216,49309922,del,HG01350,0,,-294
13,100631916,100634322,del,NA19350,0,,2406
13,57752316,57788222,del,HG00683,0,,35906
13,73721666,73724322,del,HG00699,0,,2656
13,46603862,46647733,del,NA19102,0,,43871
13,89149222,89156222,del,NA19435,0,,7000
13,36335591,36336553,del,NA18486,0,,962
13,87683402,87685391,del,NA19704,0,,1989
13,63945863,63949798,del,HG00479,0,,3935
13,104253391,104253530,del,HG00708,0,,139
13,25569807,25570932,del,NA12763,0,,1125
13,19750980,19752940,del,NA19788,0,,1960
13,90016452,90020547,del,HG00270,0,,4095
13,81037179,81045958,del,NA19835,0,,8779
13,114493071,114493453,del,HG00690,0,,382
13,107510030,107518104,del,HG00732,0,,8074
13,19340216,19347922,del,HG01197,0,,7706
13,96020259,96024496,del,NA20342,0,,4237
13,87831354,87838048,del,NA19099,0,,6694
13,50195305,50197369,del,NA12413,0,,2064
13,85056656,85057038,del,NA20761,0,,382
13,78234232,78235405,del,NA18923,0,,1173
13,96859133,96860564,del,NA19404,0,,1431
13,45867933,45868839,del,HG00244,0,,906
13,45888632,45888924,del,NA18638,0,,292
13,90002177,90018518,del,NA18984,0,,16341
13,72708145,72709215,del,NA18868,0,,1070
13,64415367,64416506,del,HG00249,0,,1139
13,86008717,86008782,del,NA19138,0,,65
13,85045827,85057071,del,NA19313,0,,11244
13,81027719,81030503,del,NA19835,0,,2784
13,75629655,75634137,del,HG00325,0,,4482
13,29948328,29949426,del,NA07048,0,,1098
13,80454900,80460138,del,HG00173,0,,5238
13,38072816,38085422,del,NA19654,0,,12606
13,25309484,25309826,del,NA19223,0,,342
13,49309946,49310034,del,HG00335,0,,88
13,58370080,58373797,del,HG00247,0,,3717
13,23624437,23624565,del,NA20752,0,,128
13,20650109,20651777,del,NA19373,0,,1668
13,72807622,72812363,del,NA19376,0,,4741
13,56851591,56852421,del,HG00176,0,,830
13,29799037,29802387,del,HG00427,0,,3350
13,99313398,99316136,del,NA19080,0,,2738
13,111110643,111111011,del,NA19678,0,,368
13,99631095,99631801,del,NA19072,0,,706
13,78806446,78808696,del,HG00338,0,,2250
13,47517876,47518025,del,NA19746,0,,149
13,70747968,70750720,del,NA19908,0,,2752
13,71197816,71201622,del,HG00705,0,,3806
13,39119963,39180969,del,HG00311,0,,61006
13,57971804,57979926,del,HG01082,0,,8122
13,106449323,106449921,del,HG00174,0,,598
13,36532154,36532278,del,HG00142,0,,124
13,25570216,25580849,del,NA19473,0,,10633
13,39528218,39530027,del,NA19474,0,,1809
13,111061196,111061358,del,HG01366,0,,162
13,92493012,92499132,del,NA07357,0,,6120
13,110741229,110763408,del,HG00641,0,,22179
13,106475352,106476294,del,NA18628,0,,942
13,114168810,114168924,del,HG00692,0,,114
13,29750830,29751681,del,NA19130,0,,851
13,72478350,72482431,del,NA18622,0,,4081
13,114882659,114882787,del,HG00701,0,,128
13,26068197,26068965,del,NA19819,0,,768
13,27919287,27919640,del,NA18637,0,,353
13,54105401,54113950,del,NA19247,0,,8549
13,21486067,21487006,del,HG01095,0,,939
13,65342066,65344322,del,NA19375,0,,2256
13,101205432,101208754,del,HG00580,0,,3322
13,66192751,66207361,del,NA18501,0,,14610
13,70125480,70128208,del,NA19375,0,,2728
13,112868967,112869098,del,HG00543,0,,131
13,63102201,63102812,del,HG01134,0,,611
13,55776609,55780521,del,HG01190,0,,3912
13,33138867,33140273,del,NA18853,0,,1406
13,113325137,113326357,del,NA19116,0,,1220
13,98721236,98721556,del,NA19383,0,,320
13,69762733,69792639,del,NA19916,0,,29906
13,28669663,28670821,del,NA18988,0,,1158
13,82759276,82761419,del,HG01075,0,,2143
13,30436515,30436925,del,NA19920,0,,410
13,27050041,27052186,del,HG01136,0,,2145
13,83921691,83928157,del,NA18960,0,,6466
13,21680352,21682068,del,NA19130,0,,1716
13,85874705,85883914,del,NA19444,0,,9209
13,91475864,91510740,del,NA19904,0,,34876
13,68974479,69002930,del,HG00372,0,,28451
13,46634466,46635354,del,NA19235,0,,888
13,66583085,66584491,del,HG00732,0,,1406
13,50474396,50480065,del,NA19380,0,,5669
13,41270453,41279307,del,NA19072,0,,8854
13,103097005,103097217,del,NA20507,0,,212
13,20342552,20343467,del,NA19818,0,,915
13,104276759,104279156,del,HG00530,0,,2397
13,108947019,108951845,del,NA11994,0,,4826
13,104041422,104042707,del,NA12154,0,,1285
13,68843111,68845698,del,HG00533,0,,2587
13,19201276,19204225,del,NA20790,0,,2949
13,48881718,48882517,del,NA19661,0,,799
13,113263252,113267813,del,NA19904,0,,4561
13,49951401,49953862,del,NA18533,0,,2461
13,34641618,34644349,del,HG00252,0,,2731
13,45407831,45427233,del,NA18565,0,,19402
13,85275016,85282222,del,NA19452,0,,7206
13,68321601,68329852,del,NA19438,0,,8251
13,20825481,20828792,del,NA12286,0,,3311
13,75809253,75810811,del,NA19429,0,,1558
13,21494518,21495129,del,NA12400,0,,611
13,26290831,26292273,del,HG00346,0,,1442
13,29617687,29918387,del,HG00110,0,,300700
13,97490457,97491017,del,HG00339,0,,560
13,38683203,38684384,del,NA19239,0,,1181
13,36335742,36336655,del,NA19373,0,,913
13,26449367,26449881,del,NA18519,0,,514
13,71986946,71995116,del,NA18576,0,,8170
13,90210933,90213123,del,NA20517,0,,2190
13,19340516,19352122,del,NA06984,0,,11606
13,104091916,104093072,del,HG00628,0,,1156
13,37497361,37500732,del,HG00369,0,,3371
13,19769452,19770956,del,NA19390,0,,1504
13,48664608,48665039,del,NA20768,0,,431
13,51512954,51515899,del,NA19681,0,,2945
13,50475315,50479199,del,NA19311,0,,3884
13,47038228,47038463,del,HG00339,0,,235
13,56152475,56229162,del,HG00445,0,,76687
13,85800516,85801572,del,HG00699,0,,1056
13,66322969,66325540,del,NA19713,0,,2571
13,78171270,78172188,del,NA18873,0,,918
13,112818610,112818800,del,NA19321,0,,190
13,45042432,45043105,del,NA12283,0,,673
13,35460002,35460209,del,HG00285,0,,207
13,45955673,45956264,del,NA18557,0,,591
13,86635040,86637140,del,HG00557,0,,2100
13,54600594,54600935,del,NA18917,0,,341
13,31943703,31945975,del,HG00537,0,,2272
13,73721883,73724477,del,NA18977,0,,2594
13,63964307,63964444,del,HG00237,0,,137
13,40058283,40068691,del,NA19084,0,,10408
13,85275073,85282923,del,NA19457,0,,7850
13,94829696,94832171,del,HG00611,0,,2475
13,25645186,25645505,del,NA19005,0,,319
13,20077974,20080405,del,NA19679,0,,2431
13,95983573,95999330,del,NA20770,0,,15757
13,114086290,114095001,del,HG00699,0,,8711
13,114545205,114548522,del,NA19457,0,,3317
13,22523531,22523872,del,NA20756,0,,341
13,59572461,59573335,del,HG00501,0,,874
13,64415298,64416101,del,HG00249,0,,803
13,55622345,55625048,del,NA18988,0,,2703
13,107012251,107014135,del,NA19012,0,,1884
13,91902210,91904309,del,NA19908,0,,2099
13,53357955,53363187,del,HG00306,0,,5232
13,64313700,64315714,del,NA07037,0,,2014
13,31019327,31022304,del,HG01047,0,,2977
13,93007998,93008735,del,HG00479,0,,737
13,27050216,27052122,del,NA20771,0,,1906
13,28663504,28664482,del,NA19436,0,,978
13,23325577,23327240,del,HG01140,0,,1663
13,81738629,81746285,del,NA19470,0,,7656
13,22052160,22054682,del,HG00337,0,,2522
13,114795930,114796020,del,NA18582,0,,90
13,108947016,108951793,del,NA19327,0,,4777
13,80531633,80531859,del,HG00472,0,,226
13,105001837,105005198,del,HG00418,0,,3361
13,97003619,97014687,del,NA19717,0,,11068
13,62015482,62015638,del,HG00260,0,,156
13,44817837,44819736,del,NA20759,0,,1899
13,111962428,111962643,del,HG00237,0,,215
13,43203512,43228440,del,NA18510,0,,24928
13,72475916,72480422,del,NA19137,0,,4506
13,103875493,103875570,del,NA18858,0,,77
13,84784068,84786575,del,HG01108,0,,2507
13,38071916,38086622,del,NA20356,0,,14706
13,113796708,113797090,del,HG00151,0,,382
13,67455669,67470220,del,NA18953,0,,14551
13,96714210,96714300,del,NA19360,0,,90
13,61505677,61507136,del,NA19440,0,,1459
13,58724251,58727371,del,HG01140,0,,3120
13,43632228,43633631,del,HG00731,0,,1403
13,93244470,93245864,del,NA11829,0,,1394
13,84258740,84261326,del,NA18561,0,,2586
13,22416616,22421922,del,NA19446,0,,5306
13,114219536,114219703,del,NA18544,0,,167
13,29616734,29917423,del,HG00146,0,,300689
13,72843037,72846924,del,NA12829,0,,3887
13,114890492,114891641,del,NA18953,0,,1149
13,38701638,38703441,del,NA19834,0,,1803
13,113458020,113458197,del,NA20291,0,,177
13,96020516,96026172,del,NA19469,0,,5656
13,25160669,25177071,del,NA19446,0,,16402
13,83131180,83132212,del,NA20518,0,,1032
13,63669391,63673867,del,NA19717,0,,4476
13,70643912,70651699,del,NA19391,0,,7787
13,61505366,61508472,del,NA19466,0,,3106
13,31628831,31629317,del,NA19818,0,,486
13,92711464,92715364,del,NA19453,0,,3900
13,19078064,19106045,dup,HG00185,0,,27981
13,19142749,19200096,dup,HG01501,0,,57347
13,19208957,19263753,dup,HG01708,0,,54796
13,19278337,19310320,dup,HG01708,0,,31983
13,19328957,19340033,dup,HG00111,0,,11076
13,19347557,19358180,dup,HG00097,0,,10623
13,19360477,19401027,dup,HG00308,0,,40550
13,19380917,19423164,dup,HG01708,0,,42247
13,19538091,19599694,dup,HG02780,0,,61603
13,19630930,19635757,dup,HG01414,0,,4827
13,19740039,19753017,dup,HG04180,0,,12978
13,19789697,20013234,dup,NA19184,0,,223537
13,20005205,20070937,dup,NA19184,0,,65732
13,20048077,20116337,dup,HG02445,0,,68260
13,20141879,20191926,dup,NA19011,0,,50047
13,20181539,20483256,dup,HG00732,0,,301717
13,20185519,20200833,dup,NA19041,0,,15314
13,20197287,20213062,dup,HG00732,0,,15775
13,20234669,20275986,dup,HG00732,0,,41317
13,20292348,20307647,dup,HG00732,0,,15299
13,20372835,20381873,dup,HG00137,0,,9038
13,20391539,20399593,dup,HG00137,0,,8054
13,20396457,20413040,dup,HG00137,0,,16583
13,20425396,20431720,dup,HG00137,0,,6324
13,20434895,20448898,dup,HG00353,0,,14003
13,20448224,20452258,dup,HG00732,0,,4034
13,20478759,20489475,dup,NA19041,0,,10716
13,20485501,20495130,dup,HG01551,0,,9629
13,20660102,20687064,dup,HG02952,0,,26962
13,20720051,20797861,dup,HG02855,0,,77810
13,20721909,20754385,dup,HG02855,0,,32476
13,20764286,20854522,dup,HG00717,0,,90236
13,20793362,20835904,dup,HG00717,0,,42542
13,21537857,21541131,dup,HG03380,0,,3274
13,21781341,21792081,dup,HG00142,0,,10740
13,21781943,21793825,dup,HG01607,0,,11882
13,22043091,22067774,dup,HG03741,0,,24683
13,23095229,23107723,dup,HG03736,0,,12494
13,23232001,23246474,dup,HG03490,0,,14473
13,23345056,23356024,dup,HG00382,0,,10968
13,23398894,23421697,dup,HG00553,0,,22803
13,23415573,23489906,dup,HG04186,0,,74333
13,23483512,23707103,dup,HG03571,0,,223591
13,23524273,23538891,dup,HG03571,0,,14618
13,23545662,23553587,dup,HG00146,0,,7925
13,23575441,23624686,dup,HG03571,0,,49245
13,23720174,23791402,dup,HG03571,0,,71228
13,23794777,23920185,dup,HG03571,0,,125408
13,23932075,24039931,dup,HG03571,0,,107856
13,24053632,24185468,dup,HG03571,0,,131836
13,24082575,24107732,dup,HG03571,0,,25157
13,24205326,24381629,dup,NA18559,0,,176303
13,24388119,24431299,dup,HG03571,0,,43180
13,24448067,24568970,dup,HG03571,0,,120903
13,24585765,24955735,dup,HG03571,0,,369970
13,24908353,24912541,dup,HG01530,0,,4188
13,24913042,24923412,dup,NA18571,0,,10370
13,25160908,25177245,dup,HG01088,0,,16337
13,25175699,25211447,dup,NA19722,0,,35748
13,26983808,27036916,dup,HG03594,0,,53108
13,26986827,27020708,dup,HG03594,0,,33881
13,28510850,28524629,dup,HG00180,0,,13779
13,29430103,29445065,dup,HG01977,0,,14962
13,30583722,30715591,dup,HG03594,0,,131869
13,30720942,30805181,dup,HG03594,0,,84239
13,31003336,31014858,dup,HG02084,0,,11522
13,31564844,31569689,dup,HG01119,0,,4845
13,31725475,31783399,dup,NA20827,0,,57924
13,31725532,31891266,dup,NA20827,0,,165734
13,31812716,31839846,dup,HG03558,0,,27130
13,32152169,32227017,dup,HG01089,0,,74848
13,32477801,32494960,dup,HG01700,0,,17159
13,33134508,33137545,dup,HG02312,0,,3037
13,33396504,33450209,dup,NA19360,0,,53705
13,33963181,33966693,dup,HG02505,0,,3512
13,34495323,34538326,dup,NA20882,0,,43003
13,36018573,36043604,dup,HG00407,0,,25031
13,36302170,36305696,dup,HG01031,0,,3526
13,36321149,36335087,dup,HG03660,0,,13938
13,36791735,36795500,dup,HG00118,0,,3765
13,36964625,36970878,dup,HG03095,0,,6253
13,40058532,40070642,dup,NA18965,0,,12110
13,40222253,40312012,dup,HG01938,0,,89759
13,41076623,41081499,dup,NA19780,0,,4876
13,41718585,41754098,dup,HG01082,0,,35513
13,42668467,42681023,dup,HG00536,0,,12556
13,43439919,43494037,dup,HG02541,0,,54118
13,43488676,43843832,dup,HG00341,0,,355156
13,43488700,43868421,dup,HG01142,0,,379721
13,43543481,43743458,dup,HG02814,0,,199977
13,43719056,43869965,dup,HG01142,0,,150909
13,44394726,44415078,dup,NA20519,0,,20352
13,45407920,45428601,dup,HG00631,0,,20681
13,45557619,45635087,dup,HG03895,0,,77468
13,45948426,45959726,dup,NA20757,0,,11300
13,46336979,46352505,dup,HG01259,0,,15526
13,46357796,46456676,dup,HG01052,0,,98880
13,46851547,46980336,dup,HG01850,0,,128789
13,47536613,47588821,dup,HG03370,0,,52208
13,47557249,47588614,dup,HG03370,0,,31365
13,50113572,50275954,dup,HG03895,0,,162382
13,52380507,52410674,dup,HG01924,0,,30167
13,52852412,52864557,dup,HG00448,0,,12145
13,52882403,52902898,dup,HG01241,0,,20495
13,52909145,52934594,dup,HG00580,0,,25449
13,53070237,53097457,dup,HG00112,0,,27220
13,53115291,53128387,dup,HG00118,0,,13096
13,54079779,54101174,dup,HG02348,0,,21395
13,54358740,54422752,dup,NA18582,0,,64012
13,54969866,55001305,dup,NA18879,0,,31439
13,55032326,55173474,dup,NA18879,0,,141148
13,55374804,55391119,dup,HG01912,0,,16315
13,55652617,55658468,dup,HG02979,0,,5851
13,55916655,55964052,dup,NA19085,0,,47397
13,55972109,56051938,dup,HG02221,0,,79829
13,56100337,56105749,dup,HG02314,0,,5412
13,56906738,56953009,dup,HG02678,0,,46271
13,56907291,56987194,dup,HG02678,0,,79903
13,56947809,57009872,dup,NA18510,0,,62063
13,56949128,57004523,dup,HG02678,0,,55395
13,57253720,57284077,dup,HG00530,0,,30357
13,57269267,57331102,dup,HG01251,0,,61835
13,57307678,57333573,dup,HG01251,0,,25895
13,57530581,57552078,dup,HG01374,0,,21497
13,57544383,57574992,dup,HG00102,0,,30609
13,57579057,57591024,dup,HG01374,0,,11967
13,57589805,57605033,dup,HG01374,0,,15228
13,57598312,57664662,dup,HG00382,0,,66350
13,57606725,57678719,dup,HG00382,0,,71994
13,57663008,57674478,dup,HG00382,0,,11470
13,57669943,57703088,dup,HG01374,0,,33145
13,57694085,57713013,dup,HG03088,0,,18928
13,57752516,57781577,dup,HG00102,0,,29061
13,57792079,57961898,dup,NA20521,0,,169819
13,57792127,57823496,dup,HG00457,0,,31369
13,57820854,57847307,dup,HG02256,0,,26453
13,57862108,57884318,dup,HG01403,0,,22210
13,57866652,57893860,dup,HG01403,0,,27208
13,57888066,57912812,dup,NA20521,0,,24746
13,58049571,58157848,dup,HG00689,0,,108277
13,58141372,58189585,dup,HG01326,0,,48213
13,58501696,58523057,dup,HG01970,0,,21361
13,58791041,58801780,dup,NA18537,0,,10739
13,60008731,60013361,dup,HG03913,0,,4630
13,60441949,60474174,dup,NA18595,0,,32225
13,61200467,61213255,dup,HG03926,0,,12788
13,61209411,61225754,dup,HG02334,0,,16343
13,61211424,61248645,dup,HG02817,0,,37221
13,61222005,61242663,dup,HG03926,0,,20658
13,61585457,61610256,dup,HG02323,0,,24799
13,61585613,61607247,dup,HG03905,0,,21634
13,61930094,61955975,dup,HG01932,0,,25881
13,62199331,62205782,dup,HG00766,0,,6451
13,62509405,62672665,dup,HG02337,0,,163260
13,62520706,62533791,dup,HG02337,0,,13085
13,62531695,62555813,dup,HG02337,0,,24118
13,62567582,62574397,dup,HG02337,0,,6815
13,62573835,62601113,dup,HG02337,0,,27278
13,62599039,62615204,dup,HG02337,0,,16165
13,62614154,62642756,dup,HG02337,0,,28602
13,62636177,62654532,dup,HG02337,0,,18355
13,62656151,62674367,dup,HG02337,0,,18216
13,62965368,62993341,dup,HG04180,0,,27973
13,63159635,63166641,dup,NA20897,0,,7006
13,63316943,63387121,dup,NA18956,0,,70178
13,63527431,63598538,dup,NA18956,0,,71107
13,63946211,63949482,dup,HG00452,0,,3271
13,64140646,64147267,dup,NA20765,0,,6621
13,64242187,64254105,dup,NA20765,0,,11918
13,64260131,64295231,dup,HG01365,0,,35100
13,64263819,64320330,dup,HG01363,0,,56511
13,64301526,64312688,dup,HG00271,0,,11162
13,64331213,64385553,dup,HG00271,0,,54340
13,64416859,64509786,dup,NA20765,0,,92927
13,64523277,64549902,dup,HG02427,0,,26625
13,64936280,64961805,dup,HG03691,0,,25525
13,65291695,65313141,dup,NA18561,0,,21446
13,65530240,65553029,dup,NA18951,0,,22789
13,65797013,65892904,dup,NA18595,0,,95891
13,65801556,65818000,dup,NA18595,0,,16444
13,65826652,65870992,dup,HG00864,0,,44340
13,65861045,65887504,dup,NA18595,0,,26459
13,66232032,66238318,dup,HG01325,0,,6286
13,66235000,66356785,dup,NA18570,0,,121785
13,66237315,66272094,dup,NA18570,0,,34779
13,66279305,66350076,dup,NA18570,0,,70771
13,66348327,66358487,dup,NA18570,0,,10160
13,66431684,66450628,dup,HG02840,0,,18944
13,66452395,66468818,dup,HG01077,0,,16423
13,66722560,66801866,dup,NA19761,0,,79306
13,66891604,66901672,dup,HG00128,0,,10068
13,67241080,67309839,dup,NA18592,0,,68759
13,67242540,67327275,dup,NA18592,0,,84735
13,67341081,67402048,dup,HG03045,0,,60967
13,67738290,67741525,dup,NA19452,0,,3235
13,67852453,68047995,dup,NA18923,0,,195542
13,67861896,67917497,dup,NA18923,0,,55601
13,67929977,67952285,dup,HG04158,0,,22308
13,67968640,68026761,dup,HG01134,0,,58121
13,68028950,68039070,dup,HG04158,0,,10120
13,68047598,68094834,dup,HG01896,0,,47236
13,68114615,68153180,dup,HG02756,0,,38565
13,68320939,68329843,dup,HG02419,0,,8904
13,68357903,68376404,dup,HG00704,0,,18501
13,68404182,68412725,dup,HG00351,0,,8543
13,68490764,68607927,dup,HG02947,0,,117163
13,68491797,68516035,dup,HG02947,0,,24238
13,68511937,68533754,dup,HG03667,0,,21817
13,68531984,68582838,dup,HG02947,0,,50854
13,68629241,68656755,dup,HG00171,0,,27514
13,68747085,68762348,dup,HG00252,0,,15263
13,68943372,69040658,dup,NA19321,0,,97286
13,68969528,69078002,dup,HG03838,0,,108474
13,69020489,69066925,dup,HG03838,0,,46436
13,69762469,69810380,dup,NA19916,0,,47911
13,70018677,70027976,dup,HG02946,0,,9299
13,70808717,70826589,dup,HG01773,0,,17872
13,71069516,71092705,dup,HG02699,0,,23189
13,71195662,71213416,dup,HG03451,0,,17754
13,71777810,71789401,dup,NA18748,0,,11591
13,71786902,71792321,dup,HG03703,0,,5419
13,72807612,72812361,dup,HG00100,0,,4749
13,75414868,75602496,dup,HG00141,0,,187628
13,75414899,75467041,dup,HG01866,0,,52142
13,75420237,75580735,dup,HG00141,0,,160498
13,75467042,75475296,dup,HG01866,0,,8254
13,75473597,75503912,dup,HG01866,0,,30315
13,75582672,75589140,dup,HG01866,0,,6468
13,75630185,75635283,dup,HG00290,0,,5098
13,76107422,76121306,dup,HG01188,0,,13884
13,76475002,76551443,dup,HG03578,0,,76441
13,77982314,77987363,dup,HG03884,0,,5049
13,78868857,78924515,dup,HG00759,0,,55658
13,79484137,79495016,dup,HG03753,0,,10879
13,79773270,80095054,dup,HG03746,0,,321784
13,79773337,79850078,dup,HG03746,0,,76741
13,79773371,79949613,dup,HG03746,0,,176242
13,79967354,80106638,dup,HG03746,0,,139284
13,80681118,80686369,dup,HG00121,0,,5251
13,80771281,80961063,dup,HG01883,0,,189782
13,80963200,81142488,dup,HG01883,0,,179288
13,81033047,81056110,dup,HG00632,0,,23063
13,81142489,81317433,dup,HG01883,0,,174944
13,81328146,81473755,dup,HG01883,0,,145609
13,81519534,81568585,dup,HG01883,0,,49051
13,81647192,81709486,dup,HG01883,0,,62294
13,81719692,81990476,dup,NA12400,0,,270784
13,82015950,82154269,dup,HG01883,0,,138319
13,82149882,82178140,dup,HG02108,0,,28258
13,82372343,82448000,dup,HG01883,0,,75657
13,82397444,82438231,dup,HG02819,0,,40787
13,82526320,82590676,dup,HG03780,0,,64356
13,82622688,82684797,dup,HG03464,0,,62109
13,83188377,83201991,dup,HG00129,0,,13614
13,83473254,83490719,dup,HG04060,0,,17465
13,83515030,83624160,dup,HG03944,0,,109130
13,83517019,83623891,dup,HG03944,0,,106872
13,84101668,84162902,dup,HG00273,0,,61234
13,84160950,84179043,dup,NA12156,0,,18093
13,84209439,84264073,dup,NA18561,0,,54634
13,84291867,84334243,dup,HG03603,0,,42376
13,84366299,84404495,dup,HG01303,0,,38196
13,84466620,84663208,dup,HG01362,0,,196588
13,84532224,84555458,dup,HG01362,0,,23234
13,84628249,84702446,dup,HG01362,0,,74197
13,84762514,84766570,dup,HG02771,0,,4056
13,84945184,84963850,dup,NA19701,0,,18666
13,85282855,85313979,dup,HG01619,0,,31124
13,85283478,85391806,dup,HG02113,0,,108328
13,85704774,85848633,dup,HG03755,0,,143859
13,85710447,85793160,dup,HG03755,0,,82713
13,85789361,85822942,dup,HG03755,0,,33581
13,85793696,85827953,dup,HG03755,0,,34257
13,85842120,85850756,dup,HG01161,0,,8636
13,85857620,85867853,dup,HG01603,0,,10233
13,86264549,86268494,dup,NA19023,0,,3945
13,86606378,86666449,dup,NA19684,0,,60071
13,87325078,87353759,dup,HG02395,0,,28681
13,87378200,87436002,dup,HG01695,0,,57802
13,87574132,87764714,dup,HG00319,0,,190582
13,87770448,87774526,dup,HG01577,0,,4078
13,87956012,88098472,dup,HG03225,0,,142460
13,88048631,88096173,dup,HG03225,0,,47542
13,88184788,88211606,dup,HG03873,0,,26818
13,88294488,88299048,dup,NA19056,0,,4560
13,89479842,89530654,dup,NA18566,0,,50812
13,89550932,89607976,dup,NA18566,0,,57044
13,89611800,89624129,dup,HG02854,0,,12329
13,89616345,89641614,dup,HG03640,0,,25269
13,89623177,89638055,dup,HG03640,0,,14878
13,89655533,89726331,dup,NA18566,0,,70798
13,89700137,89727745,dup,NA18566,0,,27608
13,89725282,89729797,dup,HG03369,0,,4515
13,89734298,89832755,dup,NA18566,0,,98457
13,89756081,89799805,dup,NA18566,0,,43724
13,89799556,89841886,dup,HG00171,0,,42330
13,90205641,90270699,dup,HG03009,0,,65058
13,90282175,90337083,dup,HG03009,0,,54908
13,90348126,90504437,dup,HG03009,0,,156311
13,90911029,90914119,dup,HG00637,0,,3090
13,91042613,91056364,dup,HG03279,0,,13751
13,91526589,91588664,dup,HG03126,0,,62075
13,91536197,91579101,dup,HG03126,0,,42904
13,91588665,91703008,dup,HG01595,0,,114343
13,92760989,92773535,dup,HG04235,0,,12546
13,93434149,93542870,dup,NA18539,0,,108721
13,93811231,93845689,dup,HG01149,0,,34458
13,93815430,93853705,dup,HG02652,0,,38275
13,94004728,94011363,dup,HG03095,0,,6635
13,94006505,94047653,dup,HG03095,0,,41148
13,94059533,94149294,dup,HG03095,0,,89761
13,94115322,94149294,dup,HG03095,0,,33972
13,94460371,94465035,dup,HG03872,0,,4664
13,95318662,95329078,dup,HG01456,0,,10416
13,95981746,96023675,dup,NA21088,0,,41929
13,96001416,96015060,dup,NA21088,0,,13644
13,100033737,100047462,dup,HG02973,0,,13725
13,101468183,101510586,dup,HG02494,0,,42403
13,103572130,103594705,dup,HG02410,0,,22575
13,103683748,103701582,dup,HG01710,0,,17834
13,103683988,103704944,dup,HG01710,0,,20956
13,103712336,103722538,dup,HG01183,0,,10202
13,103782404,103793953,dup,NA20890,0,,11549
13,104120207,104143584,dup,HG03160,0,,23377
13,104365533,104397435,dup,HG03442,0,,31902
13,104492206,104902672,dup,HG01694,0,,410466
13,104492272,104562337,dup,HG01694,0,,70065
13,104737776,104749018,dup,HG03351,0,,11242
13,104745503,104900639,dup,HG01694,0,,155136
13,105036282,105044736,dup,HG01551,0,,8454
13,105350325,105425266,dup,HG02561,0,,74941
13,105428174,105523082,dup,HG02561,0,,94908
13,105528926,105555638,dup,HG02561,0,,26712
13,105640270,105697785,dup,NA20852,0,,57515
13,105953449,105956570,dup,HG00243,0,,3121
13,106225759,106309632,dup,NA19783,0,,83873
13,106707033,106721103,dup,HG01462,0,,14070
13,106780264,107180682,dup,HG00257,0,,400418
13,106780274,106864878,dup,HG00257,0,,84604
13,106951697,106989921,dup,HG03118,0,,38224
13,107179600,107185090,dup,HG00257,0,,5490
13,107194556,107370117,dup,HG00257,0,,175561
13,107522067,107718868,dup,HG00257,0,,196801
13,107563222,107567360,dup,HG03643,0,,4138
13,107723917,107821532,dup,HG00257,0,,97615
13,108033616,108131938,dup,HG00257,0,,98322
13,108710709,108721238,dup,HG02461,0,,10529
13,108999431,109006288,dup,HG00421,0,,6857
13,109679876,109695151,dup,HG03604,0,,15275
13,110359533,110383698,dup,HG00553,0,,24165
13,110693946,110703977,dup,NA20772,0,,10031
13,110732474,110761471,dup,HG00641,0,,28997
13,111624898,111672529,dup,HG02881,0,,47631
13,111626744,111681912,dup,HG02881,0,,55168
13,111635648,111777633,dup,HG00145,0,,141985
13,111635722,111774279,dup,HG00142,0,,138557
13,111676764,111753642,dup,HG00145,0,,76878
13,111769293,111775092,dup,HG02571,0,,5799
13,112829497,112837253,dup,HG00610,0,,7756
13,112966204,112978111,dup,HG00099,0,,11907
13,112983742,113046986,dup,HG03439,0,,63244
13,112985086,113095412,dup,HG03439,0,,110326
13,113049122,113203911,dup,HG03439,0,,154789
13,113310513,113322458,dup,HG00234,0,,11945
13,114031883,114036383,dup,HG00097,0,,4500
13,114427817,114546454,dup,HG00739,0,,118637
13,114437561,114450227,dup,HG00629,0,,12666
13,114460554,114492458,dup,HG00739,0,,31904
13,114488939,114499973,dup,HG00739,0,,11034
13,114511910,114538237,dup,HG00634,0,,26327
13,114545142,114548662,dup,HG00130,0,,3520
13,114548188,114639304,dup,HG00739,0,,91116
13,114570901,114579806,dup,HG00739,0,,8905
13,114579745,114636022,dup,HG00739,0,,56277
13,114741116,114901301,dup,HG00739,0,,160185
13,114800147,114823514,dup,HG00404,0,,23367
13,114833203,114849688,dup,HG00629,0,,16485
13,114845365,114865464,dup,HG00739,0,,20099
13,114869421,114893846,dup,HG00404,0,,24425
13,114999149,115054241,dup,HG01440,0,,55092
13,115000127,115097611,dup,HG01440,0,,97484
13,115036719,115096658,dup,HG01440,0,,59939
13,115104741,115109896,dup,HG00320,0,,5155
14,106317663,106357560,del,HG01465,0,,39897
14,32776358,32783146,del,HG00427,0,,6788
14,61452507,61455096,del,NA19003,0,,2589
14,106176642,106326794,del,NA07051,0,,150152
14,107084664,107096541,del,NA19059,0,,11877
14,41390692,41393032,del,NA11932,0,,2340
14,102390142,102390264,del,NA18856,0,,122
14,21690529,21695448,del,NA19383,0,,4919
14,71689957,71690264,del,NA18516,0,,307
14,106372833,106382452,del,HG00653,0,,9619
14,22831735,22840637,del,HG00704,0,,8902
14,60154081,60154167,del,HG00701,0,,86
14,97352911,97363575,del,NA18597,0,,10664
14,58133663,58148609,del,HG01101,0,,14946
14,34514026,34514836,del,NA20754,0,,810
14,34698671,34699424,del,NA18536,0,,753
14,92668223,92670918,del,HG01083,0,,2695
14,106326088,106383011,del,NA12341,0,,56923
14,75039363,75042752,del,NA12718,0,,3389
14,100427666,100429372,del,NA19474,0,,1706
14,46601718,46608924,del,NA19703,0,,7206
14,105293174,105293360,del,HG01356,0,,186
14,106855188,106936539,del,HG01173,0,,81351
14,20985822,20987501,del,NA19390,0,,1679
14,106330108,106346886,del,HG00731,0,,16778
14,43595749,43601408,del,NA11831,0,,5659
14,91039790,91039914,del,HG00608,0,,124
14,106516082,106689565,del,NA19676,0,,173483
14,33337672,33351093,del,HG01365,0,,13421
14,42519605,42520009,del,HG00326,0,,404
14,106330716,106716422,del,NA19725,0,,385706
14,50825138,50827390,del,NA10851,0,,2252
14,106330467,106370545,del,NA19066,0,,40078
14,81334263,81340148,del,NA18599,0,,5885
14,48826809,48827135,del,HG01377,0,,326
14,29147596,29152326,del,HG00533,0,,4730
14,98024393,98025607,del,NA20758,0,,1214
14,42987526,42992932,del,NA20783,0,,5406
14,50167725,50168793,del,HG01345,0,,1068
14,55751184,55752042,del,HG01082,0,,858
14,63887473,63887802,del,NA18980,0,,329
14,77610742,77614368,del,HG01069,0,,3626
14,84241791,84250811,del,NA18990,0,,9020
14,106324779,106326526,del,NA18617,0,,1747
14,61830394,61851849,del,NA19172,0,,21455
14,58566902,58569551,del,NA18613,0,,2649
14,98783980,98785087,del,HG00310,0,,1107
14,95356094,95356651,del,NA20813,0,,557
14,55811665,55812371,del,HG01080,0,,706
14,96527364,96535698,del,NA19190,0,,8334
14,82995489,82997463,del,NA19007,0,,1974
14,98800963,98808479,del,HG00472,0,,7516
14,103206531,103208082,del,NA18986,0,,1551
14,26283873,26284799,del,NA20761,0,,926
14,106330829,106370488,del,NA18596,0,,39659
14,80225540,80230383,del,NA18910,0,,4843
14,85503989,85508777,del,NA18950,0,,4788
14,67250960,67328020,del,HG00124,0,,77060
14,30458391,30459907,del,HG00537,0,,1516
14,69116946,69123471,del,HG00334,0,,6525
14,47217590,47228019,del,HG00326,0,,10429
14,68406253,68409048,del,NA19000,0,,2795
14,35170716,35174322,del,HG00596,0,,3606
14,106330094,106362342,del,NA18999,0,,32248
14,106211048,106326756,del,HG01462,0,,115708
14,88589285,88590152,del,HG00119,0,,867
14,83386736,83386899,del,NA19240,0,,163
14,23720806,23726160,del,NA19315,0,,5354
14,24479018,24484374,del,HG00265,0,,5356
14,38133148,38137813,del,NA12750,0,,4665
14,70351277,70356228,del,NA18856,0,,4951
14,52594665,52594980,del,HG01365,0,,315
14,106235816,106326622,del,NA20276,0,,90806
14,63723916,63725422,del,HG00581,0,,1506
14,21921049,21922201,del,NA19900,0,,1152
14,21645573,21645702,del,NA18910,0,,129
14,105576725,105579516,del,HG00421,0,,2791
14,73996845,74024571,del,HG00684,0,,27726
14,107244029,107244871,del,NA18635,0,,842
14,78720223,78720520,del,NA18582,0,,297
14,59983441,60021738,del,HG00428,0,,38297
14,103002240,103003525,del,HG00258,0,,1285
14,106037567,106157666,del,HG00326,0,,120099
14,22774831,22775364,del,NA18853,0,,533
14,104896945,104897161,del,NA19657,0,,216
14,52057299,52071400,del,NA20527,0,,14101
14,104075945,104077511,del,NA19374,0,,1566
14,73526841,73531932,del,HG00145,0,,5091
14,97838089,97842796,del,NA18562,0,,4707
14,105372911,105373274,del,NA19399,0,,363
14,75661900,75664470,del,NA20810,0,,2570
14,35607516,35616072,del,NA20508,0,,8556
14,99735116,99742322,del,HG00171,0,,7206
14,19275616,19302722,del,HG00478,0,,27106
14,25611606,25613526,del,HG00478,0,,1920
14,63955301,63964335,del,NA20803,0,,9034
14,103234651,103235476,del,HG00533,0,,825
14,91256227,91267142,del,HG00116,0,,10915
14,106624016,106716522,del,NA20585,0,,92506
14,102758621,102760561,del,NA19719,0,,1940
14,96442480,96449488,del,NA18612,0,,7008
14,106118967,106217737,del,NA11920,0,,98770
14,46830458,46830591,del,HG00319,0,,133
14,99594523,99594643,del,HG00281,0,,120
14,73895928,73900514,del,HG00140,0,,4586
14,85154115,85154183,del,HG00690,0,,68
14,83798756,83799707,del,NA19685,0,,951
14,46425002,46431833,del,NA11920,0,,6831
14,55328407,55330073,del,NA19439,0,,1666
14,99034672,99057288,del,NA19332,0,,22616
14,107125511,107137313,del,NA19012,0,,11802
14,106331404,106385277,del,NA19236,0,,53873
14,84119947,84122041,del,NA18611,0,,2094
14,76390387,76392514,del,HG01047,0,,2127
14,70690052,70690240,del,NA19403,0,,188
14,106822816,106854922,del,NA20127,0,,32106
14,75784631,75785985,del,NA19435,0,,1354
14,31458868,31459578,del,NA18487,0,,710
14,82548009,82551521,del,NA19074,0,,3512
14,66069057,66077993,del,NA20814,0,,8936
14,27469954,27472449,del,NA19093,0,,2495
14,107018439,107126048,del,NA18942,0,,107609
14,106787073,106811790,del,HG00452,0,,24717
14,77815486,77817599,del,NA19081,0,,2113
14,35019366,35022561,del,HG00176,0,,3195
14,91067188,91069893,del,NA20502,0,,2705
14,66810629,66810941,del,HG00638,0,,312
14,21993216,21995122,del,NA19663,0,,1906
14,32953304,32954345,del,NA18610,0,,1041
14,96831300,96832588,del,NA20537,0,,1288
14,35850538,35852180,del,HG01108,0,,1642
14,27673282,27708064,del,HG00361,0,,34782
14,21622388,21624197,del,NA12400,0,,1809
14,85297416,85302372,del,NA20526,0,,4956
14,20315081,20315665,del,NA19374,0,,584
14,53709344,53710826,del,HG00698,0,,1482
14,26798137,26804139,del,NA19000,0,,6002
14,90876458,90877235,del,NA18560,0,,777
14,97174916,97175672,del,HG01516,0,,756
14,89345429,89358870,del,NA18501,0,,13441
14,71450268,71451351,del,NA12413,0,,1083
14,28667395,28673635,del,NA19355,0,,6240
14,74545333,74546052,del,NA19452,0,,719
14,106330472,106361377,del,NA19789,0,,30905
14,42761076,42761423,del,NA19239,0,,347
14,103764021,103764125,del,HG00256,0,,104
14,101033616,101036722,del,HG00437,0,,3106
14,87600503,87600936,del,HG01133,0,,433
14,44501580,44531509,del,NA18633,0,,29929
14,59853221,59853559,del,HG00418,0,,338
14,104655929,104656073,del,NA18520,0,,144
14,43182827,43185215,del,NA18499,0,,2388
14,106324197,106326341,del,HG00619,0,,2144
14,106211603,106212432,del,NA12282,0,,829
14,60341397,60343241,del,NA18964,0,,1844
14,73501871,73502798,del,HG00419,0,,927
14,27679744,27712768,del,NA20346,0,,33024
14,62630090,62630501,del,NA20505,0,,411
14,86457721,86489585,del,HG01124,0,,31864
14,74323881,74327880,del,NA19462,0,,3999
14,65834933,65835401,del,NA18508,0,,468
14,49331365,49333934,del,HG00478,0,,2569
14,38952298,39045538,del,HG00117,0,,93240
14,42210186,42211630,del,HG01489,0,,1444
14,64205623,64210620,del,NA19401,0,,4997
14,22191020,22196261,del,NA11920,0,,5241
14,106329477,106373028,del,NA19700,0,,43551
14,29873300,29877561,del,NA18943,0,,4261
14,98130052,98140922,del,NA19346,0,,10870
14,67863757,67892045,del,NA19239,0,,28288
14,23371837,23372681,del,HG01073,0,,844
14,106330850,106351875,del,NA12155,0,,21025
14,83337525,83339188,del,HG00338,0,,1663
14,45888149,45888467,del,NA18516,0,,318
14,84370310,84371220,del,NA18933,0,,910
14,48763836,48764158,del,HG00442,0,,322
14,106329469,106347360,del,HG00281,0,,17891
14,79554290,79554894,del,NA19445,0,,604
14,68177752,68184925,del,NA20542,0,,7173
14,106349780,106363824,del,NA19443,0,,14044
14,23105113,23107948,del,NA18564,0,,2835
14,90415817,90417466,del,NA12750,0,,1649
14,48229812,48277399,del,NA20768,0,,47587
14,42115817,42116402,del,NA18553,0,,585
14,52756782,52757113,del,NA19201,0,,331
14,106330118,106373079,del,HG00367,0,,42961
14,106734116,106781522,del,NA20539,0,,47406
14,35775685,35776715,del,NA19057,0,,1030
14,35255859,35257244,del,NA19065,0,,1385
14,74288219,74288402,del,HG01072,0,,183
14,106800273,107275805,del,NA19909,0,,475532
14,83352162,83352351,del,HG00330,0,,189
14,64409299,64410482,del,HG00437,0,,1183
14,106330479,106360328,del,HG01491,0,,29849
14,55364188,55366739,del,HG00357,0,,2551
14,106330485,106351875,del,HG00282,0,,21390
14,65709232,65712965,del,HG00285,0,,3733
14,81598285,81598366,del,NA18505,0,,81
14,38159448,38159953,del,NA19712,0,,505
14,42504722,42505421,del,HG00245,0,,699
14,84434229,84440894,del,NA19147,0,,6665
14,106330495,106357541,del,HG00580,0,,27046
14,41472038,41485619,del,NA19916,0,,13581
14,43481963,43485251,del,HG01461,0,,3288
14,29126970,29128068,del,HG01070,0,,1098
14,32301372,32301834,del,NA19444,0,,462
14,19258047,19259780,del,NA19334,0,,1733
14,29274015,29277389,del,HG00367,0,,3374
14,106244516,106319522,del,NA20524,0,,75006
14,42988516,42992322,del,NA18547,0,,3806
14,73953771,73954035,del,NA19379,0,,264
14,105629036,105629153,del,HG01097,0,,117
14,106239548,106326460,del,HG00684,0,,86912
14,58273962,58275423,del,NA19455,0,,1461
14,85887124,85893512,del,HG00537,0,,6388
14,66664806,66674710,del,HG00620,0,,9904
14,102526899,102527332,del,NA11932,0,,433
14,54230498,54230854,del,NA19138,0,,356
14,24264977,24271939,del,NA18942,0,,6962
14,35401402,35401723,del,NA19159,0,,321
14,93884146,93888741,del,HG00126,0,,4595
14,70687832,70689453,del,NA19685,0,,1621
14,106833485,106839622,del,NA12827,0,,6137
14,91959530,91960393,del,NA19712,0,,863
14,33941742,33942276,del,NA19914,0,,534
14,71935616,71935841,del,HG00310,0,,225
14,38902508,38904049,del,NA20795,0,,1541
14,106175932,106176344,del,NA11918,0,,412
14,106330012,106360267,del,NA18989,0,,30255
14,106330089,106366979,del,NA20796,0,,36890
14,70280427,70282501,del,NA18870,0,,2074
14,39209447,39213695,del,HG00708,0,,4248
14,63723743,63724907,del,HG00590,0,,1164
14,22582707,22583756,del,NA18508,0,,1049
14,57509662,57510307,del,NA19700,0,,645
14,44714145,44721078,del,HG01441,0,,6933
14,50000947,50001076,del,HG01170,0,,129
14,77687066,77688122,del,HG00698,0,,1056
14,75658931,75659370,del,NA19213,0,,439
14,106449027,106450848,del,HG01051,0,,1821
14,61963572,61984044,del,NA19900,0,,20472
14,106039650,106159942,del,NA20753,0,,120292
14,103106887,103110034,del,NA18916,0,,3147
14,32106275,32278803,del,HG00578,0,,172528
14,61149958,61156563,del,NA19355,0,,6605
14,21786059,21795293,del,NA18622,0,,9234
14,106329428,106368428,del,HG01354,0,,39000
14,96461400,96465245,del,HG00556,0,,3845
14,69532614,69535716,del,NA18620,0,,3102
14,106716633,106727470,del,NA19461,0,,10837
14,104136951,104137892,del,NA19435,0,,941
14,68603366,68603572,del,HG00270,0,,206
14,51038514,51045027,del,HG01489,0,,6513
14,67709619,67718223,del,NA18613,0,,8604
14,59854421,59861243,del,HG00327,0,,6822
14,106855242,106857886,del,HG01133,0,,2644
14,46775907,46784693,del,NA19311,0,,8786
14,105629007,105629162,del,NA20773,0,,155
14,105092283,105095301,del,HG00247,0,,3018
14,107183187,107183500,del,NA18550,0,,313
14,106331670,106347375,del,NA19075,0,,15705
14,35605866,35615572,del,HG01462,0,,9706
14,76997954,76999158,del,HG00734,0,,1204
14,59045052,59056660,del,HG01191,0,,11608
14,74503693,74512287,del,HG00656,0,,8594
14,72805802,72810924,del,NA19067,0,,5122
14,58360502,58363662,del,NA20795,0,,3160
14,30955038,30961785,del,NA19247,0,,6747
14,36672116,36675397,del,NA19398,0,,3281
14,76313064,76314916,del,NA18871,0,,1852
14,106331665,106350733,del,HG00559,0,,19068
14,57868237,57868642,del,NA12749,0,,405
14,41609016,41669522,del,NA19747,0,,60506
14,78787309,78791811,del,NA19467,0,,4502
14,31542480,31543259,del,NA18634,0,,779
14,44258534,44284022,del,HG00236,0,,25488
14,98774516,98774846,del,HG00328,0,,330
14,106785598,106810283,del,HG00690,0,,24685
14,25262334,25263124,del,NA20814,0,,790
14,78124955,78125062,del,NA12778,0,,107
14,52975738,52976325,del,NA19917,0,,587
14,75698858,75700757,del,HG00662,0,,1899
14,64016303,64017742,del,NA19375,0,,1439
14,73996816,74024522,del,NA18579,0,,27706
14,103728010,103736802,del,NA18499,0,,8792
14,23094866,23098680,del,NA19684,0,,3814
14,107023151,107023278,del,NA19462,0,,127
14,50717861,50727010,del,NA20589,0,,9149
14,81878211,81880612,del,NA18960,0,,2401
14,45386003,45386522,del,NA18501,0,,519
14,66039255,66045923,del,NA19172,0,,6668
14,31813876,31814050,del,NA18989,0,,174
14,105415199,105418170,del,HG01108,0,,2971
14,26760518,26793598,del,NA19010,0,,33080
14,74517730,74519131,del,NA19382,0,,1401
14,106211016,106326222,del,HG01137,0,,115206
14,106239798,106327048,del,HG00247,0,,87250
14,106330488,106370336,del,NA19678,0,,39848
14,20376011,20379478,del,HG00247,0,,3467
14,54710566,54712822,del,NA20813,0,,2256
14,73996961,74024689,del,NA12749,0,,27728
14,106330483,106350711,del,NA18543,0,,20228
14,92945518,92946897,del,NA07051,0,,1379
14,86630986,86632921,del,HG00689,0,,1935
14,99178100,99193783,del,HG01066,0,,15683
14,42277577,42277784,del,NA19081,0,,207
14,40977149,40981796,del,NA19685,0,,4647
14,38962310,38966269,del,NA18549,0,,3959
14,94638740,94639887,del,HG00232,0,,1147
14,49293723,49295070,del,NA19371,0,,1347
14,42717641,42723957,del,NA19395,0,,6316
14,61775494,61775792,del,NA19445,0,,298
14,77434253,77435333,del,NA19099,0,,1080
14,45067018,45067262,del,NA20541,0,,244
14,28111319,28115314,del,NA18615,0,,3995
14,62809626,62811094,del,NA19074,0,,1468
14,106331671,106357552,del,HG00640,0,,25881
14,54108247,54116738,del,HG00473,0,,8491
14,107174398,107174927,del,HG00344,0,,529
14,46588959,46591063,del,NA19462,0,,2104
14,73950812,73953330,del,NA20507,0,,2518
14,55393195,55395755,del,NA19664,0,,2560
14,83628479,83630953,del,NA20770,0,,2474
14,65527144,65527428,del,NA19313,0,,284
14,22029944,22031591,del,HG00512,0,,1647
14,41608616,41670922,del,HG01052,0,,62306
14,90991732,90992338,del,NA19651,0,,606
14,93612008,93613305,del,HG01516,0,,1297
14,38637127,38640665,del,NA11919,0,,3538
14,35398946,35399036,del,HG00281,0,,90
14,105523645,105523789,del,HG00734,0,,144
14,24198015,24208761,del,HG00479,0,,10746
14,106084134,106228380,del,HG00189,0,,144246
14,34881316,34881476,del,HG01440,0,,160
14,51031184,51034892,del,NA18543,0,,3708
14,35787481,35787881,del,NA19346,0,,400
14,71643906,71645117,del,NA19779,0,,1211
14,106323989,106326076,del,HG00276,0,,2087
14,106329450,106385377,del,NA07048,0,,55927
14,48730075,48731937,del,NA19398,0,,1862
14,87052895,87054462,del,NA19470,0,,1567
14,86285463,86312792,del,NA20506,0,,27329
14,96581531,96581862,del,NA19399,0,,331
14,88391528,88423163,del,HG00155,0,,31635
14,102637566,102639692,del,HG00156,0,,2126
14,36545580,36548202,del,NA19346,0,,2622
14,21952624,21954662,del,NA20322,0,,2038
14,102074045,102074153,del,HG01069,0,,108
14,106212309,106239200,del,HG01149,0,,26891
14,107088129,107088788,del,NA18950,0,,659
14,104674639,104674912,del,HG00690,0,,273
14,59524783,59524951,del,NA12046,0,,168
14,85297108,85302155,del,NA18631,0,,5047
14,106330856,106373005,del,HG00554,0,,42149
14,107083274,107169907,del,NA20766,0,,86633
14,22019366,22023438,del,NA10847,0,,4072
14,90200875,90203726,del,HG00436,0,,2851
14,68370656,68374578,del,NA19403,0,,3922
14,103197729,103204117,del,HG01149,0,,6388
14,106879069,107096546,del,HG00180,0,,217477
14,101110289,101110799,del,NA18908,0,,510
14,79981186,79981991,del,NA19130,0,,805
14,89927707,89938956,del,NA20811,0,,11249
14,51090731,51091751,del,NA10851,0,,1020
14,103020356,103020778,del,NA19723,0,,422
14,68002812,68004284,del,NA19375,0,,1472
14,104465980,104466116,del,NA18973,0,,136
14,28680719,28681113,del,NA19099,0,,394
14,26258861,26266495,del,HG01069,0,,7634
14,106330863,106382666,del,HG01136,0,,51803
14,57566760,57572966,del,NA19355,0,,6206
14,28869416,28871272,del,HG00421,0,,1856
14,79747399,79748027,del,NA18622,0,,628
14,80644678,80654912,del,HG00656,0,,10234
14,84042925,84050184,del,HG01176,0,,7259
14,35115086,35122259,del,NA19712,0,,7173
14,52446810,52450280,del,NA20771,0,,3470
14,45921421,45935097,del,NA19346,0,,13676
14,106330462,106382690,del,NA18543,0,,52228
14,35304153,35306787,del,NA18871,0,,2634
14,90573241,90575398,del,NA20803,0,,2157
14,21778186,21778401,del,NA19982,0,,215
14,106330516,106816022,del,NA19395,0,,485506
14,44501588,44529512,del,HG00629,0,,27924
14,73997316,74024222,del,NA19660,0,,26906
14,64361152,64365299,del,NA18570,0,,4147
14,80225566,80230522,del,NA19900,0,,4956
14,100428430,100429279,del,NA19430,0,,849
14,100277480,100279019,del,NA20826,0,,1539
14,101583489,101583908,del,NA19819,0,,419
14,65166979,65167498,del,NA18566,0,,519
14,106330863,106380201,del,NA12778,0,,49338
14,45595467,45597314,del,NA19004,0,,1847
14,28869843,28872160,del,NA12775,0,,2317
14,106330116,106716522,del,HG00324,0,,386406
14,32204167,32204884,del,NA18499,0,,717
14,89828766,89828822,del,NA19384,0,,56
14,66448858,66449651,del,NA19371,0,,793
14,107051108,107133336,del,HG00452,0,,82228
14,80951093,80951946,del,NA18489,0,,853
14,84320237,84321510,del,HG01060,0,,1273
14,87663528,87667650,del,HG01083,0,,4122
14,78445193,78445454,del,NA19703,0,,261
14,64033668,64034068,del,NA19359,0,,400
14,82129405,82172772,del,NA19713,0,,43367
14,50171138,50174074,del,HG00702,0,,2936
14,29728038,29728802,del,NA19376,0,,764
14,106351907,106380219,del,NA19469,0,,28312
14,75784555,75785913,del,NA18545,0,,1358
14,46100808,46101129,del,HG00158,0,,321
14,22892033,22918105,del,NA18941,0,,26072
14,95404962,95405024,del,NA18570,0,,62
14,87706079,87712346,del,NA19717,0,,6267
14,90142204,90147377,del,NA19390,0,,5173
14,20431816,20433722,del,HG00437,0,,1906
14,106329450,106382687,del,HG00403,0,,53237
14,103659267,103664602,del,NA18505,0,,5335
14,106727816,106845822,del,NA19060,0,,118006
14,106596387,106871492,del,HG00732,0,,275105
14,54301008,54301258,del,NA18570,0,,250
14,106240666,106323372,del,HG00651,0,,82706
14,68857923,68861769,del,HG00323,0,,3846
14,106049161,106168000,del,NA18596,0,,118839
14,59555754,59555964,del,NA12342,0,,210
14,106331505,106367005,del,HG00281,0,,35500
14,24186861,24187328,del,HG00366,0,,467
14,106329816,106846022,del,NA18853,0,,516206
14,85332785,85716093,del,NA19059,0,,383308
14,76898946,76899173,del,NA19130,0,,227
14,85108071,85110860,del,HG00254,0,,2789
14,106175016,106228122,del,HG01515,0,,53106
14,106785870,106810573,del,NA18606,0,,24703
14,77687466,77688272,del,HG00375,0,,806
14,39308794,39333273,del,NA18544,0,,24479
14,38910097,38912588,del,HG00309,0,,2491
14,46629376,46630394,del,NA18917,0,,1018
14,106330471,106351733,del,NA19130,0,,21262
14,102644466,102646227,del,HG00331,0,,1761
14,106329450,106370543,del,HG00607,0,,41093
14,65619116,65620314,del,NA19085,0,,1198
14,80286099,80287504,del,HG01197,0,,1405
14,98398858,98399501,del,NA19060,0,,643
14,41608616,41670522,del,HG00583,0,,61906
14,83200758,83201438,del,NA20801,0,,680
14,84605670,84605879,del,NA20281,0,,209
14,22323424,22376244,del,NA12878,0,,52820
14,59545298,59545605,del,NA12044,0,,307
14,81922504,81924610,del,NA19713,0,,2106
14,97048594,97051714,del,HG00156,0,,3120
14,84168191,84172375,del,HG01137,0,,4184
14,47965124,47971113,del,NA07048,0,,5989
14,106330465,106368507,del,NA06986,0,,38042
14,61058055,61059489,del,HG00146,0,,1434
14,106324753,106325969,del,NA19985,0,,1216
14,35897017,35898745,del,NA19920,0,,1728
14,106235616,106326222,del,NA11918,0,,90606
14,73545763,73546924,del,HG01168,0,,1161
14,83578770,83578871,del,NA18636,0,,101
14,35507700,35509507,del,HG01437,0,,1807
14,58322595,58325557,del,NA18510,0,,2962
14,71830118,71843859,del,NA19819,0,,13741
14,98997752,98998111,del,NA19225,0,,359
14,24743364,24787375,del,HG00320,0,,44011
14,33568230,33573725,del,HG00449,0,,5495
14,106847516,106855022,del,NA19318,0,,7506
14,96012017,96014146,del,NA18549,0,,2129
14,48472703,48473732,del,NA19456,0,,1029
14,100844997,100845330,del,NA18940,0,,333
14,86753430,86753514,del,HG00276,0,,84
14,33337562,33350956,del,HG01365,0,,13394
14,74239794,74246936,del,NA18999,0,,7142
14,99503901,99505210,del,HG00313,0,,1309
14,78617463,78617647,del,HG00701,0,,184
14,102638555,102639243,del,HG00326,0,,688
14,46215133,46220638,del,NA19457,0,,5505
14,94553058,94553487,del,NA18543,0,,429
14,41062910,41065609,del,NA19379,0,,2699
14,37636633,37639426,del,NA12282,0,,2793
14,49084555,49084864,del,HG01350,0,,309
14,63629257,63629859,del,NA06989,0,,602
14,52378343,52378902,del,NA19437,0,,559
14,76091529,76093716,del,NA19436,0,,2187
14,37629934,37634343,del,NA19909,0,,4409
14,30986507,30986761,del,NA12003,0,,254
14,73996916,74025022,del,NA18945,0,,28106
14,106728716,106816022,del,HG01516,0,,87306
14,83446633,83449549,del,HG00173,0,,2916
14,92866522,92869689,del,HG00421,0,,3167
14,53026228,53031652,del,NA18633,0,,5424
14,72210562,72212235,del,NA19390,0,,1673
14,103721199,103722697,del,NA19457,0,,1498
14,63924050,63931371,del,NA18990,0,,7321
14,102573173,102575030,del,HG01148,0,,1857
14,50540119,50541658,del,HG01334,0,,1539
14,100096603,100096754,del,NA11918,0,,151
14,49958435,49958589,del,NA12489,0,,154
14,38643495,38643812,del,HG00608,0,,317
14,107085786,107097664,del,NA19909,0,,11878
14,56202423,56205827,del,NA19372,0,,3404
14,102953940,102955280,del,NA19726,0,,1340
14,103159638,103159992,del,NA20800,0,,354
14,26590958,26592391,del,HG00116,0,,1433
14,104755663,104755887,del,NA19085,0,,224
14,31682526,31683380,del,NA18612,0,,854
14,39632069,39633321,del,NA18912,0,,1252
14,70016992,70022486,del,NA19625,0,,5494
14,63061284,63065832,del,NA19256,0,,4548
14,55032316,55035722,del,HG00436,0,,3406
14,70572599,70574832,del,NA18908,0,,2233
14,105629007,105629135,del,NA19137,0,,128
14,22908002,22918104,del,HG00702,0,,10102
14,86130565,86132145,del,HG00261,0,,1580
14,106055954,106056055,del,HG00525,0,,101
14,31219975,31225538,del,HG00513,0,,5563
14,107134554,107135776,del,HG00143,0,,1222
14,67470273,67470406,del,HG00475,0,,133
14,22835226,22836171,del,NA18502,0,,945
14,104631474,104631972,del,NA19346,0,,498
14,64888461,64890535,del,HG00186,0,,2074
14,46100942,46101126,del,HG00377,0,,184
14,105131635,105131754,del,HG01073,0,,119
14,106330360,106382577,del,HG00334,0,,52217
14,43064421,43078114,del,NA19346,0,,13693
14,69740833,69743730,del,NA06986,0,,2897
14,74460438,74469252,del,NA19982,0,,8814
14,28666966,28673922,del,NA18487,0,,6956
14,89234234,89238718,del,NA12843,0,,4484
14,96437266,96437622,del,HG01083,0,,356
14,106331681,106346868,del,NA19099,0,,15187
14,67605785,67606915,del,NA19900,0,,1130
14,106211516,106326222,del,NA19093,0,,114706
14,49940791,49943128,del,NA19313,0,,2337
14,102876607,102878067,del,NA19334,0,,1460
14,63787179,63787519,del,NA19455,0,,340
14,99638016,99642422,del,HG00657,0,,4406
14,60624516,60625278,del,NA12249,0,,762
14,103451412,103451565,del,NA18637,0,,153
14,44588872,44591715,del,HG00247,0,,2843
14,35605866,35615172,del,HG00309,0,,9306
14,106081229,106196433,del,HG00275,0,,115204
14,106784941,106809628,del,HG00595,0,,24687
14,26005796,26006047,del,NA19780,0,,251
14,106330486,106354386,del,NA18620,0,,23900
14,23108145,23110545,del,HG01072,0,,2400
14,106689963,107181699,del,HG00418,0,,491736
14,73884611,73885278,del,NA18599,0,,667
14,106886116,106895522,del,NA19395,0,,9406
14,66983216,67041389,del,NA20538,0,,58173
14,30864207,30864701,del,HG00581,0,,494
14,19076419,19079174,del,NA19355,0,,2755
14,94988309,95007044,del,NA18545,0,,18735
14,40869936,40873879,del,NA20544,0,,3943
14,105541366,105541972,del,HG00124,0,,606
14,80556743,80562596,del,NA19920,0,,5853
14,25954052,25958989,del,NA18572,0,,4937
14,23109513,23110679,del,HG00252,0,,1166
14,106237216,106323422,del,NA19456,0,,86206
14,60143072,60144528,del,NA19663,0,,1456
14,106330096,106380209,del,HG00154,0,,50113
14,106329473,106350700,del,NA19429,0,,21227
14,52161628,52161902,del,NA19401,0,,274
14,106728116,106783422,del,NA12272,0,,55306
14,103343458,103343839,del,NA19439,0,,381
14,28963753,28965477,del,HG00476,0,,1724
14,74006970,74038879,del,HG00247,0,,31909
14,71121936,71124468,del,HG00122,0,,2532
14,106484416,106716522,del,NA18949,0,,232106
14,83203928,83206863,del,HG00595,0,,2935
14,89827194,89829136,del,HG01550,0,,1942
14,106624619,106627907,del,NA19908,0,,3288
14,52391728,52396258,del,NA19901,0,,4530
14,104791375,104791938,del,NA20506,0,,563
14,41600966,41602442,del,NA19657,0,,1476
14,41885619,41893153,del,NA20510,0,,7534
14,38924059,38985239,del,HG00243,0,,61180
14,32263016,32268122,del,HG00543,0,,5106
14,65902275,65914851,del,HG01191,0,,12576
14,105328156,105328444,del,HG00281,0,,288
14,35605614,35615068,del,HG00159,0,,9454
14,77443696,77445735,del,NA19060,0,,2039
14,80106288,80115049,del,HG00126,0,,8761
14,55622711,55625988,del,NA19716,0,,3277
14,106014794,106014954,del,NA19455,0,,160
14,22026269,22036272,del,NA19456,0,,10003
14,106330845,106354412,del,NA12489,0,,23567
14,28712345,28733912,del,HG00273,0,,21567
14,68858031,68861775,del,HG00323,0,,3744
14,30682751,30683198,del,HG00500,0,,447
14,83852040,83852363,del,NA19664,0,,323
14,60310778,60311795,del,NA18990,0,,1017
14,106330814,106347328,del,HG01134,0,,16514
14,105994281,105994721,del,NA19375,0,,440
14,35428810,35432453,del,NA20278,0,,3643
14,65555552,65557319,del,HG01061,0,,1767
14,106330848,106366983,del,NA11930,0,,36135
14,80481240,80481690,del,NA19455,0,,450
14,84168191,84172370,del,HG01137,0,,4179
14,46824254,46825389,del,NA19457,0,,1135
14,75692526,75694134,del,NA19059,0,,1608
14,29117629,29118552,del,HG00182,0,,923
14,63951131,63952944,del,NA19064,0,,1813
14,21114916,21117039,del,NA18632,0,,2123
14,27102536,27146583,del,HG01174,0,,44047
14,103583530,103583818,del,HG00320,0,,288
14,105350516,105351322,del,NA19834,0,,806
14,43372911,43373323,del,NA18597,0,,412
14,106238716,106326222,del,NA19755,0,,87506
14,21357758,21385704,del,NA19455,0,,27946
14,29064753,29074713,del,NA20753,0,,9960
14,75607023,75609752,del,HG00662,0,,2729
14,65827927,65828224,del,HG01101,0,,297
14,25910216,25911915,del,NA20766,0,,1699
14,81691761,81693424,del,NA18959,0,,1663
14,106330495,106363803,del,NA12272,0,,33308
14,42277546,42277774,del,NA19360,0,,228
14,42717248,42718287,del,NA18983,0,,1039
14,33436824,33442560,del,NA19663,0,,5736
14,62292786,62293850,del,NA18916,0,,1064
14,80070853,80072108,del,NA18574,0,,1255
14,38358843,38365798,del,NA20815,0,,6955
14,21753116,21754659,del,NA19376,0,,1543
14,38133120,38138018,del,NA19678,0,,4898
14,50986811,50989758,del,HG01440,0,,2947
14,26147100,26147457,del,HG00253,0,,357
14,107032286,107113710,del,NA19431,0,,81424
14,20476915,20489535,del,NA20531,0,,12620
14,106786993,106811705,del,NA18873,0,,24712
14,59864315,59868423,del,HG00421,0,,4108
14,25806849,25808832,del,HG01124,0,,1983
14,79347331,79349296,del,NA19430,0,,1965
14,87453595,87462990,del,NA20800,0,,9395
14,106151235,106151488,del,HG01072,0,,253
14,96905037,96908025,del,HG00650,0,,2988
14,39004518,39005027,del,NA19079,0,,509
14,84932220,84933173,del,NA20582,0,,953
14,94347869,94351270,del,NA19391,0,,3401
14,106330832,106361453,del,NA10851,0,,30621
14,106079636,106224231,del,HG00404,0,,144595
14,45178594,45225632,del,HG00137,0,,47038
14,106884216,106918622,del,HG01522,0,,34406
14,106330073,106375702,del,HG00249,0,,45629
14,90987023,90987349,del,NA19377,0,,326
14,41604016,41664222,del,NA11992,0,,60206
14,95841345,95841584,del,NA11829,0,,239
14,106331663,106373070,del,NA12342,0,,41407
14,23108076,23109267,del,NA18498,0,,1191
14,93443895,93445141,del,NA19431,0,,1246
14,95281421,95281816,del,HG01491,0,,395
14,75692801,75694428,del,NA19059,0,,1627
14,41814234,41859620,del,NA18505,0,,45386
14,106781369,106806069,del,HG00449,0,,24700
14,76538156,76539524,del,HG00375,0,,1368
14,106330467,106347400,del,NA19468,0,,16933
14,42500810,42508010,del,HG00231,0,,7200
14,35019913,35022492,del,HG00637,0,,2579
14,106031751,106151252,del,NA12045,0,,119501
14,41210103,41237865,del,NA18610,0,,27762
14,98956668,98958718,del,NA18948,0,,2050
14,101025314,101030133,del,NA19704,0,,4819
14,30817199,30819449,del,HG00261,0,,2250
14,106324422,106325659,del,NA18520,0,,1237
14,73332951,73333806,del,NA20768,0,,855
14,23505496,23505686,del,HG01083,0,,190
14,71047171,71049289,del,HG00442,0,,2118
14,80098981,80099820,del,NA19384,0,,839
14,71535352,71535556,del,HG01101,0,,204
14,38799649,38803622,del,NA12287,0,,3973
14,31687130,31688155,del,HG01140,0,,1025
14,79159143,79165643,del,NA20797,0,,6500
14,58006227,58008292,del,HG00553,0,,2065
14,106886116,106918022,del,NA10847,0,,31906
14,27500142,27500416,del,NA19137,0,,274
14,74831894,74833310,del,NA19451,0,,1416
14,52404332,52404457,del,HG00533,0,,125
14,35354154,35368606,del,HG00554,0,,14452
14,106541845,107172888,del,HG00155,0,,631043
14,106324858,106327499,del,NA11992,0,,2641
14,46048997,46060587,del,NA19346,0,,11590
14,106323305,106327724,del,NA18986,0,,4419
14,34733453,34736585,del,HG00270,0,,3132
14,106330080,106357530,del,NA19393,0,,27450
14,73997416,74025022,del,NA18910,0,,27606
14,55319889,55326213,del,HG00437,0,,6324
14,83435205,83436960,del,NA18595,0,,1755
14,106331444,106368454,del,NA19068,0,,37010
14,55249669,55252339,del,HG00261,0,,2670
14,106330462,106346892,del,NA19129,0,,16430
14,103014542,103016125,del,HG00732,0,,1583
14,90900538,90901834,del,HG00613,0,,1296
14,102950423,102951138,del,HG00565,0,,715
14,106727816,106753222,del,NA18565,0,,25406
14,33236110,33237664,del,NA19440,0,,1554
14,103854901,103869038,del,NA19395,0,,14137
14,106357572,106363817,del,NA07051,0,,6245
14,56584716,56586522,del,HG00531,0,,1806
14,38946040,38952872,del,NA19009,0,,6832
14,49726934,49728424,del,NA20812,0,,1490
14,40609815,40617672,del,NA19059,0,,7857
14,94988309,95007051,del,NA18545,0,,18742
14,106330092,106370525,del,HG00273,0,,40433
14,28620886,28623324,del,NA18611,0,,2438
14,65360386,65363540,del,HG00533,0,,3154
14,100427668,100429460,del,NA19102,0,,1792
14,51142132,51157121,del,NA20786,0,,14989
14,58372647,58376437,del,NA19062,0,,3790
14,71608585,71613140,del,HG01440,0,,4555
14,106325230,106326527,del,HG00275,0,,1297
14,106080678,106195887,del,NA19734,0,,115209
14,87453509,87462931,del,NA12842,0,,9422
14,42866535,42962649,del,HG00620,0,,96114
14,93022507,93025837,del,HG00704,0,,3330
14,106330483,106376240,del,HG00689,0,,45757
14,106211043,106212891,del,HG00702,0,,1848
14,45611039,45613142,del,NA20322,0,,2103
14,26529714,26539045,del,NA18549,0,,9331
14,21377300,21379531,del,NA18611,0,,2231
14,23105129,23109270,del,NA19372,0,,4141
14,46749244,46770579,del,HG00154,0,,21335
14,77513441,77514101,del,NA19350,0,,660
14,106330484,106361478,del,NA18856,0,,30994
14,106676463,107176758,del,NA20540,0,,500295
14,83154532,83155469,del,NA19257,0,,937
14,74085026,74085335,del,NA19401,0,,309
14,106330472,106349759,del,NA20581,0,,19287
14,99503952,99505261,del,NA20536,0,,1309
14,106727816,106783922,del,HG01495,0,,56106
14,80823326,80826314,del,NA11995,0,,2988
14,93696889,93697639,del,NA19451,0,,750
14,54710346,54713685,del,NA18561,0,,3339
14,75520938,75525519,del,NA18953,0,,4581
14,85404213,85407130,del,NA19332,0,,2917
14,93622006,93626736,del,NA19776,0,,4730
14,106330098,106385351,del,NA12889,0,,55253
14,46628766,46630222,del,NA19463,0,,1456
14,73552002,73552263,del,HG01441,0,,261
14,48882066,48882441,del,HG00595,0,,375
14,46568882,46634630,del,HG00158,0,,65748
14,78295158,78297076,del,NA19059,0,,1918
14,19002385,19010406,del,NA19350,0,,8021
14,24932619,24932783,del,HG00258,0,,164
14,97352967,97363734,del,NA18597,0,,10767
14,66157661,66158245,del,NA19379,0,,584
14,64077678,64078576,del,HG00702,0,,898
14,47672010,47678228,del,HG01366,0,,6218
14,103648896,103651625,del,NA18908,0,,2729
14,98220914,98222825,del,NA19404,0,,1911
14,46054782,46055629,del,NA18963,0,,847
14,53252466,53255079,del,NA19077,0,,2613
14,58530806,58530926,del,NA19404,0,,120
14,42650928,42651245,del,NA18972,0,,317
14,75874438,75875278,del,NA19726,0,,840
14,73953709,73954008,del,NA18999,0,,299
14,106329816,106716522,del,HG01354,0,,386706
14,28869865,28871422,del,NA19434,0,,1557
14,106897016,106919022,del,NA19404,0,,22006
14,67932019,67932170,del,HG00337,0,,151
14,27479686,27493212,del,HG00740,0,,13526
14,92800222,92802570,del,NA19172,0,,2348
14,86342835,86343156,del,NA18570,0,,321
14,77815592,77821482,del,NA19213,0,,5890
14,33391972,33392308,del,NA18546,0,,336
14,85062262,85062943,del,NA18874,0,,681
14,45265131,45265399,del,NA18545,0,,268
14,23922246,23922646,del,NA20805,0,,400
14,105506297,105507045,del,NA18933,0,,748
14,49882077,49882243,del,HG00473,0,,166
14,31267670,31268693,del,HG00328,0,,1023
14,95796192,95796978,del,NA19463,0,,786
14,68129562,68130333,del,HG00126,0,,771
14,32214739,32216582,del,HG01462,0,,1843
14,89228361,89239081,del,NA12843,0,,10720
14,41609436,41669664,del,NA19717,0,,60228
14,50171074,50173883,del,HG00702,0,,2809
14,23052224,23053553,del,HG00111,0,,1329
14,106811564,107107732,del,NA20783,0,,296168
14,86201037,86204896,del,NA19225,0,,3859
14,44804402,44807988,del,HG00613,0,,3586
14,106330013,106376181,del,HG01366,0,,46168
14,23371837,23372687,del,HG01073,0,,850
14,46535866,46564372,del,NA19004,0,,28506
14,106204647,106205488,del,NA19436,0,,841
14,56295331,56297205,del,NA19713,0,,1874
14,65852991,65856025,del,NA18635,0,,3034
14,47707571,47717845,del,HG00256,0,,10274
14,35702292,35702878,del,HG00638,0,,586
14,102622372,102630541,del,NA19700,0,,8169
14,106329472,106379062,del,NA20588,0,,49590
14,106753116,106782722,del,NA19722,0,,29606
14,22320490,22371013,del,NA18987,0,,50523
14,103752226,103754028,del,HG01377,0,,1802
14,48407587,48408819,del,HG00472,0,,1232
14,19112155,19126473,dup,HG00096,0,,14318
14,19462329,19469848,dup,HG00120,0,,7519
14,20335553,20423316,dup,HG00096,0,,87763
14,20520660,20541553,dup,HG02009,0,,20893
14,20550914,20555141,dup,HG00097,0,,4227
14,20678645,20757699,dup,HG01462,0,,79054
14,21151846,21189119,dup,NA21117,0,,37273
14,21194161,21198377,dup,HG01251,0,,4216
14,21354698,21416619,dup,HG00404,0,,61921
14,21806181,21816825,dup,NA19060,0,,10644
14,21924067,22032405,dup,HG01747,0,,108338
14,21963366,21995659,dup,HG01747,0,,32293
14,22049269,22058851,dup,HG02255,0,,9582
14,22740308,22923239,dup,HG00130,0,,182931
14,23156004,23312307,dup,NA20759,0,,156303
14,23166014,23176164,dup,NA18510,0,,10150
14,24422900,24439549,dup,HG01107,0,,16649
14,24449758,24464787,dup,HG00102,0,,15029
14,24479423,24485167,dup,HG00102,0,,5744
14,24488845,24503941,dup,NA20294,0,,15096
14,25144283,25162374,dup,HG04047,0,,18091
14,25245961,25260260,dup,HG02870,0,,14299
14,25993759,25998758,dup,HG02108,0,,4999
14,26841018,26877981,dup,NA19475,0,,36963
14,26880546,27004747,dup,NA19475,0,,124201
14,27094237,27152805,dup,NA21091,0,,58568
14,27248698,27281624,dup,HG03636,0,,32926
14,27280572,27330481,dup,HG01565,0,,49909
14,27287758,27329696,dup,NA18916,0,,41938
14,27454377,27476700,dup,HG02070,0,,22323
14,27466316,27531010,dup,HG00116,0,,64694
14,27680399,27713744,dup,NA20346,0,,33345
14,27839901,27889590,dup,HG02628,0,,49689
14,27893782,27911756,dup,HG02628,0,,17974
14,28011480,28094937,dup,HG01565,0,,83457
14,28137223,28187946,dup,HG02628,0,,50723
14,28459457,28522642,dup,HG02651,0,,63185
14,30289005,30319155,dup,HG03634,0,,30150
14,30302086,30328207,dup,HG02322,0,,26121
14,30990300,30993849,dup,HG00428,0,,3549
14,31983996,31991918,dup,HG01531,0,,7922
14,33331760,33347814,dup,HG01250,0,,16054
14,34260777,34280118,dup,HG03844,0,,19341
14,34546660,34557155,dup,NA21135,0,,10495
14,34838311,34842662,dup,NA19334,0,,4351
14,37999777,38013670,dup,HG00096,0,,13893
14,38133201,38137750,dup,HG00102,0,,4549
14,39308602,39335629,dup,NA18544,0,,27027
14,40227758,40240595,dup,HG01680,0,,12837
14,40363830,40379812,dup,HG04209,0,,15982
14,41412448,41476781,dup,NA18641,0,,64333
14,41426801,41467817,dup,NA18641,0,,41016
14,41453986,41472538,dup,HG02716,0,,18552
14,41731050,41810160,dup,NA19399,0,,79110
14,41817211,41830682,dup,NA18505,0,,13471
14,41846610,41867761,dup,HG02657,0,,21151
14,42550112,42614913,dup,NA18639,0,,64801
14,42664146,42764775,dup,NA19782,0,,100629
14,42831271,42859134,dup,NA19782,0,,27863
14,42844538,42856813,dup,HG02923,0,,12275
14,42866301,42965674,dup,HG02128,0,,99373
14,42963334,43086446,dup,HG01162,0,,123112
14,43056717,43088805,dup,HG01162,0,,32088
14,43481887,43485207,dup,HG01136,0,,3320
14,43737570,43849370,dup,HG03567,0,,111800
14,43819438,43840685,dup,HG03567,0,,21247
14,43844038,43856134,dup,HG01101,0,,12096
14,43851999,43879873,dup,HG01101,0,,27874
14,43886231,43949464,dup,HG01101,0,,63233
14,43913902,43949621,dup,HG01101,0,,35719
14,44012659,44130746,dup,HG02881,0,,118087
14,44014199,44037689,dup,HG02881,0,,23490
14,44053092,44059613,dup,HG02881,0,,6521
14,44068154,44195844,dup,HG01630,0,,127690
14,44174705,44218090,dup,HG01101,0,,43385
14,44242947,44246929,dup,NA18507,0,,3982
14,44488567,44536408,dup,HG00406,0,,47841
14,44560209,44620957,dup,HG01513,0,,60748
14,44630810,44661589,dup,NA19391,0,,30779
14,44821955,44930566,dup,HG01700,0,,108611
14,44896070,45005334,dup,HG03040,0,,109264
14,45012504,45075748,dup,HG01775,0,,63244
14,45015602,45110683,dup,HG01775,0,,95081
14,45267271,45281503,dup,HG01168,0,,14232
14,45824072,46023320,dup,HG02281,0,,199248
14,46108235,46189687,dup,HG01369,0,,81452
14,46210416,46318290,dup,HG02491,0,,107874
14,46409290,46491298,dup,HG02283,0,,82008
14,46775855,46784699,dup,NA19319,0,,8844
14,46811181,46872359,dup,HG02635,0,,61178
14,46841506,46870799,dup,HG03815,0,,29293
14,46986143,46997786,dup,NA20581,0,,11643
14,47728941,47752791,dup,HG03069,0,,23850
14,48271196,48425388,dup,HG00472,0,,154192
14,48276959,48361516,dup,HG00472,0,,84557
14,48376775,48408124,dup,HG00472,0,,31349
14,48463983,48508300,dup,HG01597,0,,44317
14,48672966,48683350,dup,HG02070,0,,10384
14,48787716,48912612,dup,HG00138,0,,124896
14,49083155,49147982,dup,HG02278,0,,64827
14,49268587,49300699,dup,HG02278,0,,32112
14,49943173,49984513,dup,NA19328,0,,41340
14,50110406,50195691,dup,HG03729,0,,85285
14,50135329,50164596,dup,HG03729,0,,29267
14,50168399,50177521,dup,HG03452,0,,9122
14,50183376,50195057,dup,HG03729,0,,11681
14,52775367,52803136,dup,NA18881,0,,27769
14,53283274,53307281,dup,NA18539,0,,24007
14,53729153,53743122,dup,HG01801,0,,13969
14,53732765,53772189,dup,HG01247,0,,39424
14,53744123,53767803,dup,HG01247,0,,23680
14,55623280,55690988,dup,HG03862,0,,67708
14,55646029,55674479,dup,HG03862,0,,28450
14,56163503,56265659,dup,HG01600,0,,102156
14,56280377,56332540,dup,HG03693,0,,52163
14,56393082,56487614,dup,HG03693,0,,94532
14,56460654,56482247,dup,HG03693,0,,21593
14,57185720,57200203,dup,HG03604,0,,14483
14,59349717,59376016,dup,HG01682,0,,26299
14,59352166,59371118,dup,HG01682,0,,18952
14,59352185,59369341,dup,HG01682,0,,17156
14,60426266,60519877,dup,NA18571,0,,93611
14,61506526,61517269,dup,NA19732,0,,10743
14,62304909,62329107,dup,HG03084,0,,24198
14,62399566,62409423,dup,HG01766,0,,9857
14,62632564,62639690,dup,HG00851,0,,7126
14,62632652,62796914,dup,HG00851,0,,164262
14,62633538,62790863,dup,HG00851,0,,157325
14,62638785,62732063,dup,HG00851,0,,93278
14,62765877,62801515,dup,HG00851,0,,35638
14,63592816,63599668,dup,HG00701,0,,6852
14,63771914,63854827,dup,NA06989,0,,82913
14,63938090,64106783,dup,HG03048,0,,168693
14,63939085,64015724,dup,HG03048,0,,76639
14,64037564,64048663,dup,HG03048,0,,11099
14,64056822,64086427,dup,HG03048,0,,29605
14,64261383,64273146,dup,NA21114,0,,11763
14,64636642,64760733,dup,NA20517,0,,124091
14,65014921,65021231,dup,HG00097,0,,6310
14,65733011,65742380,dup,HG00421,0,,9369
14,67044519,67147790,dup,HG02895,0,,103271
14,67400018,67406579,dup,NA18643,0,,6561
14,69855188,69888620,dup,HG03848,0,,33432
14,70008134,70015105,dup,HG00271,0,,6971
14,70706016,70709887,dup,HG02505,0,,3871
14,71645812,71656417,dup,NA20888,0,,10605
14,73768499,73786788,dup,NA19397,0,,18289
14,73858242,73867961,dup,HG02610,0,,9719
14,74011083,74024007,dup,HG00097,0,,12924
14,74028137,74040600,dup,HG00157,0,,12463
14,74435587,74460206,dup,HG03945,0,,24619
14,74571114,74596638,dup,HG01363,0,,25524
14,74893387,75004477,dup,HG01842,0,,111090
14,75103618,75116819,dup,HG02312,0,,13201
14,75128492,75143128,dup,HG01842,0,,14636
14,75632417,75662662,dup,HG01974,0,,30245
14,77851765,77858737,dup,HG01896,0,,6972
14,78096624,78211999,dup,HG02562,0,,115375
14,78110425,78163529,dup,HG02562,0,,53104
14,78367272,78392388,dup,HG01122,0,,25116
14,78367654,78384957,dup,HG01122,0,,17303
14,78604851,78633261,dup,HG03770,0,,28410
14,79774899,79794257,dup,NA18876,0,,19358
14,80952359,81042867,dup,NA06984,0,,90508
14,81179270,81312386,dup,NA06984,0,,133116
14,81181601,82138717,dup,NA06984,0,,957116
14,81315899,81499449,dup,NA06984,0,,183550
14,82131412,82175028,dup,NA19713,0,,43616
14,83257921,83269657,dup,NA18559,0,,11736
14,83523529,83532583,dup,NA18749,0,,9054
14,83709801,83739877,dup,HG01880,0,,30076
14,83779975,83782981,dup,HG01396,0,,3006
14,84076835,84102504,dup,NA18745,0,,25669
14,84294406,84350431,dup,NA06984,0,,56025
14,84498796,84638064,dup,NA06984,0,,139268
14,84901009,84916537,dup,HG01879,0,,15528
14,85018695,85292037,dup,NA06984,0,,273342
14,85169702,85249167,dup,HG04033,0,,79465
14,85251069,85286744,dup,HG04033,0,,35675
14,85251735,85279859,dup,HG04033,0,,28124
14,85581997,85712587,dup,NA06984,0,,130590
14,85782495,85878113,dup,NA06984,0,,95618
14,85879322,85939199,dup,NA06984,0,,59877
14,85942947,86153989,dup,NA06984,0,,211042
14,86083582,86102194,dup,HG00653,0,,18612
14,86149519,86153471,dup,HG01083,0,,3952
14,86236643,86358710,dup,HG01973,0,,122067
14,86280259,86312390,dup,HG00111,0,,32131
14,86285145,86306409,dup,HG00111,0,,21264
14,86318828,86366506,dup,HG01973,0,,47678
14,86458517,86497673,dup,HG00119,0,,39156
14,86540381,86578981,dup,HG00437,0,,38600
14,86835202,87177225,dup,NA06984,0,,342023
14,86885724,86923979,dup,HG03851,0,,38255
14,86932707,86976808,dup,HG03851,0,,44101
14,87251524,87379778,dup,HG03557,0,,128254
14,87309019,87349925,dup,HG03557,0,,40906
14,87470260,87571773,dup,NA06984,0,,101513
14,87530575,87546522,dup,HG02771,0,,15947
14,87595568,87744803,dup,NA06984,0,,149235
14,87607546,87631801,dup,HG02879,0,,24255
14,87698816,87712107,dup,NA19309,0,,13291
14,87748356,87858778,dup,NA06984,0,,110422
14,88187870,88226001,dup,NA06984,0,,38131
14,88299497,88420442,dup,HG00342,0,,120945
14,88929909,89130748,dup,NA06984,0,,200839
14,89490481,89529991,dup,HG01366,0,,39510
14,89878851,90082805,dup,NA06984,0,,203954
14,90084784,90421901,dup,HG01345,0,,337117
14,90601080,90610079,dup,NA20877,0,,8999
14,90848544,91074011,dup,NA06984,0,,225467
14,92184192,92333818,dup,NA06984,0,,149626
14,92657141,92719427,dup,HG03875,0,,62286
14,92962211,93140111,dup,NA06984,0,,177900
14,93158419,93230205,dup,HG04140,0,,71786
14,93159364,93224206,dup,HG04140,0,,64842
14,93520242,93651063,dup,NA06984,0,,130821
14,93652920,93709427,dup,NA06984,0,,56507
14,94105354,94210013,dup,NA06984,0,,104659
14,94316013,94333306,dup,HG03025,0,,17293
14,94506497,94640326,dup,NA06984,0,,133829
14,94643301,94841337,dup,NA06984,0,,198036
14,95036002,95174194,dup,NA06984,0,,138192
14,95147916,95153344,dup,HG00097,0,,5428
14,95194315,95234720,dup,NA06984,0,,40405
14,95415693,95418858,dup,HG00256,0,,3165
14,95569857,95754539,dup,NA06984,0,,184682
14,95790417,96019300,dup,HG01052,0,,228883
14,96022364,96123770,dup,NA06984,0,,101406
14,96112696,96125345,dup,NA19456,0,,12649
14,96263473,96338662,dup,NA06984,0,,75189
14,96445677,96449856,dup,NA18612,0,,4179
14,96652817,96689743,dup,NA06984,0,,36926
14,96676168,96696299,dup,NA06984,0,,20131
14,96691296,96786259,dup,NA06984,0,,94963
14,96851405,96870140,dup,HG03672,0,,18735
14,96908344,96931471,dup,HG01679,0,,23127
14,97600495,97617036,dup,NA18974,0,,16541
14,97642016,97811232,dup,HG00100,0,,169216
14,97882656,97947291,dup,NA06984,0,,64635
14,97952320,98123635,dup,NA06984,0,,171315
14,98643066,98751734,dup,NA06984,0,,108668
14,98941378,99040792,dup,NA18628,0,,99414
14,99163852,99361475,dup,NA06984,0,,197623
14,99178192,99196485,dup,HG01064,0,,18293
14,99488671,99600993,dup,HG02343,0,,112322
14,99611982,99735908,dup,NA06984,0,,123926
14,99743946,100066897,dup,NA06984,0,,322951
14,100049668,100056267,dup,HG00610,0,,6599
14,100071343,100124461,dup,NA06984,0,,53118
14,100127062,100185076,dup,NA06984,0,,58014
14,100635922,100757302,dup,HG01495,0,,121380
14,100677926,100690205,dup,NA19003,0,,12279
14,100741794,100775469,dup,HG03784,0,,33675
14,100830665,100948069,dup,NA06984,0,,117404
14,100949878,101004394,dup,NA06984,0,,54516
14,101005158,101147708,dup,NA06984,0,,142550
14,101160516,101295032,dup,NA06984,0,,134516
14,101299058,101433242,dup,NA06984,0,,134184
14,101438422,101448848,dup,HG00130,0,,10426
14,101461351,101532406,dup,HG00099,0,,71055
14,101489331,101499396,dup,NA19451,0,,10065
14,101575819,101716200,dup,NA06984,0,,140381
14,101754603,101895908,dup,NA06984,0,,141305
14,101925811,102026080,dup,NA06984,0,,100269
14,102028747,102094525,dup,NA06984,0,,65778
14,102267755,102427340,dup,HG00185,0,,159585
14,102398976,102542660,dup,NA06984,0,,143684
14,102689828,102784248,dup,NA06984,0,,94420
14,102742051,102747644,dup,NA20504,0,,5593
14,102875200,102978945,dup,NA06984,0,,103745
14,103239183,103378037,dup,HG00304,0,,138854
14,103398196,103570863,dup,NA06984,0,,172667
14,103667407,103708022,dup,HG01806,0,,40615
14,103821437,103834863,dup,HG00598,0,,13426
14,103821489,103901125,dup,HG00598,0,,79636
14,103840245,103855283,dup,HG00598,0,,15038
14,103844299,103903992,dup,HG00598,0,,59693
14,103991118,104072746,dup,NA06984,0,,81628
14,104007443,104011430,dup,HG00335,0,,3987
14,104091115,104181193,dup,NA06984,0,,90078
14,104282978,104307108,dup,NA18636,0,,24130
14,104485881,104602445,dup,NA06984,0,,116564
14,104532643,104540958,dup,HG03163,0,,8315
14,104533058,104556044,dup,HG03163,0,,22986
14,104547208,104550920,dup,HG00105,0,,3712
14,104606457,104693540,dup,NA06984,0,,87083
14,104697299,104889173,dup,HG00186,0,,191874
14,105030835,105202213,dup,NA06984,0,,171378
14,105208054,105349844,dup,NA06984,0,,141790
14,105408692,105421617,dup,HG01443,0,,12925
14,105432322,105613911,dup,NA06984,0,,181589
14,105545960,105580558,dup,HG00105,0,,34598
14,105717945,105737184,dup,HG00634,0,,19239
14,105746933,105758195,dup,HG01628,0,,11262
14,105767207,105772355,dup,HG01628,0,,5148
14,105769981,105782805,dup,HG01628,0,,12824
14,105940019,105950877,dup,HG00097,0,,10858
14,106014637,106022478,dup,HG01060,0,,7841
14,106021206,106083160,dup,HG01060,0,,61954
14,106118172,106145752,dup,HG00139,0,,27580
14,107004951,107033659,dup,HG00452,0,,28708
14,107034460,107047852,dup,HG00332,0,,13392
14,107048799,107082667,dup,HG00739,0,,33868
14,107084938,107095083,dup,HG00099,0,,10145
14,107102740,107128955,dup,HG00099,0,,26215
14,107127166,107148415,dup,HG00099,0,,21249
14,107147166,107164532,dup,HG00155,0,,17366
14,107184257,107214698,dup,HG00099,0,,30441
14,107213469,107241301,dup,HG01863,0,,27832
14,107234016,107252803,dup,HG01873,0,,18787
14,107250311,107289542,dup,NA19197,0,,39231
15,100542027,100544157,del,NA19443,0,,2130
15,99727055,99733946,del,NA19819,0,,6891
15,24055377,24061645,del,NA20508,0,,6268
15,72288946,72291641,del,NA18867,0,,2695
15,59100957,59102084,del,HG01125,0,,1127
15,36699402,36700968,del,HG01187,0,,1566
15,60671307,60672700,del,NA18596,0,,1393
15,24673416,24720422,del,NA18596,0,,47006
15,85062716,85068322,del,NA18967,0,,5606
15,85949605,85954239,del,NA19381,0,,4634
15,89548974,89551547,del,NA19130,0,,2573
15,86538372,86548771,del,HG01550,0,,10399
15,46090396,46090969,del,HG00427,0,,573
15,73724030,73724893,del,HG00335,0,,863
15,88881333,88881697,del,NA18523,0,,364
15,45120316,45120487,del,HG00285,0,,171
15,42940634,42942308,del,NA19063,0,,1674
15,51379288,51379907,del,NA19371,0,,619
15,46255085,46257494,del,NA19436,0,,2409
15,97558730,97899813,del,HG01124,0,,341083
15,66706539,66706705,del,NA11931,0,,166
15,100051190,100057667,del,NA18486,0,,6477
15,78208075,78208468,del,NA18546,0,,393
15,46438538,46454101,del,HG00334,0,,15563
15,27483242,27483346,del,NA12878,0,,104
15,27534824,27546250,del,NA07357,0,,11426
15,54890823,54893267,del,NA11933,0,,2444
15,92674573,92677070,del,NA12043,0,,2497
15,29911564,29913694,del,NA19381,0,,2130
15,32186757,32189481,del,NA18867,0,,2724
15,76010690,76012066,del,NA18910,0,,1376
15,65816044,65819275,del,NA19783,0,,3231
15,62706092,62707792,del,HG00464,0,,1700
15,100432709,100433779,del,NA18599,0,,1070
15,44757156,44758387,del,HG01070,0,,1231
15,26880624,26883819,del,NA18616,0,,3195
15,24671016,24722922,del,NA19985,0,,51906
15,85184284,85184472,del,NA18508,0,,188
15,25037857,25039282,del,NA20348,0,,1425
15,48102834,48104361,del,HG00641,0,,1527
15,71880126,71883351,del,NA19773,0,,3225
15,76884016,76897122,del,HG00614,0,,13106
15,31447311,31451142,del,NA19788,0,,3831
15,81064981,81068946,del,NA19056,0,,3965
15,93897032,93897394,del,HG00249,0,,362
15,86057007,86059198,del,HG00133,0,,2191
15,46429348,46435371,del,NA19319,0,,6023
15,77635764,77646303,del,HG00595,0,,10539
15,75172347,75172473,del,NA18499,0,,126
15,29752966,29755617,del,HG01055,0,,2651
15,68552051,68552471,del,NA19717,0,,420
15,70504582,70506042,del,NA18613,0,,1460
15,98532621,98536469,del,NA19093,0,,3848
15,26547131,26547242,del,NA12878,0,,111
15,91045015,91045570,del,NA19920,0,,555
15,27918865,27927867,del,NA18520,0,,9002
15,67404678,67405618,del,HG01204,0,,940
15,25458462,25458605,del,NA18543,0,,143
15,36087560,36088527,del,HG00559,0,,967
15,56083024,56089192,del,NA19462,0,,6168
15,41465021,41465734,del,HG00361,0,,713
15,44122487,44123445,del,NA18603,0,,958
15,70748540,70749359,del,HG01101,0,,819
15,53974458,53977014,del,NA12827,0,,2556
15,94136216,94166318,del,NA19651,0,,30102
15,76336512,76346064,del,NA18507,0,,9552
15,31013144,31019758,del,NA20804,0,,6614
15,58336033,58345154,del,NA11843,0,,9121
15,79384386,79384535,del,NA19114,0,,149
15,83544878,83550997,del,NA19004,0,,6119
15,85202212,85202761,del,NA20544,0,,549
15,24366065,24529461,del,NA19449,0,,163396
15,89959580,89961583,del,HG00692,0,,2003
15,27633278,27633539,del,NA19463,0,,261
15,93710935,93711211,del,NA18874,0,,276
15,82582616,82745722,del,NA19399,0,,163106
15,93400109,93405793,del,NA19712,0,,5684
15,27403202,27409786,del,NA10851,0,,6584
15,84699324,84707901,del,HG00566,0,,8577
15,24672128,24722660,del,HG00366,0,,50532
15,81405691,81406544,del,HG00253,0,,853
15,35530935,35535710,del,HG00337,0,,4775
15,65243016,65247122,del,NA19209,0,,4106
15,76694919,76695944,del,NA18620,0,,1025
15,22373078,22383652,del,NA19435,0,,10574
15,86762786,86770403,del,HG00131,0,,7617
15,59610013,59611137,del,NA19818,0,,1124
15,98641938,98642586,del,NA19377,0,,648
15,22560391,22560645,del,HG00619,0,,254
15,24388186,24443942,del,NA19725,0,,55756
15,23088508,23131536,del,NA19000,0,,43028
15,76884316,76895172,del,NA18559,0,,10856
15,76166062,76175996,del,NA18986,0,,9934
15,39372373,39373481,del,HG00375,0,,1108
15,53536190,53537608,del,NA19700,0,,1418
15,100714433,100714685,del,NA19137,0,,252
15,29900616,29902022,del,HG00421,0,,1406
15,51029827,51031501,del,NA19085,0,,1674
15,34531308,34535144,del,NA19700,0,,3836
15,69592956,69593146,del,NA18624,0,,190
15,102227732,102229747,del,NA18520,0,,2015
15,77772022,77775169,del,HG01133,0,,3147
15,55010061,55015439,del,NA11843,0,,5378
15,74892823,74896449,del,NA19430,0,,3626
15,66877674,66878449,del,HG01124,0,,775
15,65618415,65618811,del,NA11831,0,,396
15,29066328,29069716,del,NA19435,0,,3388
15,95691673,95692330,del,HG00690,0,,657
15,59575014,59578802,del,NA18990,0,,3788
15,94149998,94243725,del,NA19773,0,,93727
15,47720633,47720807,del,NA19471,0,,174
15,21163126,21166373,del,NA12751,0,,3247
15,42617530,42620961,del,HG00638,0,,3431
15,47520087,47520336,del,HG00672,0,,249
15,33906532,33910716,del,NA18999,0,,4184
15,39759045,39771431,del,HG00473,0,,12386
15,25109342,25118761,del,NA19083,0,,9419
15,56705608,56714864,del,NA19379,0,,9256
15,80190559,80252586,del,NA18627,0,,62027
15,53121377,53122971,del,NA19678,0,,1594
15,24504408,24721010,del,NA19012,0,,216602
15,67647896,67649784,del,HG01080,0,,1888
15,25931396,25932380,del,NA18617,0,,984
15,76476915,76477290,del,HG00536,0,,375
15,79262797,79263246,del,NA19346,0,,449
15,23772959,23773929,del,NA19063,0,,970
15,77048927,77051682,del,NA19468,0,,2755
15,92675094,92675892,del,NA18536,0,,798
15,83551620,83557670,del,NA18942,0,,6050
15,96655378,96656043,del,NA18545,0,,665
15,92292691,92294052,del,HG00513,0,,1361
15,99561137,99562764,del,NA20752,0,,1627
15,64196439,64197540,del,NA18579,0,,1101
15,81677734,81677878,del,NA20539,0,,144
15,88960217,88963129,del,HG00500,0,,2912
15,74017262,74026265,del,HG01173,0,,9003
15,46255166,46257872,del,NA19213,0,,2706
15,64997712,65007699,del,NA20287,0,,9987
15,34253743,34254850,del,NA18595,0,,1107
15,81351029,81351465,del,HG00698,0,,436
15,42642494,42642977,del,NA20282,0,,483
15,41614954,41618181,del,NA19722,0,,3227
15,102110678,102112824,del,NA18559,0,,2146
15,56966883,56968267,del,NA19834,0,,1384
15,24486216,24488622,del,NA19070,0,,2406
15,79964829,79972251,del,NA18941,0,,7422
15,45519573,45521331,del,NA18871,0,,1758
15,101625656,101630761,del,NA18621,0,,5105
15,26322825,26324042,del,NA19360,0,,1217
15,61685198,61688112,del,NA18599,0,,2914
15,65784283,65788534,del,NA18626,0,,4251
15,96735048,96739799,del,HG00654,0,,4751
15,24382513,24384131,del,NA12347,0,,1618
15,54950897,54951134,del,NA19391,0,,237
15,56063895,56064987,del,NA19355,0,,1092
15,100416661,100423235,del,HG01440,0,,6574
15,99772253,99775831,del,NA19350,0,,3578
15,20084314,20106116,del,NA20585,0,,21802
15,25419284,25429934,del,HG00252,0,,10650
15,77199684,77200708,del,HG00171,0,,1024
15,78008485,78012583,del,HG00280,0,,4098
15,34562177,34562563,del,NA18517,0,,386
15,24673366,24721922,del,HG00472,0,,48556
15,31570019,31570564,del,NA18502,0,,545
15,71452512,71452805,del,NA12890,0,,293
15,68750781,68757202,del,NA11994,0,,6421
15,73808393,73811152,del,HG01060,0,,2759
15,92577243,92579279,del,HG01365,0,,2036
15,42988961,42995221,del,NA18517,0,,6260
15,22336853,22344093,del,NA18511,0,,7240
15,102293048,102300016,del,NA19452,0,,6968
15,97393489,97394870,del,NA18613,0,,1381
15,76674343,76677079,del,HG00534,0,,2736
15,59830676,59830848,del,NA19382,0,,172
15,84280619,84280828,del,NA19152,0,,209
15,96043616,96046001,del,NA19235,0,,2385
15,45068778,45069086,del,HG00256,0,,308
15,55655537,55657061,del,NA18561,0,,1524
15,26962006,26962290,del,NA12751,0,,284
15,69614410,69615415,del,NA19130,0,,1005
15,56517774,56532192,del,NA19428,0,,14418
15,67646166,67648440,del,HG00123,0,,2274
15,34802547,34810836,del,HG00312,0,,8289
15,92674416,92678022,del,HG00320,0,,3606
15,28262865,28265823,del,NA19383,0,,2958
15,89483970,89486563,del,NA12716,0,,2593
15,90790335,90791088,del,NA20281,0,,753
15,60206417,60207218,del,HG00258,0,,801
15,61685078,61688323,del,NA18599,0,,3245
15,70575191,70575343,del,NA19403,0,,152
15,65589798,65591798,del,NA19332,0,,2000
15,101318873,101319101,del,NA18974,0,,228
15,52388394,52389647,del,HG00707,0,,1253
15,89583728,89596251,del,HG00428,0,,12523
15,90059415,90061662,del,HG00178,0,,2247
15,34847366,34853272,del,HG01253,0,,5906
15,62624364,62624795,del,HG00657,0,,431
15,20025722,20033356,del,NA19834,0,,7634
15,24671016,24722522,del,NA19338,0,,51506
15,25116990,25118733,del,HG01461,0,,1743
15,82565877,82567801,del,NA20785,0,,1924
15,42146326,42147490,del,NA18498,0,,1164
15,91401897,91402416,del,NA19437,0,,519
15,32509316,32516172,del,NA18566,0,,6856
15,54199516,54202772,del,NA20797,0,,3256
15,42076100,42085578,del,NA19901,0,,9478
15,47242819,47243873,del,NA19776,0,,1054
15,27389585,27394495,del,NA12750,0,,4910
15,40821926,40823587,del,NA19776,0,,1661
15,99710583,99712628,del,NA12046,0,,2045
15,84578524,84579552,del,HG00556,0,,1028
15,56789861,56801000,del,NA20786,0,,11139
15,24839317,24839639,del,HG00336,0,,322
15,77851974,77853169,del,NA12283,0,,1195
15,26699342,26704584,del,HG00344,0,,5242
15,98531866,98536322,del,NA18523,0,,4456
15,100686975,100693180,del,NA19756,0,,6205
15,38267584,38268321,del,NA19434,0,,737
15,34406341,34409388,del,NA19819,0,,3047
15,83773927,83774202,del,NA19390,0,,275
15,76100649,76100980,del,NA18502,0,,331
15,50946404,50947394,del,NA20752,0,,990
15,20945596,20946011,del,NA18560,0,,415
15,44137057,44138852,del,NA20505,0,,1795
15,23973457,23975314,del,NA20348,0,,1857
15,82396618,82401737,del,HG01061,0,,5119
15,49811390,49817861,del,NA19904,0,,6471
15,24472763,24575044,del,HG00592,0,,102281
15,29901186,29903113,del,NA18615,0,,1927
15,42421403,42433815,del,NA19082,0,,12412
15,89269815,89277077,del,HG01060,0,,7262
15,76884596,76896938,del,NA11930,0,,12342
15,24368596,24532840,del,HG00332,0,,164244
15,20120430,20210609,del,HG00689,0,,90179
15,87529006,87529819,del,NA19445,0,,813
15,87440688,87441955,del,NA18987,0,,1267
15,26124152,26126044,del,NA19720,0,,1892
15,23029805,23030481,del,NA19213,0,,676
15,25436684,25438475,del,NA12058,0,,1791
15,76383643,76391051,del,HG00176,0,,7408
15,70298265,70298357,del,HG00256,0,,92
15,24538529,24543765,del,NA19676,0,,5236
15,62460565,62466832,del,NA19213,0,,6267
15,54890843,54893251,del,NA12843,0,,2408
15,28938007,28939392,del,NA19190,0,,1385
15,24489194,24587701,del,NA18567,0,,98507
15,79084263,79084355,del,NA18552,0,,92
15,35761201,35762331,del,HG00418,0,,1130
15,57587104,57587698,del,NA19717,0,,594
15,64906400,64907576,del,NA19190,0,,1176
15,72719364,72723464,del,NA19462,0,,4100
15,85489070,85496755,del,NA19700,0,,7685
15,47664461,47687602,del,NA19446,0,,23141
15,65720784,65721212,del,NA19703,0,,428
15,42752793,42754530,del,NA19060,0,,1737
15,70822709,70822833,del,HG00475,0,,124
15,34989787,34989986,del,NA18948,0,,199
15,95227310,95227953,del,NA19238,0,,643
15,31912498,31921824,del,NA18873,0,,9326
15,58458712,58465703,del,NA19660,0,,6991
15,101341487,101342370,del,NA19451,0,,883
15,26961972,26962315,del,HG00268,0,,343
15,47515284,47521843,del,HG01489,0,,6559
15,24672045,24722573,del,NA18870,0,,50528
15,56677806,56684307,del,NA19451,0,,6501
15,68351922,68352824,del,NA19399,0,,902
15,36160130,36162215,del,NA19436,0,,2085
15,64843787,64844213,del,HG00237,0,,426
15,74545946,74547605,del,NA19449,0,,1659
15,55506343,55507825,del,HG00343,0,,1482
15,39744390,39744859,del,NA18977,0,,469
15,74164205,74164387,del,HG00337,0,,182
15,93661984,93663164,del,HG00553,0,,1180
15,98153036,98154152,del,NA18941,0,,1116
15,27892736,27903824,del,HG00141,0,,11088
15,71991545,71991777,del,NA19431,0,,232
15,98760507,98762224,del,HG00274,0,,1717
15,20031995,20039096,del,NA19920,0,,7101
15,25107032,25109421,del,NA19147,0,,2389
15,67579861,67583086,del,HG01351,0,,3225
15,56486842,56492736,del,NA19701,0,,5894
15,40739409,40743381,del,NA19429,0,,3972
15,81405631,81406448,del,NA18917,0,,817
15,48567582,48570144,del,NA18572,0,,2562
15,77851745,77853169,del,NA19684,0,,1424
15,83039916,83150922,del,HG00595,0,,111006
15,101949453,101960157,del,HG00174,0,,10704
15,63200930,63209314,del,NA18982,0,,8384
15,75973124,75974363,del,NA18511,0,,1239
15,77330746,77332721,del,NA12878,0,,1975
15,25332949,25334091,del,NA18620,0,,1142
15,63763272,63764875,del,NA19701,0,,1603
15,74037232,74037403,del,HG01365,0,,171
15,23177665,23183052,del,NA19390,0,,5387
15,52428091,52428271,del,NA19463,0,,180
15,90390177,90394860,del,NA18977,0,,4683
15,64375116,64379922,del,HG00707,0,,4806
15,41604020,41604430,del,HG01112,0,,410
15,78053668,78060121,del,HG00449,0,,6453
15,43093359,43093516,del,HG00739,0,,157
15,34779516,34783122,del,HG00245,0,,3606
15,44578497,44578814,del,NA19129,0,,317
15,26399106,26401752,del,NA19108,0,,2646
15,102195058,102196502,del,NA20519,0,,1444
15,71881569,71882966,del,HG00375,0,,1397
15,56543421,56552590,del,HG01465,0,,9169
15,62669022,62669343,del,HG01107,0,,321
15,25464532,25466678,del,NA18853,0,,2146
15,89268652,89278231,del,NA20356,0,,9579
15,93857162,93866134,del,NA19172,0,,8972
15,26749172,26752412,del,HG00404,0,,3240
15,99125317,99125744,del,NA19382,0,,427
15,25420116,25430789,del,NA12155,0,,10673
15,24672916,24722522,del,HG01125,0,,49606
15,47058462,47063560,del,NA19172,0,,5098
15,99656598,99657398,del,NA18526,0,,800
15,23992086,23995938,del,NA18986,0,,3852
15,89554345,89555662,del,NA18555,0,,1317
15,90098201,90099043,del,HG00186,0,,842
15,58519099,58584866,del,HG00531,0,,65767
15,91402096,91402416,del,NA20507,0,,320
15,32361779,32362884,del,NA18549,0,,1105
15,54199918,54203165,del,NA19055,0,,3247
15,61285545,61290679,del,HG00282,0,,5134
15,35196843,35197859,del,NA19428,0,,1016
15,86340605,86350045,del,NA18519,0,,9440
15,92354990,92355971,del,NA19332,0,,981
15,43076624,43082600,del,HG00662,0,,5976
15,76336542,76346955,del,NA19625,0,,10413
15,82663416,82745722,del,NA18870,0,,82306
15,54893240,54906928,del,HG00671,0,,13688
15,96813450,96814793,del,NA19651,0,,1343
15,59842519,59933805,del,NA20790,0,,91286
15,27073825,27990329,del,NA18873,0,,916504
15,96503802,96508373,del,NA18530,0,,4571
15,29663096,29668631,del,NA19213,0,,5535
15,79844899,79845038,del,HG00253,0,,139
15,67083771,67084069,del,NA11992,0,,298
15,101581438,101583244,del,HG00536,0,,1806
15,98900070,98900636,del,HG01365,0,,566
15,65873611,65873779,del,HG01101,0,,168
15,102332716,102332622,del,NA20507,0,,-94
15,59088879,59090812,del,HG01354,0,,1933
15,82237095,82238184,del,HG01134,0,,1089
15,80394687,80407412,del,NA18558,0,,12725
15,38142300,38143393,del,HG00189,0,,1093
15,89459632,89465634,del,NA19818,0,,6002
15,90862611,90862840,del,NA19393,0,,229
15,77878004,77879183,del,HG00418,0,,1179
15,91590984,91591244,del,NA19390,0,,260
15,55175761,55185747,del,NA18577,0,,9986
15,29663916,29666972,del,NA19130,0,,3056
15,25115703,25117504,del,NA19725,0,,1801
15,86396663,86397204,del,HG00651,0,,541
15,26899404,26901455,del,NA20765,0,,2051
15,76366252,76370807,del,NA18874,0,,4555
15,48260723,48266515,del,NA18511,0,,5792
15,69316044,69317695,del,NA18520,0,,1651
15,42721015,42723644,del,NA19394,0,,2629
15,71021839,71027508,del,NA19762,0,,5669
15,98226953,98227057,del,HG00628,0,,104
15,23066394,23066528,del,HG00257,0,,134
15,24672066,24723322,del,HG00249,0,,51256
15,71881616,71883222,del,HG01187,0,,1606
15,25436588,25438493,del,NA18916,0,,1905
15,91219174,91222796,del,NA19360,0,,3622
15,100264017,100264519,del,NA18564,0,,502
15,95116011,95117026,del,HG00124,0,,1015
15,24425484,24814341,del,HG01173,0,,388857
15,31724215,31725937,del,NA19474,0,,1722
15,23685271,23686334,del,HG01183,0,,1063
15,53765720,53766078,del,NA18999,0,,358
15,86511262,86521191,del,NA12843,0,,9929
15,47483455,47487639,del,HG01440,0,,4184
15,84541434,84543848,del,HG00449,0,,2414
15,53545659,53546461,del,HG01390,0,,802
15,65461989,65463698,del,NA19399,0,,1709
15,34929786,34982969,del,HG00138,0,,53183
15,31254722,31256306,del,HG00156,0,,1584
15,71474410,71477936,del,NA12763,0,,3526
15,68262339,68264916,del,HG00693,0,,2577
15,101122429,101122777,del,HG01359,0,,348
15,58231568,58235270,del,NA19462,0,,3702
15,55010122,55015516,del,NA11843,0,,5394
15,39837738,39839292,del,NA18542,0,,1554
15,46860707,46861168,del,NA18486,0,,461
15,68418322,68419172,del,HG00418,0,,850
15,24495463,24598612,del,HG00457,0,,103149
15,47972907,47974111,del,NA19789,0,,1204
15,101694929,101696266,del,NA19437,0,,1337
15,25810782,25815044,del,HG00427,0,,4262
15,51897716,51898058,del,NA07357,0,,342
15,42389098,42392357,del,NA19130,0,,3259
15,77588621,77590383,del,NA19473,0,,1762
15,70599544,70603666,del,NA19466,0,,4122
15,24673409,24763062,del,HG00188,0,,89653
15,99574511,99575638,del,NA18610,0,,1127
15,91981577,91989265,del,HG00377,0,,7688
15,27028691,27030100,del,NA12775,0,,1409
15,67868338,67869360,del,NA18536,0,,1022
15,42585816,42587124,del,NA19391,0,,1308
15,94614505,94642484,del,NA19469,0,,27979
15,39525848,39526509,del,NA19077,0,,661
15,101195175,101201732,del,NA19428,0,,6557
15,83275270,83275581,del,NA12414,0,,311
15,91364498,91364780,del,NA18933,0,,282
15,41669960,41670693,del,NA19469,0,,733
15,98780652,98784318,del,NA19384,0,,3666
15,52375793,52378346,del,NA19066,0,,2553
15,61285474,61290621,del,HG00282,0,,5147
15,89602085,89610321,del,NA12058,0,,8236
15,64901763,64904602,del,NA19713,0,,2839
15,45154113,45160093,del,NA19381,0,,5980
15,52302573,52307359,del,HG01080,0,,4786
15,73483765,73483819,del,HG00634,0,,54
15,89868324,89868426,del,NA18609,0,,102
15,24411621,24799746,del,NA19332,0,,388125
15,25302486,25304102,del,NA19468,0,,1616
15,93836181,93838543,del,HG00178,0,,2362
15,56806093,56806798,del,NA19059,0,,705
15,64440047,64441547,del,NA19007,0,,1500
15,62955607,62956997,del,NA19005,0,,1390
15,48207005,48215250,del,HG00692,0,,8245
15,100506915,100507986,del,NA18950,0,,1071
15,91563226,91567483,del,HG00611,0,,4257
15,80199883,80201079,del,NA18909,0,,1196
15,85242935,85243739,del,HG01440,0,,804
15,100340154,100340258,del,HG00662,0,,104
15,93314479,93315988,del,NA19209,0,,1509
15,68983566,68984222,del,HG00443,0,,656
15,80110684,80110971,del,HG01079,0,,287
15,49544863,49547854,del,NA12004,0,,2991
15,72223509,72225077,del,HG00418,0,,1568
15,53644462,53647139,del,NA18620,0,,2677
15,70388116,70394322,del,HG00343,0,,6206
15,24496141,24604740,del,NA18541,0,,108599
15,45570037,45570183,del,NA18870,0,,146
15,24396527,24401752,del,HG01080,0,,5225
15,84852620,85731716,del,HG01383,0,,879096
15,35683986,35721544,del,HG00262,0,,37558
15,67290798,67290908,del,HG00254,0,,110
15,24688313,24738684,del,HG00458,0,,50371
15,24219412,24226824,del,HG00247,0,,7412
15,73791516,73807593,del,HG01060,0,,16077
15,54443619,54444774,del,NA18599,0,,1155
15,100609938,100612651,del,NA19009,0,,2713
15,78849063,78850703,del,NA18546,0,,1640
15,102394650,102441539,del,NA19982,0,,46889
15,30971298,30974862,del,NA19982,0,,3564
15,45131855,45145844,del,NA19239,0,,13989
15,96581669,96583010,del,NA19451,0,,1341
15,53880898,53881831,del,NA19720,0,,933
15,79804633,79804992,del,HG01334,0,,359
15,22154267,22156991,del,NA19439,0,,2724
15,61686955,61698819,del,HG01378,0,,11864
15,24350604,24508554,del,HG01061,0,,157950
15,92293845,92294220,del,NA20525,0,,375
15,72571927,72575577,del,NA19469,0,,3650
15,20007178,20012964,del,NA19818,0,,5786
15,51191390,51191688,del,NA19359,0,,298
15,87905744,87910458,del,NA19359,0,,4714
15,22803216,22807622,del,NA19347,0,,4406
15,93646487,93647656,del,NA18870,0,,1169
15,85426716,85428433,del,NA19107,0,,1717
15,25472291,25477569,del,NA19152,0,,5278
15,98002745,98003333,del,NA11930,0,,588
15,91335604,91336633,del,NA20289,0,,1029
15,83296992,83457792,del,NA12891,0,,160800
15,51586185,51586377,del,NA19819,0,,192
15,32271864,32272060,del,NA18611,0,,196
15,41712061,41713950,del,NA18990,0,,1889
15,51120012,51125285,del,HG01437,0,,5273
15,83414236,83415892,del,HG01188,0,,1656
15,101043868,101044579,del,NA19453,0,,711
15,42403409,42409178,del,NA19396,0,,5769
15,24826851,25074609,del,NA20755,0,,247758
15,20581463,20589613,del,HG00150,0,,8150
15,100416866,100422122,del,NA18549,0,,5256
15,45134569,45137244,del,NA19380,0,,2675
15,71027704,71053126,del,NA18572,0,,25422
15,30199651,30201250,del,HG00421,0,,1599
15,87299354,87299762,del,NA19147,0,,408
15,24643409,24816395,del,HG00384,0,,172986
15,66809566,66810622,del,HG00683,0,,1056
15,74559812,74560121,del,NA19818,0,,309
15,28419387,28924388,del,HG00437,0,,505001
15,100339984,100340393,del,NA19438,0,,409
15,50921353,50921795,del,NA20287,0,,442
15,53096516,53098622,del,NA19439,0,,2106
15,82582916,82657022,del,HG00577,0,,74106
15,101385024,101385246,del,NA19404,0,,222
15,70254064,70258213,del,NA19916,0,,4149
15,26407767,26409005,del,NA19436,0,,1238
15,65784310,65788430,del,NA18559,0,,4120
15,98705998,98706417,del,NA20299,0,,419
15,66706536,66706683,del,NA12399,0,,147
15,100415016,100424522,del,NA19655,0,,9506
15,77996670,77996958,del,NA19116,0,,288
15,35588989,35589148,del,NA18595,0,,159
15,23040982,23042242,del,NA18549,0,,1260
15,93766173,93773417,del,NA19080,0,,7244
15,89774820,89776758,del,NA18961,0,,1938
15,72417866,72419239,del,NA18523,0,,1373
15,58596496,58596817,del,HG00708,0,,321
15,77660772,77673901,del,HG00284,0,,13129
15,84604983,84606942,del,NA19434,0,,1959
15,56529152,56532381,del,NA18990,0,,3229
15,63267345,63269176,del,NA18638,0,,1831
15,30083263,30084267,del,NA20772,0,,1004
15,85821675,85821973,del,NA18988,0,,298
15,69622821,69624127,del,NA19720,0,,1306
15,75867342,75867566,del,HG01173,0,,224
15,39520102,39520442,del,NA18961,0,,340
15,51518854,51519950,del,NA19383,0,,1096
15,44993251,44996504,del,NA18910,0,,3253
15,94736386,94749378,del,NA19081,0,,12992
15,86946057,86946803,del,NA19403,0,,746
15,58912848,58913166,del,NA18613,0,,318
15,64664107,64664226,del,HG00140,0,,119
15,56060180,56062836,del,HG01108,0,,2656
15,27469997,27471790,del,NA20296,0,,1793
15,25109816,25119322,del,NA19083,0,,9506
15,29530236,29534555,del,NA20512,0,,4319
15,97261353,97269096,del,NA20768,0,,7743
15,44238157,44246356,del,HG00592,0,,8199
15,77635817,77646469,del,HG00577,0,,10652
15,35136434,35136775,del,NA19819,0,,341
15,62392911,62394146,del,NA19452,0,,1235
15,61003055,61008226,del,HG00343,0,,5171
15,84071231,84072200,del,NA19316,0,,969
15,25332998,25334140,del,NA19313,0,,1142
15,70486325,70488579,del,NA20819,0,,2254
15,90505478,90510981,del,NA19152,0,,5503
15,88053816,88060422,del,HG00284,0,,6606
15,93400154,93405872,del,NA19712,0,,5718
15,48640517,48648052,del,NA12763,0,,7535
15,98842324,98843807,del,NA19385,0,,1483
15,56447942,56448910,del,HG01140,0,,968
15,27913429,27913815,del,HG00342,0,,386
15,36107608,36108772,del,NA18950,0,,1164
15,89868331,89868486,del,NA19385,0,,155
15,37389816,37394522,del,HG00607,0,,4706
15,67404687,67405618,del,HG01101,0,,931
15,76087730,76098677,del,NA18546,0,,10947
15,100506956,100507720,del,NA18950,0,,764
15,71671478,71673154,del,NA19664,0,,1676
15,75237387,75240040,del,NA18635,0,,2653
15,66877737,66878378,del,NA12249,0,,641
15,59249409,59249950,del,HG00449,0,,541
15,92702397,92705433,del,HG01342,0,,3036
15,69369664,69370526,del,NA18963,0,,862
15,66097893,66103652,del,NA18908,0,,5759
15,85055294,85075337,del,HG01070,0,,20043
15,45735399,45735972,del,HG00683,0,,573
15,95838199,95839082,del,HG00448,0,,883
15,77851829,77853160,del,NA19684,0,,1331
15,72017124,72017484,del,NA18595,0,,360
15,85062716,85069322,del,NA18539,0,,6606
15,42845266,42846731,del,HG01051,0,,1465
15,86762748,86770386,del,HG00131,0,,7638
15,24819036,24823265,del,HG01183,0,,4229
15,95989992,95994821,del,NA18853,0,,4829
15,100415066,100422372,del,NA19002,0,,7306
15,24393951,24449968,del,HG01080,0,,56017
15,94594868,94595469,del,HG00271,0,,601
15,89270394,89275569,del,HG01060,0,,5175
15,80521068,80526743,del,NA18632,0,,5675
15,84086162,84089423,del,NA19468,0,,3261
15,23685546,23686511,del,HG00377,0,,965
15,50747172,50747665,del,HG00123,0,,493
15,48340517,48343213,del,NA19900,0,,2696
15,46067964,46068314,del,NA19099,0,,350
15,75479676,75480310,del,NA19472,0,,634
15,90535009,90537708,del,NA19236,0,,2699
15,66877816,66878172,del,HG00123,0,,356
15,34741748,34742029,del,NA19334,0,,281
15,25459839,25460046,del,NA18543,0,,207
15,93888903,93890978,del,HG00607,0,,2075
15,24422766,24638415,del,HG00351,0,,215649
15,37270019,37279935,del,NA18963,0,,9916
15,39562630,39564293,del,NA12249,0,,1663
15,60073153,60103849,del,HG00148,0,,30696
15,43468781,43470325,del,NA19470,0,,1544
15,22802216,22807922,del,NA18567,0,,5706
15,25065537,25085018,del,NA19248,0,,19481
15,23162216,23163411,del,NA12155,0,,1195
15,45224267,45235240,del,HG01102,0,,10973
15,96597426,96599898,del,NA19462,0,,2472
15,65598040,65601515,del,NA20813,0,,3475
15,31296668,31300057,del,NA19374,0,,3389
15,74672086,74672809,del,HG00338,0,,723
15,76336586,76346675,del,NA19248,0,,10089
15,76884816,76895372,del,NA20773,0,,10556
15,80166503,80171375,del,NA20826,0,,4872
15,34200447,34200714,del,NA18944,0,,267
15,65026068,65027802,del,NA19404,0,,1734
15,89868364,89868423,del,HG00257,0,,59
15,81773728,81781589,del,HG01342,0,,7861
15,20056807,20099024,dup,HG02594,0,,42217
15,22295225,22338164,dup,HG01311,0,,42939
15,22343965,22372302,dup,HG01311,0,,28337
15,22372936,22383193,dup,HG00096,0,,10257
15,22383477,22434169,dup,HG01177,0,,50692
15,22446739,22506103,dup,HG01311,0,,59364
15,22514833,22542530,dup,HG01311,0,,27697
15,22535611,22557517,dup,HG01311,0,,21906
15,22565057,22590778,dup,HG01311,0,,25721
15,22752995,23086836,dup,HG00236,0,,333841
15,22753978,22790909,dup,HG00263,0,,36931
15,22834309,22851388,dup,HG00263,0,,17079
15,22848602,22871151,dup,HG00263,0,,22549
15,22968845,23054143,dup,HG00263,0,,85298
15,23090451,23131176,dup,HG00263,0,,40725
15,23128332,23161536,dup,HG00263,0,,33204
15,23175488,23217043,dup,HG00263,0,,41555
15,23214022,23251599,dup,HG00263,0,,37577
15,23619784,23671044,dup,HG00128,0,,51260
15,23701551,23848671,dup,HG00524,0,,147120
15,23968712,23973258,dup,HG00732,0,,4546
15,24031828,24198614,dup,NA20757,0,,166786
15,24350936,24389975,dup,HG00096,0,,39039
15,24377380,24438730,dup,HG00096,0,,61350
15,24450166,24484075,dup,HG00096,0,,33909
15,24495296,24502596,dup,HG00096,0,,7300
15,24508886,24546084,dup,HG00123,0,,37198
15,24539629,24559691,dup,HG00123,0,,20062
15,24569304,24618731,dup,HG00123,0,,49427
15,24598185,24652901,dup,HG00123,0,,54716
15,24675105,24720472,dup,HG00100,0,,45367
15,24723979,24774154,dup,HG00188,0,,50175
15,24816623,24958608,dup,HG04173,0,,141985
15,24976293,24991998,dup,HG04173,0,,15705
15,25242309,25245858,dup,HG02439,0,,3549
15,25982940,25992405,dup,NA20757,0,,9465
15,26570053,26580097,dup,HG04186,0,,10044
15,26622909,26625911,dup,HG02946,0,,3002
15,26749086,26752336,dup,HG00159,0,,3250
15,26753837,26764788,dup,HG00129,0,,10951
15,27312272,27319609,dup,HG01444,0,,7337
15,28343591,28439869,dup,HG02143,0,,96278
15,28353161,28366578,dup,HG00112,0,,13417
15,28377687,28444143,dup,HG02143,0,,66456
15,28477852,28539259,dup,HG02384,0,,61407
15,28549862,28564312,dup,HG00107,0,,14450
15,28958816,28970869,dup,HG00593,0,,12053
15,29567486,29575584,dup,HG01058,0,,8098
15,29681781,29685374,dup,HG00101,0,,3593
15,29876216,29900238,dup,HG03490,0,,24022
15,30920779,30992231,dup,HG00244,0,,71452
15,31011238,31094725,dup,HG01802,0,,83487
15,31024767,31965475,dup,HG00106,0,,940708
15,31110505,31330839,dup,HG00141,0,,220334
15,31363407,31617279,dup,HG00141,0,,253872
15,31617781,31671152,dup,HG00141,0,,53371
15,31898857,32030945,dup,HG00096,0,,132088
15,32020929,32100435,dup,HG00244,0,,79506
15,32060172,32271079,dup,HG00141,0,,210907
15,32108157,32146643,dup,HG00244,0,,38486
15,32140606,32173242,dup,HG00141,0,,32636
15,32168050,32234962,dup,HG00244,0,,66912
15,32269594,32347873,dup,HG00106,0,,78279
15,32285326,32446221,dup,HG00141,0,,160895
15,32317244,32415591,dup,HG00244,0,,98347
15,32504287,32519739,dup,HG00261,0,,15452
15,34170206,34183139,dup,HG02728,0,,12933
15,34217240,34280179,dup,HG01173,0,,62939
15,34219505,34277327,dup,HG01173,0,,57822
15,34402349,34428355,dup,HG00654,0,,26006
15,34531003,34535142,dup,HG03052,0,,4139
15,34721236,34836826,dup,HG00118,0,,115590
15,35242899,35270130,dup,HG02013,0,,27231
15,35702104,35722454,dup,HG00262,0,,20350
15,36369968,36386705,dup,HG04239,0,,16737
15,37198996,37387450,dup,HG00365,0,,188454
15,37199325,37930926,dup,HG00365,0,,731601
15,37203374,37247911,dup,HG00365,0,,44537
15,37406689,37670705,dup,HG00365,0,,264016
15,37650859,37732580,dup,HG00365,0,,81721
15,37726229,37775236,dup,HG02013,0,,49007
15,37769152,37890250,dup,HG00365,0,,121098
15,37792931,37932775,dup,HG00365,0,,139844
15,38865170,38872950,dup,HG03896,0,,7780
15,39075682,39113865,dup,HG02140,0,,38183
15,41419327,41430746,dup,NA20910,0,,11419
15,41593339,41617356,dup,HG02154,0,,24017
15,42050678,42115858,dup,HG03886,0,,65180
15,42062939,42116502,dup,HG03886,0,,53563
15,42403401,42407889,dup,HG01105,0,,4488
15,43149805,43277261,dup,NA19920,0,,127456
15,43199687,43270508,dup,NA19920,0,,70821
15,43407738,43418089,dup,HG01600,0,,10351
15,43891183,43901376,dup,HG00102,0,,10193
15,43921219,43947721,dup,HG00117,0,,26502
15,43989562,44039659,dup,HG01992,0,,50097
15,45109276,45117476,dup,HG01345,0,,8200
15,45129530,45146345,dup,HG02307,0,,16815
15,45160112,45176440,dup,HG02577,0,,16328
15,45212083,45226541,dup,HG02577,0,,14458
15,45224381,45236351,dup,HG00108,0,,11970
15,45233886,45250692,dup,HG02577,0,,16806
15,45252965,45261443,dup,HG02577,0,,8478
15,45267243,45294597,dup,HG02577,0,,27354
15,45289507,45307564,dup,NA19315,0,,18057
15,45563609,45597992,dup,NA19625,0,,34383
15,45563932,45612999,dup,NA19625,0,,49067
15,45878584,45886178,dup,HG02982,0,,7594
15,46056442,46157070,dup,HG03629,0,,100628
15,46135432,46263814,dup,HG03629,0,,128382
15,46291891,46486276,dup,NA18639,0,,194385
15,48614220,48639276,dup,NA11829,0,,25056
15,49184285,49187842,dup,NA18939,0,,3557
15,49646282,49701048,dup,HG02128,0,,54766
15,49753195,49758200,dup,NA18966,0,,5005
15,50390907,50459139,dup,HG04153,0,,68232
15,50926678,50978283,dup,NA19067,0,,51605
15,51072857,51085245,dup,NA11894,0,,12388
15,51309847,51454697,dup,NA19000,0,,144850
15,51314534,51378205,dup,NA19000,0,,63671
15,51314780,51774851,dup,NA19000,0,,460071
15,51472157,51498877,dup,NA18616,0,,26720
15,52281917,52287993,dup,NA19043,0,,6076
15,53849377,53887521,dup,NA20276,0,,38144
15,53887397,54200577,dup,HG03971,0,,313180
15,54006653,54065388,dup,HG03971,0,,58735
15,54070230,54096955,dup,HG01707,0,,26725
15,54132170,54201985,dup,HG03971,0,,69815
15,54203606,54288327,dup,HG03971,0,,84721
15,54292386,54460764,dup,HG03971,0,,168378
15,54743615,54757741,dup,HG04188,0,,14126
15,54990863,55065730,dup,HG02799,0,,74867
15,54992674,55032095,dup,HG02799,0,,39421
15,55670580,55706728,dup,NA12413,0,,36148
15,56025076,56059674,dup,HG01536,0,,34598
15,56249127,56266189,dup,HG03259,0,,17062
15,56279068,56313704,dup,HG04107,0,,34636
15,56775333,56825770,dup,HG01077,0,,50437
15,57564727,57595620,dup,HG02419,0,,30893
15,57642633,57719185,dup,HG02661,0,,76552
15,57642650,57780422,dup,HG02661,0,,137772
15,58387209,58417325,dup,HG02784,0,,30116
15,59626084,59644104,dup,HG02811,0,,18020
15,59825227,59841327,dup,NA18642,0,,16100
15,59927919,59969965,dup,HG04210,0,,42046
15,59942338,59962039,dup,HG04210,0,,19701
15,60627203,60631411,dup,NA11931,0,,4208
15,62388718,62392193,dup,HG01372,0,,3475
15,62600195,62613267,dup,HG00599,0,,13072
15,62651508,62669393,dup,NA18940,0,,17885
15,63380506,63547621,dup,NA19225,0,,167115
15,63456921,63492811,dup,NA19225,0,,35890
15,64152654,64302980,dup,HG00242,0,,150326
15,64457238,64465872,dup,HG03960,0,,8634
15,66421109,66429777,dup,HG03727,0,,8668
15,67032054,67056004,dup,HG01494,0,,23950
15,69503484,69522447,dup,NA11894,0,,18963
15,70923991,70928768,dup,HG03478,0,,4777
15,71614496,71629438,dup,HG01438,0,,14942
15,71958800,71964651,dup,HG02727,0,,5851
15,74081475,74105577,dup,HG01516,0,,24102
15,74111064,74168107,dup,HG01516,0,,57043
15,74312895,74348935,dup,NA12813,0,,36040
15,75457571,75503353,dup,HG01777,0,,45782
15,75655921,75670680,dup,HG02060,0,,14759
15,76200572,76318279,dup,HG02816,0,,117707
15,76884546,76895794,dup,HG00096,0,,11248
15,77075862,77087057,dup,HG02224,0,,11195
15,78250040,78310321,dup,HG01148,0,,60281
15,78418667,78436866,dup,NA12827,0,,18199
15,78691893,78702316,dup,HG00707,0,,10423
15,78950952,79003708,dup,HG02715,0,,52756
15,79114704,79125527,dup,HG04161,0,,10823
15,79734821,79748179,dup,NA21133,0,,13358
15,81065083,81070088,dup,NA19056,0,,5005
15,81860504,81945842,dup,HG02146,0,,85338
15,81959250,82087447,dup,NA19089,0,,128197
15,81989435,82062642,dup,NA19089,0,,73207
15,82044652,82199031,dup,HG02146,0,,154379
15,82553298,82610077,dup,HG00096,0,,56779
15,83259037,83395363,dup,HG03796,0,,136326
15,83549431,83598126,dup,HG01613,0,,48695
15,83611746,83733245,dup,HG01613,0,,121499
15,84156039,84304141,dup,HG02307,0,,148102
15,84689272,84708570,dup,HG00566,0,,19298
15,84760164,84770267,dup,HG00267,0,,10103
15,84917937,84956990,dup,HG00674,0,,39053
15,85068707,85107177,dup,NA19473,0,,38470
15,85122060,85150725,dup,HG02885,0,,28665
15,85143692,85240782,dup,HG02885,0,,97090
15,85172627,85179823,dup,HG02325,0,,7196
15,85188419,85225341,dup,HG02885,0,,36922
15,85402179,85446833,dup,NA20868,0,,44654
15,85788985,85812169,dup,HG01440,0,,23184
15,85822261,85835903,dup,NA19043,0,,13642
15,85834858,86008105,dup,HG02684,0,,173247
15,85928116,86011310,dup,HG02684,0,,83194
15,85995335,86056785,dup,NA19043,0,,61450
15,86064810,86182627,dup,HG00235,0,,117817
15,86097329,86177229,dup,NA19043,0,,79900
15,86351269,86391608,dup,HG03461,0,,40339
15,86367874,86392990,dup,HG03461,0,,25116
15,86629060,86633114,dup,HG00445,0,,4054
15,87671283,87686769,dup,HG02643,0,,15486
15,87830737,87884134,dup,HG00101,0,,53397
15,88095836,88140859,dup,HG01571,0,,45023
15,89581919,89667492,dup,HG03479,0,,85573
15,89583476,89663289,dup,NA12340,0,,79813
15,90070570,90119334,dup,NA12414,0,,48764
15,90396722,90409772,dup,HG02715,0,,13050
15,90566166,90572367,dup,HG04018,0,,6201
15,90627771,90648520,dup,NA19209,0,,20749
15,90727973,90778908,dup,NA19093,0,,50935
15,90785994,90790600,dup,HG01893,0,,4606
15,90795764,90809397,dup,HG03781,0,,13633
15,90828092,90840618,dup,HG01776,0,,12526
15,91379749,91390950,dup,NA19403,0,,11201
15,92204147,92226871,dup,NA19747,0,,22724
15,93040629,93123784,dup,HG01597,0,,83155
15,93126894,93148314,dup,HG01597,0,,21420
15,93500962,93512561,dup,HG01880,0,,11599
15,93681839,93695120,dup,NA18577,0,,13281
15,93804858,93822223,dup,NA18856,0,,17365
15,93891393,93908702,dup,HG00580,0,,17309
15,93917579,93978253,dup,HG03888,0,,60674
15,94136998,94166485,dup,NA19651,0,,29487
15,94567593,94748770,dup,NA20911,0,,181177
15,94567981,94796520,dup,HG02737,0,,228539
15,94773151,94829155,dup,NA20911,0,,56004
15,94794493,94801577,dup,HG02722,0,,7084
15,94806355,94817279,dup,HG02737,0,,10924
15,96068276,96072609,dup,HG02549,0,,4333
15,96472910,96521571,dup,HG02774,0,,48661
15,97635603,97675137,dup,HG01124,0,,39534
15,97683925,97758558,dup,HG01124,0,,74633
15,97759059,97900324,dup,HG01124,0,,141265
15,97878439,97922137,dup,NA18621,0,,43698
15,98629488,98643415,dup,HG02613,0,,13927
15,98853448,98870989,dup,NA18868,0,,17541
15,99142554,99150455,dup,HG01064,0,,7901
15,99432728,99510759,dup,NA18977,0,,78031
15,99433223,99509551,dup,NA19063,0,,76328
15,99434679,99465112,dup,NA19063,0,,30433
15,99756579,99909363,dup,NA18868,0,,152784
15,100248964,100852117,dup,HG02678,0,,603153
15,100281102,100327054,dup,HG01956,0,,45952
15,100281389,100340679,dup,HG01956,0,,59290
15,100417307,100600292,dup,HG01464,0,,182985
15,100423312,100439854,dup,HG01464,0,,16542
15,100445000,100487483,dup,HG01464,0,,42483
15,100496639,100514033,dup,HG00620,0,,17394
15,100509723,100599112,dup,NA20294,0,,89389
15,100621125,100680759,dup,NA20294,0,,59634
15,100632987,100639510,dup,NA20294,0,,6523
15,100640626,100685920,dup,NA20294,0,,45294
15,100674575,100754798,dup,HG02384,0,,80223
15,100780505,100847689,dup,HG02678,0,,67184
15,100851435,101048561,dup,HG03914,0,,197126
15,100857642,100978126,dup,HG03914,0,,120484
15,101002015,101030203,dup,HG03914,0,,28188
15,101048562,101143986,dup,HG03914,0,,95424
15,101101755,101140630,dup,HG03914,0,,38875
15,101321940,101415818,dup,HG00183,0,,93878
15,101478508,101495795,dup,HG00183,0,,17287
15,101502192,101577956,dup,HG00183,0,,75764
15,101616519,101646148,dup,HG00183,0,,29629
15,101732897,101903642,dup,NA12815,0,,170745
15,101919294,101991196,dup,NA12815,0,,71902
15,102026462,102086627,dup,HG02813,0,,60165
15,102060482,102143136,dup,HG02813,0,,82654
15,102146712,102201607,dup,HG01762,0,,54895
15,102156604,102275100,dup,HG01762,0,,118496
15,102210429,102294690,dup,HG01762,0,,84261
15,102331823,102395530,dup,HG00436,0,,63707
15,102335374,102369274,dup,HG00121,0,,33900
15,102412018,102432535,dup,HG00109,0,,20517
16,5174080,5186090,del,HG01366,0,,12010
16,17664258,17664873,del,HG01365,0,,615
16,9445108,9445699,del,NA20507,0,,591
16,8755317,8756880,del,NA19077,0,,1563
16,3918273,3918501,del,NA18961,0,,228
16,58945819,58954315,del,NA18632,0,,8496
16,28133231,28134754,del,HG01365,0,,1523
16,20100057,20109354,del,NA19383,0,,9297
16,25543262,25544231,del,NA18520,0,,969
16,88314737,88314868,del,NA18548,0,,131
16,80366403,80372529,del,NA19311,0,,6126
16,78371638,78384898,del,HG00334,0,,13260
16,33537416,33539750,del,NA19900,0,,2334
16,12688669,12706424,del,NA19213,0,,17755
16,62828372,62841296,del,HG01075,0,,12924
16,87828185,87831536,del,NA19701,0,,3351
16,56617025,56617359,del,NA19078,0,,334
16,52412371,52414843,del,NA12400,0,,2472
16,8159114,8159762,del,NA19116,0,,648
16,17475748,17479746,del,NA19779,0,,3998
16,79224152,79225167,del,NA12778,0,,1015
16,86483136,86483763,del,NA18510,0,,627
16,87772136,87773062,del,NA19726,0,,926
16,72244692,72252873,del,NA19684,0,,8181
16,84057285,84058135,del,NA20806,0,,850
16,154193,160126,del,HG00513,0,,5933
16,4785869,4788336,del,NA19075,0,,2467
16,33589135,33599678,del,NA19818,0,,10543
16,73771316,73778366,del,NA12003,0,,7050
16,89418285,89419670,del,NA19904,0,,1385
16,86630339,86630852,del,HG00421,0,,513
16,69063764,69066535,del,NA18985,0,,2771
16,23509617,23514643,del,HG00125,0,,5026
16,70010109,70237225,del,NA18614,0,,227116
16,9125945,9126588,del,HG00464,0,,643
16,11468966,11469431,del,HG00178,0,,465
16,31256130,31256426,del,HG01440,0,,296
16,13623758,13624689,del,NA20783,0,,931
16,89713972,89714812,del,NA06986,0,,840
16,89900667,89901095,del,NA19818,0,,428
16,78171665,78172344,del,NA20317,0,,679
16,24606998,24608189,del,NA19453,0,,1191
16,50223517,50225075,del,NA19713,0,,1558
16,6957738,6958440,del,HG00138,0,,702
16,52293556,52294388,del,HG01366,0,,832
16,87932444,87933012,del,HG00702,0,,568
16,88155588,88156040,del,NA19678,0,,452
16,3420631,3424940,del,HG01350,0,,4309
16,1002952,1003976,del,HG00463,0,,1024
16,67253665,67253981,del,HG01108,0,,316
16,59308333,59309094,del,HG00479,0,,761
16,32346079,33340418,del,HG00124,0,,994339
16,32296848,33184731,del,HG00346,0,,887883
16,34296949,34299081,del,NA18861,0,,2132
16,1003493,1004019,del,HG00542,0,,526
16,896772,897098,del,HG00138,0,,326
16,19945550,19967579,del,HG01365,0,,22029
16,31148868,31149162,del,HG01067,0,,294
16,46451207,46454939,del,NA18944,0,,3732
16,76539133,76544026,del,NA18980,0,,4893
16,87146732,87155030,del,NA19379,0,,8298
16,60910036,60913923,del,NA18566,0,,3887
16,81154827,81157221,del,NA18561,0,,2394
16,87418967,87421316,del,HG01137,0,,2349
16,47834527,47852130,del,NA18628,0,,17603
16,6422445,6423453,del,HG00449,0,,1008
16,6836862,6888632,del,NA20756,0,,51770
16,88196672,88196942,del,HG01072,0,,270
16,24126508,24126818,del,HG00331,0,,310
16,76716500,76719050,del,HG00264,0,,2550
16,87710313,87710962,del,NA19471,0,,649
16,11841493,11842927,del,HG00369,0,,1434
16,32297009,33237999,del,NA18619,0,,940990
16,68005832,68006509,del,HG01440,0,,677
16,85302491,85304390,del,NA19651,0,,1899
16,2658375,2670418,del,HG00281,0,,12043
16,65879890,65884662,del,HG00133,0,,4772
16,89015767,89016219,del,NA18507,0,,452
16,10726983,10729964,del,HG01462,0,,2981
16,485702,487882,del,NA18990,0,,2180
16,29558757,29559160,del,NA19391,0,,403
16,4067048,4067528,del,NA19725,0,,480
16,7062008,7082758,del,NA18593,0,,20750
16,75383615,75385839,del,NA19982,0,,2224
16,55795116,55822322,del,HG00449,0,,27206
16,64589048,64590984,del,NA19152,0,,1936
16,51185016,51189922,del,NA19350,0,,4906
16,235340,235602,del,NA19381,0,,262
16,89190794,89197711,del,NA20795,0,,6917
16,12338271,12343518,del,HG00705,0,,5247
16,62046861,62047194,del,NA20531,0,,333
16,31526936,31821543,del,NA19703,0,,294607
16,48126458,48127573,del,NA19469,0,,1115
16,11299573,11302468,del,NA20533,0,,2895
16,47118478,47121843,del,NA18989,0,,3365
16,4878134,4879737,del,HG01389,0,,1603
16,3703743,3719647,del,HG00734,0,,15904
16,4952254,4957057,del,HG00592,0,,4803
16,67537010,67537310,del,HG00656,0,,300
16,998031,1000193,del,HG01133,0,,2162
16,34684747,34685242,del,NA20506,0,,495
16,11523565,11600116,del,NA19076,0,,76551
16,826440,827348,del,NA18940,0,,908
16,4677540,4678139,del,NA19321,0,,599
16,78293341,78295646,del,HG00353,0,,2305
16,62221072,62223928,del,NA19067,0,,2856
16,78761950,78772498,del,NA19064,0,,10548
16,57332378,57334202,del,NA18628,0,,1824
16,48965726,48965892,del,NA19670,0,,166
16,81756658,81759551,del,NA19070,0,,2893
16,4403330,4412775,del,NA19058,0,,9445
16,77148437,77149288,del,NA18547,0,,851
16,88562297,88564595,del,NA18907,0,,2298
16,68061682,68063128,del,NA19676,0,,1446
16,35232612,35273410,del,NA19713,0,,40798
16,30083337,30085366,del,HG01170,0,,2029
16,86087366,86095744,del,NA18964,0,,8378
16,66735877,66738934,del,NA19313,0,,3057
16,88112731,88115667,del,NA18942,0,,2936
16,29131635,29134048,del,NA19108,0,,2413
16,83883840,83886904,del,HG00654,0,,3064
16,58203387,58205354,del,NA18933,0,,1967
16,24126535,24126822,del,HG01110,0,,287
16,54408012,54419653,del,NA20757,0,,11641
16,72571558,72590096,del,HG00182,0,,18538
16,84429946,84431802,del,NA20340,0,,1856
16,83243635,83244681,del,HG00263,0,,1046
16,77090640,77092865,del,NA18559,0,,2225
16,79026219,79039150,del,NA19257,0,,12931
16,29005318,29005755,del,NA19786,0,,437
16,26916920,26919504,del,NA20289,0,,2584
16,62814846,62817047,del,NA19819,0,,2201
16,477853,480781,del,NA19701,0,,2928
16,8826048,8827724,del,NA19189,0,,1676
16,68617341,68623408,del,NA18910,0,,6067
16,14470517,14470809,del,NA19920,0,,292
16,59195187,59196674,del,NA11893,0,,1487
16,87828361,87831463,del,NA19257,0,,3102
16,25116026,25116994,del,NA19701,0,,968
16,85242394,85242527,del,HG00324,0,,133
16,7338482,7341938,del,NA20543,0,,3456
16,90131010,90137150,del,NA19474,0,,6140
16,1407676,1408990,del,HG01140,0,,1314
16,76168648,76168753,del,NA19658,0,,105
16,8354172,8415537,del,NA19390,0,,61365
16,294783,296871,del,NA19920,0,,2088
16,85040445,85043179,del,NA18861,0,,2734
16,1186738,1186878,del,NA19084,0,,140
16,53713456,53713559,del,NA19080,0,,103
16,34336815,34337356,del,NA19909,0,,541
16,89989416,89993822,del,HG00274,0,,4406
16,33993075,33993891,del,NA19681,0,,816
16,72565833,72566118,del,NA18980,0,,285
16,25066130,25137262,del,HG00359,0,,71132
16,9078496,9081183,del,HG01101,0,,2687
16,5426661,5429506,del,NA19436,0,,2845
16,70666895,70667765,del,HG00553,0,,870
16,73423097,73425303,del,HG00683,0,,2206
16,32345742,33342545,del,HG00262,0,,996803
16,59836856,59848038,del,HG00699,0,,11182
16,31612999,31613503,del,NA18567,0,,504
16,5709383,5710282,del,HG00583,0,,899
16,14075622,14075741,del,NA20819,0,,119
16,75616044,75630492,del,NA18988,0,,14448
16,57725395,57727846,del,NA18999,0,,2451
16,74521507,74524245,del,NA19313,0,,2738
16,24539116,24546422,del,NA19901,0,,7306
16,74113666,74114345,del,HG00620,0,,679
16,82043707,82049587,del,NA19675,0,,5880
16,23654569,23656512,del,HG00177,0,,1943
16,6695937,6697778,del,NA19002,0,,1841
16,1289016,1293872,del,NA19085,0,,4856
16,27317512,27317690,del,HG01441,0,,178
16,34455603,34489220,del,NA18532,0,,33617
16,71996450,72002559,del,NA19908,0,,6109
16,58945815,58948614,del,NA19452,0,,2799
16,1010318,1010432,del,HG00436,0,,114
16,86915793,86920410,del,NA19900,0,,4617
16,61672907,61678240,del,HG01060,0,,5333
16,75157116,75159722,del,HG00525,0,,2606
16,87602257,87607130,del,NA19070,0,,4873
16,49540318,49540452,del,HG00692,0,,134
16,72083350,72110149,del,HG00536,0,,26799
16,57740612,57740687,del,HG01069,0,,75
16,88891444,88892009,del,NA18510,0,,565
16,48005597,48007203,del,NA20795,0,,1606
16,56699378,56700339,del,NA19916,0,,961
16,18069781,18076265,del,NA18909,0,,6484
16,3263277,3263572,del,HG01072,0,,295
16,84594715,84596564,del,NA18977,0,,1849
16,75023955,75027502,del,NA19783,0,,3547
16,16715125,16716866,del,NA11994,0,,1741
16,66520369,66526126,del,NA18573,0,,5757
16,87913197,87913502,del,NA18933,0,,305
16,16071329,16077430,del,NA19099,0,,6101
16,85416879,85417098,del,HG00265,0,,219
16,924758,931265,del,NA19102,0,,6507
16,87902,94174,del,HG00242,0,,6272
16,86451233,86455956,del,NA18990,0,,4723
16,67849554,67851187,del,NA19116,0,,1633
16,22908973,22909251,del,HG00554,0,,278
16,34963113,34964121,del,NA19717,0,,1008
16,46431235,46498904,del,NA19764,0,,67669
16,55795116,55822922,del,NA18532,0,,27806
16,68491184,68491991,del,NA18576,0,,807
16,543796,544093,del,NA19379,0,,297
16,58673812,58677313,del,NA19009,0,,3501
16,60555449,60572907,del,HG00137,0,,17458
16,68801217,68805000,del,HG00125,0,,3783
16,88313032,88314134,del,NA19383,0,,1102
16,59468872,59471451,del,NA19324,0,,2579
16,31971531,31972077,del,NA18562,0,,546
16,66058557,66058673,del,NA18549,0,,116
16,89485563,89494601,del,HG00335,0,,9038
16,49798964,49834179,del,HG01149,0,,35215
16,5195675,5201204,del,HG01357,0,,5529
16,83808503,83809073,del,NA18944,0,,570
16,10484427,10487686,del,NA19332,0,,3259
16,78306606,78309887,del,HG00257,0,,3281
16,17475649,17479647,del,NA18858,0,,3998
16,81179419,81183672,del,NA19012,0,,4253
16,85311349,85317896,del,NA19625,0,,6547
16,22255235,22256235,del,HG00651,0,,1000
16,52604505,52605733,del,NA19835,0,,1228
16,55796516,55822422,del,NA18965,0,,25906
16,86894882,86895098,del,NA20289,0,,216
16,87828616,87832322,del,NA19248,0,,3706
16,86621641,86621833,del,HG00125,0,,192
16,74795983,74796457,del,HG00160,0,,474
16,52147337,52150551,del,NA19429,0,,3214
16,67822186,67824947,del,NA19235,0,,2761
16,63619152,63623325,del,NA20516,0,,4173
16,33536370,33538678,del,NA19726,0,,2308
16,59037912,59038007,del,NA19403,0,,95
16,26879464,26882689,del,NA18858,0,,3225
16,60918902,60919030,del,HG00421,0,,128
16,79260121,79279799,del,HG01489,0,,19678
16,23934129,23942250,del,NA20806,0,,8121
16,77077815,77078938,del,NA19082,0,,1123
16,4672101,4672413,del,NA19920,0,,312
16,14549470,14550610,del,NA18565,0,,1140
16,71355922,71360566,del,HG00231,0,,4644
16,215516,234687,del,HG00699,0,,19171
16,11811494,11811892,del,NA19445,0,,398
16,61910265,61914320,del,NA12889,0,,4055
16,86948158,86949493,del,HG00126,0,,1335
16,8077014,8080164,del,NA19397,0,,3150
16,74430265,74431237,del,HG01136,0,,972
16,3420447,3425027,del,NA18501,0,,4580
16,27445867,27447347,del,NA19072,0,,1480
16,12725914,12739521,del,HG01377,0,,13607
16,25340109,25343127,del,HG00329,0,,3018
16,20177334,20180097,del,HG00320,0,,2763
16,9386725,9411957,del,HG00267,0,,25232
16,696784,697207,del,HG01461,0,,423
16,74224433,74225865,del,NA18486,0,,1432
16,2881489,2887882,del,NA19382,0,,6393
16,85277530,85278347,del,NA19703,0,,817
16,35183015,35198081,del,HG01170,0,,15066
16,89915081,89915257,del,HG00513,0,,176
16,3973029,3981050,del,HG00276,0,,8021
16,29208508,29208641,del,NA19404,0,,133
16,88562248,88564567,del,NA18907,0,,2319
16,5107250,5111485,del,NA18626,0,,4235
16,10925104,10925638,del,NA20586,0,,534
16,81451870,81461195,del,HG00258,0,,9325
16,34242051,34248352,del,NA20543,0,,6301
16,33915209,33972247,del,NA18592,0,,57038
16,31249812,31261831,del,NA18623,0,,12019
16,87597608,87598013,del,NA19818,0,,405
16,31185444,31186551,del,NA18985,0,,1107
16,9250182,9250779,del,NA19473,0,,597
16,10621420,10626351,del,HG00662,0,,4931
16,17655142,17656228,del,NA19660,0,,1086
16,52412516,52415922,del,HG00148,0,,3406
16,1240942,1241621,del,NA19448,0,,679
16,6941794,6979285,del,HG00513,0,,37491
16,24541084,24546433,del,NA19920,0,,5349
16,13508717,13509427,del,NA18539,0,,710
16,75353643,75384604,del,NA19901,0,,30961
16,4769903,4772320,del,HG00177,0,,2417
16,85226399,85234627,del,HG00309,0,,8228
16,66954567,66954667,del,HG00613,0,,100
16,88112731,88115671,del,HG00705,0,,2940
16,83477384,83477772,del,HG00159,0,,388
16,78876652,78877577,del,HG00277,0,,925
16,27336444,27351080,del,HG00336,0,,14636
16,6162939,6164945,del,NA18624,0,,2006
16,12355111,12355288,del,NA19731,0,,177
16,54316316,54325722,del,NA19443,0,,9406
16,20778541,20778861,del,NA18573,0,,320
16,64589266,64592322,del,NA19377,0,,3056
16,49335866,49336302,del,HG00137,0,,436
16,15501705,15502950,del,NA19904,0,,1245
16,46664448,46664951,del,NA19428,0,,503
16,81148687,81149558,del,NA19461,0,,871
16,34455698,34457643,del,NA18552,0,,1945
16,17890789,17890991,del,NA19428,0,,202
16,65282963,65283680,del,HG00243,0,,717
16,23509929,23514731,del,HG00125,0,,4802
16,78699791,78705368,del,HG00149,0,,5577
16,90048883,90048955,del,HG00513,0,,72
16,71999651,72003028,del,NA20816,0,,3377
16,69854331,69858805,del,NA12272,0,,4474
16,8228510,8230504,del,NA18552,0,,1994
16,469394,472902,del,NA19093,0,,3508
16,1345123,1348607,del,NA20761,0,,3484
16,18099972,18102951,del,NA20512,0,,2979
16,23474229,23474301,del,HG01383,0,,72
16,13294465,13296494,del,HG01075,0,,2029
16,23588735,23589003,del,NA11932,0,,268
16,81900022,81900280,del,NA18613,0,,258
16,89967775,89969138,del,HG01173,0,,1363
16,78223663,78227852,del,HG00704,0,,4189
16,4300557,4301589,del,NA18942,0,,1032
16,10791046,10791276,del,HG00476,0,,230
16,68514342,68514450,del,NA19138,0,,108
16,76250297,76251087,del,HG00236,0,,790
16,7061798,7098544,del,HG00684,0,,36746
16,58204021,58206142,del,NA19684,0,,2121
16,57326398,57328247,del,HG00436,0,,1849
16,61694145,61697773,del,HG00246,0,,3628
16,243182,243836,del,NA19248,0,,654
16,72737092,72738014,del,NA19372,0,,922
16,77089766,77094222,del,NA20828,0,,4456
16,87251214,87252348,del,NA18517,0,,1134
16,88447369,88447503,del,NA18523,0,,134
16,89269034,89314747,del,HG00146,0,,45713
16,89536240,89537291,del,HG01047,0,,1051
16,9007191,9008295,del,NA19332,0,,1104
16,73450733,73451812,del,NA19372,0,,1079
16,82293491,82294463,del,NA18617,0,,972
16,3519442,3519632,del,HG00140,0,,190
16,89715155,89715289,del,NA18542,0,,134
16,25825750,25835738,del,HG01072,0,,9988
16,60080926,60098495,del,HG01082,0,,17569
16,75000109,75002350,del,NA19372,0,,2241
16,30164524,30164659,del,HG00533,0,,135
16,72388210,72389080,del,NA07357,0,,870
16,48549831,48554329,del,HG01072,0,,4498
16,83808504,83809082,del,HG00463,0,,578
16,33915282,33973666,del,NA20503,0,,58384
16,13944336,13944439,del,NA19360,0,,103
16,27025736,27026732,del,NA18548,0,,996
16,32345261,33340964,del,NA18940,0,,995703
16,32345704,33342851,del,NA18574,0,,997147
16,16000781,16006147,del,HG01489,0,,5366
16,70718016,70720322,del,HG01072,0,,2306
16,3752091,3753983,del,NA18907,0,,1892
16,88862687,88862924,del,HG00231,0,,237
16,79059786,79063002,del,NA20287,0,,3216
16,6695978,6697818,del,NA19002,0,,1840
16,29301553,29304346,del,HG00524,0,,2793
16,31921478,31924265,del,NA18508,0,,2787
16,68037929,68079260,del,HG00437,0,,41331
16,78079298,78095635,del,NA12341,0,,16337
16,12106896,12107405,del,NA18559,0,,509
16,2936326,2939356,del,NA18874,0,,3030
16,35182716,35198322,del,HG01518,0,,15606
16,18119427,18140474,del,NA20807,0,,21047
16,934670,934898,del,NA19399,0,,228
16,22856321,22856818,del,NA19062,0,,497
16,29718131,29722749,del,HG01174,0,,4618
16,18922886,18929052,del,NA18985,0,,6166
16,14438084,14442486,del,NA18948,0,,4402
16,11759778,11761447,del,NA19380,0,,1669
16,84501438,84504115,del,HG00478,0,,2677
16,29005338,29009504,del,HG00324,0,,4166
16,2212227,2213041,del,HG00318,0,,814
16,76598920,76601564,del,NA18923,0,,2644
16,47935905,47937481,del,NA19383,0,,1576
16,76887761,76945258,del,NA20807,0,,57497
16,4396042,4397689,del,NA18603,0,,1647
16,87597694,87597672,del,NA18949,0,,-22
16,26957423,26957658,del,NA19755,0,,235
16,85416683,85417748,del,NA18507,0,,1065
16,22851936,22856279,del,NA19472,0,,4343
16,10796947,10797172,del,NA19225,0,,225
16,8688167,8689560,del,NA19129,0,,1393
16,296449,299975,del,NA19818,0,,3526
16,58647190,58650264,del,NA19921,0,,3074
16,1290146,1295288,del,NA19065,0,,5142
16,220716,227472,del,NA19703,0,,6756
16,76294912,76295032,del,NA19463,0,,120
16,88808171,88808321,del,HG00542,0,,150
16,82634710,82635126,del,HG00653,0,,416
16,1778549,1778839,del,NA18870,0,,290
16,16097239,16097751,del,HG01360,0,,512
16,77091116,77093022,del,HG00329,0,,1906
16,23760266,23762220,del,HG00736,0,,1954
16,1090994,1091453,del,HG01070,0,,459
16,57602331,57603371,del,NA20322,0,,1040
16,80954136,80999551,del,NA19324,0,,45415
16,5107216,5111265,del,HG00427,0,,4049
16,2969172,2971094,del,HG00343,0,,1922
16,88312878,88313145,del,HG00140,0,,267
16,28607386,28620311,del,NA19114,0,,12925
16,60704468,60704896,del,HG00422,0,,428
16,75256155,75259539,del,NA19059,0,,3384
16,3662265,3684220,del,HG01389,0,,21955
16,33884559,33884803,del,HG01384,0,,244
16,3981617,3990621,del,HG00513,0,,9004
16,8972135,8977474,del,HG00267,0,,5339
16,88270743,88270989,del,NA19395,0,,246
16,12900405,12903096,del,NA19453,0,,2691
16,81151567,81153128,del,NA19467,0,,1561
16,63905505,63907872,del,NA20585,0,,2367
16,17804931,17813765,del,HG00732,0,,8834
16,64326741,64328239,del,NA20828,0,,1498
16,34707536,34714092,del,HG00533,0,,6556
16,6855532,6855720,del,NA19129,0,,188
16,89896057,89898390,del,HG00330,0,,2333
16,20451120,20451971,del,HG00266,0,,851
16,26817372,26820065,del,NA19921,0,,2693
16,67296976,67297389,del,HG00154,0,,413
16,83890583,83895249,del,NA18867,0,,4666
16,67616570,67620384,del,NA20513,0,,3814
16,83500535,83501579,del,NA20534,0,,1044
16,46429129,46499062,del,HG01070,0,,69933
16,84831426,84835496,del,NA19328,0,,4070
16,24540988,24546463,del,NA18924,0,,5475
16,25230042,25231199,del,NA19350,0,,1157
16,79976009,79977034,del,NA19452,0,,1025
16,17172702,17173905,del,NA19777,0,,1203
16,68684244,68687176,del,NA19713,0,,2932
16,87876205,87878031,del,HG00610,0,,1826
16,11579999,11580190,del,NA18571,0,,191
16,530776,531087,del,HG00273,0,,311
16,85311240,85314562,del,NA19625,0,,3322
16,4762140,4763041,del,NA19315,0,,901
16,71834146,71834576,del,NA18520,0,,430
16,34568383,34568693,del,HG01174,0,,310
16,14629488,14634563,del,NA19085,0,,5075
16,29313924,29314128,del,HG00641,0,,204
16,58135289,58136601,del,NA19213,0,,1312
16,12045138,12045981,del,NA19834,0,,843
16,30351767,30355154,del,HG00328,0,,3387
16,1339821,1339965,del,HG00257,0,,144
16,29005533,29009525,del,HG00324,0,,3992
16,87648207,87648649,del,NA19316,0,,442
16,62544333,62550668,del,HG00683,0,,6335
16,82164230,82164507,del,HG00331,0,,277
16,58647190,58650415,del,NA11992,0,,3225
16,5703169,5703403,del,NA07357,0,,234
16,73683162,73686014,del,HG00180,0,,2852
16,4225434,4227721,del,NA19390,0,,2287
16,26963254,26963386,del,HG00629,0,,132
16,77417564,77418898,del,NA19391,0,,1334
16,32346330,33340296,del,HG01148,0,,993966
16,28644993,28646898,del,NA18989,0,,1905
16,462601,464177,del,HG00705,0,,1576
16,56670380,56673170,del,NA20811,0,,2790
16,79590838,79592057,del,NA20296,0,,1219
16,86155923,86156873,del,NA19147,0,,950
16,75920842,75925954,del,NA18545,0,,5112
16,8206571,8207496,del,NA12286,0,,925
16,11603742,11605023,del,NA19900,0,,1281
16,11435571,11436631,del,HG00581,0,,1060
16,12106360,12107596,del,NA20806,0,,1236
16,52904248,52904373,del,HG01440,0,,125
16,246610,248739,del,NA19385,0,,2129
16,76661500,76671078,del,NA19371,0,,9578
16,6274615,6277132,del,HG00578,0,,2517
16,75543036,75546721,del,NA19065,0,,3685
16,12412525,12429655,del,HG00692,0,,17130
16,49848024,49848737,del,HG00530,0,,713
16,32598099,32601572,del,NA18615,0,,3473
16,967406,967380,del,HG00692,0,,-26
16,67933505,67938996,del,NA18507,0,,5491
16,88446745,88447808,del,NA18558,0,,1063
16,83003975,83004270,del,NA18523,0,,295
16,89658275,89659018,del,NA19313,0,,743
16,58967789,58975263,del,NA18549,0,,7474
16,34193851,34194900,del,NA19012,0,,1049
16,27306287,27307375,del,NA19380,0,,1088
16,6777005,6779291,del,NA19012,0,,2286
16,3261027,3263405,del,NA19189,0,,2378
16,5177615,5177989,del,HG00160,0,,374
16,24916590,24917853,del,HG01187,0,,1263
16,75164001,75167912,del,NA11994,0,,3911
16,13653999,13656661,del,HG00344,0,,2662
16,68030446,68035511,del,HG00536,0,,5065
16,13505765,13506643,del,NA19440,0,,878
16,89980726,89981090,del,NA19004,0,,364
16,4698303,4698561,del,HG00160,0,,258
16,4251467,4251846,del,NA19394,0,,379
16,82076992,82077314,del,NA19391,0,,322
16,62204493,62205025,del,NA19077,0,,532
16,73330863,73332170,del,NA19198,0,,1307
16,86894860,86895014,del,HG01375,0,,154
16,60886448,60887001,del,HG00123,0,,553
16,47353007,47355678,del,NA19834,0,,2671
16,72084095,72109619,del,NA18543,0,,25524
16,19988480,19992542,del,NA18489,0,,4062
16,10133866,10134101,del,NA20795,0,,235
16,53748731,53766449,del,HG00610,0,,17718
16,10362263,10362414,del,NA06986,0,,151
16,89146914,89147028,del,NA19324,0,,114
16,67849742,67850983,del,NA18873,0,,1241
16,11389020,11389150,del,HG00629,0,,130
16,85585879,85586186,del,HG00318,0,,307
16,83196147,83209726,del,HG00137,0,,13579
16,15248828,15249835,del,HG00310,0,,1007
16,19945816,19969222,del,NA11931,0,,23406
16,1886491,1886797,del,NA18523,0,,306
16,53213176,53213437,del,NA19398,0,,261
16,16013927,16016019,del,NA18522,0,,2092
16,85066132,85088100,del,HG00421,0,,21968
16,74470901,74471690,del,HG00265,0,,789
16,2987753,3012845,del,NA20802,0,,25092
16,88559494,88559754,del,HG00278,0,,260
16,1290677,1306040,del,NA20805,0,,15363
16,20596426,20603227,del,HG00671,0,,6801
16,15559854,15564221,del,NA19428,0,,4367
16,87255703,87255733,del,NA18505,0,,30
16,35280649,35283923,del,HG00595,0,,3274
16,64696414,64696551,del,HG00463,0,,137
16,77885721,77889469,del,NA19376,0,,3748
16,80903476,80913830,del,NA19703,0,,10354
16,4279003,4283873,del,NA19439,0,,4870
16,89645881,89645967,del,NA12890,0,,86
16,60611858,60613431,del,NA19396,0,,1573
16,84248507,84255051,del,NA20800,0,,6544
16,23760346,23762263,del,NA18599,0,,1917
16,81171090,81177308,del,NA18582,0,,6218
16,17166660,17170696,del,NA12748,0,,4036
16,19959497,19966223,del,NA19434,0,,6726
16,79632316,79634522,del,HG01356,0,,2206
16,89799105,89799291,del,HG00531,0,,186
16,85433944,85434418,del,NA07357,0,,474
16,58290902,58291220,del,NA12275,0,,318
16,81219616,81221088,del,NA18543,0,,1472
16,76716375,76719059,del,HG01048,0,,2684
16,4134313,4141275,del,HG00375,0,,6962
16,78068304,78068452,del,HG00325,0,,148
16,9962001,9966488,del,NA19236,0,,4487
16,62202137,62205791,del,HG00663,0,,3654
16,24396426,24398392,del,NA19818,0,,1966
16,3394521,3395278,del,HG00463,0,,757
16,72074290,72074591,del,NA12400,0,,301
16,72676880,72680321,del,NA19404,0,,3441
16,78371916,78382922,del,NA19317,0,,11006
16,73037375,73039298,del,NA19469,0,,1923
16,7044906,7056259,del,NA18951,0,,11353
16,22031769,22037638,del,NA19700,0,,5869
16,34987350,34988573,del,HG00513,0,,1223
16,89133291,89133428,del,HG01060,0,,137
16,75522675,75524126,del,NA19469,0,,1451
16,10414312,10423377,del,HG00445,0,,9065
16,33897644,34181259,del,NA12004,0,,283615
16,25639376,25640150,del,NA19009,0,,774
16,88023287,88023524,del,HG00246,0,,237
16,66521145,66522663,del,NA19452,0,,1518
16,60081112,60098561,del,HG00654,0,,17449
16,48508940,48511436,del,HG00249,0,,2496
16,10350699,10355949,del,NA18599,0,,5250
16,65286389,65287494,del,HG01350,0,,1105
16,13835713,13841016,del,HG00611,0,,5303
16,89980575,89981043,del,HG00152,0,,468
16,19945766,19968672,del,HG00103,0,,22906
16,28497311,28498244,del,HG00154,0,,933
16,2936376,2936689,del,NA19444,0,,313
16,59987133,59994114,del,NA19347,0,,6981
16,11686764,11689323,del,HG01048,0,,2559
16,1289316,1295022,del,NA18539,0,,5706
16,6997879,7090982,del,NA07346,0,,93103
16,76717196,76741182,del,HG00590,0,,23986
16,76539133,76544025,del,NA20807,0,,4892
16,49288299,49289092,del,HG01197,0,,793
16,273186,274658,del,HG00737,0,,1472
16,81175990,81188361,del,HG00111,0,,12371
16,87606516,87607395,del,NA19428,0,,879
16,30983718,30989410,del,HG00264,0,,5692
16,55780979,55781855,del,NA19318,0,,876
16,70539175,70541867,del,NA18599,0,,2692
16,89099817,89101701,del,NA19190,0,,1884
16,9113710,9113962,del,NA19463,0,,252
16,73390166,73391330,del,HG00327,0,,1164
16,5607955,5615965,del,NA18989,0,,8010
16,65499384,65499603,del,HG01108,0,,219
16,6777168,6804266,del,NA18501,0,,27098
16,54566053,54567759,del,NA18965,0,,1706
16,81879328,81882298,del,NA12058,0,,2970
16,89299279,89299919,del,NA18984,0,,640
16,2395486,2395665,del,NA19395,0,,179
16,74417560,74434660,del,NA19660,0,,17100
16,27306907,27307526,del,NA19137,0,,619
16,5180167,5180657,del,NA19722,0,,490
16,80678745,80680417,del,HG00442,0,,1672
16,2269323,2291588,del,HG00537,0,,22265
16,52032481,52033550,del,HG00108,0,,1069
16,28896297,28898045,del,HG00346,0,,1748
16,16127651,16128060,del,HG00671,0,,409
16,866613,868001,del,HG01072,0,,1388
16,55451059,55451735,del,HG00284,0,,676
16,87787187,87796990,del,HG01354,0,,9803
16,22988629,22996430,del,NA18870,0,,7801
16,34240515,34250337,del,HG01465,0,,9822
16,527032,528476,del,NA19319,0,,1444
16,58116896,58117430,del,NA19390,0,,534
16,10746487,10746630,del,HG00310,0,,143
16,11866008,11867696,del,NA18912,0,,1688
16,1002626,1003873,del,HG00373,0,,1247
16,62805122,62814470,del,NA19819,0,,9348
16,7267116,7267222,del,NA19084,0,,106
16,48433737,48440410,del,NA19084,0,,6673
16,88917433,88918176,del,NA19064,0,,743
16,1156063,1189902,del,NA19007,0,,33839
16,992534,992749,del,NA11830,0,,215
16,78944127,78948650,del,NA12843,0,,4523
16,35273786,35275321,del,HG00156,0,,1535
16,89799099,89799438,del,HG00654,0,,339
16,32344633,33341254,del,HG00732,0,,996621
16,61452744,61453018,del,HG00690,0,,274
16,49330586,49334452,del,HG00619,0,,3866
16,34539718,34540255,del,NA20811,0,,537
16,23283423,23283961,del,HG00272,0,,538
16,22190958,22199242,del,NA19675,0,,8284
16,58945819,58954212,del,NA19900,0,,8393
16,27881118,27881708,del,HG00657,0,,590
16,10771072,10771589,del,HG00260,0,,517
16,78212490,78216577,del,NA18987,0,,4087
16,84274865,84276874,del,NA19431,0,,2009
16,46482135,46489826,del,NA19909,0,,7691
16,6321342,6325229,del,HG00154,0,,3887
16,88312909,88315252,del,NA19311,0,,2343
16,2347996,2348156,del,HG00708,0,,160
16,77593113,77600451,del,NA20540,0,,7338
16,3684406,3693939,del,NA20787,0,,9533
16,32297326,33293789,del,NA20810,0,,996463
16,3009980,3010347,del,NA07347,0,,367
16,17664279,17664886,del,NA19404,0,,607
16,24540989,24546415,del,NA19901,0,,5426
16,58948721,58954212,del,NA19332,0,,5491
16,17134403,17142085,del,HG00734,0,,7682
16,84546375,84546919,del,NA19382,0,,544
16,75429216,75431322,del,HG00559,0,,2106
16,12412525,12430086,del,NA18566,0,,17561
16,80811143,80818543,del,NA19651,0,,7400
16,89078337,89078702,del,HG00111,0,,365
16,17864538,17865025,del,HG00513,0,,487
16,57104853,57104973,del,NA19428,0,,120
16,86008508,86014372,del,HG00151,0,,5864
16,69854416,69854515,del,HG00336,0,,99
16,26383518,26388238,del,NA18610,0,,4720
16,89799099,89799393,del,NA20502,0,,294
16,87912967,87913205,del,HG01066,0,,238
16,83668023,83668961,del,NA20761,0,,938
16,20475884,20476343,del,NA19397,0,,459
16,68318321,68333120,del,HG00533,0,,14799
16,52809650,52811134,del,HG00285,0,,1484
16,70537483,70537796,del,HG01342,0,,313
16,2553607,2555085,del,HG00464,0,,1478
16,54500563,54501747,del,NA18534,0,,1184
16,11485010,11494588,del,NA19462,0,,9578
16,33998696,34003943,del,NA19377,0,,5247
16,71293049,71294413,del,HG01440,0,,1364
16,14152569,14153858,del,NA19678,0,,1289
16,87981799,87981853,del,NA18545,0,,54
16,66573462,66584729,del,NA19401,0,,11267
16,26787674,26789568,del,HG00629,0,,1894
16,4874288,4877184,del,NA12383,0,,2896
16,58945756,58948403,del,NA19332,0,,2647
16,27880435,27882402,del,NA19429,0,,1967
16,25115326,25116790,del,NA19901,0,,1464
16,70553009,70553329,del,NA20538,0,,320
16,57503222,57503823,del,NA18522,0,,601
16,86922831,86923096,del,HG01374,0,,265
16,64682970,64685206,del,HG00343,0,,2236
16,57045423,57048159,del,NA19901,0,,2736
16,799533,799810,del,NA19731,0,,277
16,35119226,35124799,del,HG00536,0,,5573
16,23803524,23805209,del,NA19055,0,,1685
16,1002970,1003921,del,NA19394,0,,951
16,56654831,56655797,del,NA18868,0,,966
16,81243848,81248649,del,NA19108,0,,4801
16,223447,227258,del,NA18947,0,,3811
16,87602272,87606810,del,NA19070,0,,4538
16,87220968,87221110,del,HG00629,0,,142
16,80976502,80983282,del,HG00512,0,,6780
16,85585916,85590622,del,NA20814,0,,4706
16,50207921,50210597,del,HG00702,0,,2676
16,33604996,33605259,del,NA18579,0,,263
16,25204945,25207825,del,NA20797,0,,2880
16,57362003,57362772,del,HG00148,0,,769
16,9531174,9534033,del,NA19107,0,,2859
16,15198313,15198423,del,NA19439,0,,110
16,46434467,46499012,del,NA19473,0,,64545
16,32296978,33293870,del,NA18941,0,,996892
16,59426814,59426924,del,NA19238,0,,110
16,89701171,89701416,del,HG01516,0,,245
16,32346648,33343611,del,HG00264,0,,996963
16,64475506,64475622,del,NA18986,0,,116
16,88155671,88155861,del,HG00353,0,,190
16,89317590,89318034,del,HG00257,0,,444
16,73699274,73701052,del,NA19900,0,,1778
16,57739664,57739884,del,NA19463,0,,220
16,90089999,90090367,del,HG00127,0,,368
16,74203087,74204247,del,NA18505,0,,1160
16,799492,799799,del,HG00583,0,,307
16,1500694,1500940,del,NA18504,0,,246
16,74615615,74632191,del,NA18530,0,,16576
16,83685108,83692557,del,NA19901,0,,7449
16,8453181,8454470,del,HG00122,0,,1289
16,11683733,11685294,del,NA18570,0,,1561
16,87719945,87720224,del,NA19404,0,,279
16,61979585,61995191,del,HG00692,0,,15606
16,14394816,14397322,del,HG00252,0,,2506
16,72353586,72353757,del,HG00672,0,,171
16,85149487,85150075,del,HG00657,0,,588
16,76505922,76506487,del,NA18504,0,,565
16,47864811,47873427,del,HG00478,0,,8616
16,67087233,67088693,del,HG00171,0,,1460
16,876627,876958,del,NA19403,0,,331
16,80196900,80197002,del,NA18608,0,,102
16,64075413,64115712,del,NA19431,0,,40299
16,88218692,88218774,del,NA18557,0,,82
16,34925212,34927628,del,HG00190,0,,2416
16,81154610,81157224,del,NA18561,0,,2614
16,83914978,83917182,del,NA19472,0,,2204
16,83883722,83886771,del,HG00654,0,,3049
16,85314839,85318018,del,NA19625,0,,3179
16,22707238,22707330,del,HG00271,0,,92
16,84427516,84429345,del,NA18510,0,,1829
16,85996939,85997565,del,NA19062,0,,626
16,31836080,31841825,del,NA06989,0,,5745
16,61613268,61619559,del,HG00174,0,,6291
16,74298166,74300214,del,NA19789,0,,2048
16,48673359,48674984,del,NA20807,0,,1625
16,10891959,10893317,del,NA20518,0,,1358
16,71865078,71869925,del,HG01389,0,,4847
16,81854412,81854555,del,NA19445,0,,143
16,4806272,4809825,del,NA18988,0,,3553
16,7421857,7423693,del,HG00473,0,,1836
16,9150576,9152431,del,HG00698,0,,1855
16,32346207,33341432,del,HG00690,0,,995225
16,88638750,88642347,del,NA07037,0,,3597
16,19506316,19506635,del,HG00280,0,,319
16,67513805,67514123,del,NA19137,0,,318
16,89569620,89570187,del,NA18498,0,,567
16,76002056,76020832,del,HG00683,0,,18776
16,14453235,14453653,del,HG00306,0,,418
16,27077063,27098778,del,NA18606,0,,21715
16,68636351,68644082,del,NA18617,0,,7731
16,88561966,88565424,del,NA19079,0,,3458
16,60466727,60467430,del,NA20317,0,,703
16,52004398,52004737,del,HG00626,0,,339
16,32372798,33369456,del,HG00705,0,,996658
16,25623554,25623861,del,NA19469,0,,307
16,18352316,18359722,del,HG01254,0,,7406
16,3392316,3393613,del,NA18606,0,,1297
16,15669913,15674423,del,NA19010,0,,4510
16,85716,94293,dup,HG00261,0,,8577
16,115679,150251,dup,NA19786,0,,34572
16,162127,184240,dup,NA19786,0,,22113
16,192277,200590,dup,HG01855,0,,8313
16,203016,213826,dup,HG01272,0,,10810
16,311768,321794,dup,NA19786,0,,10026
16,313247,555590,dup,HG03095,0,,242343
16,337941,420218,dup,HG03095,0,,82277
16,346495,350305,dup,HG01892,0,,3810
16,350040,369624,dup,HG00266,0,,19584
16,370893,427048,dup,HG00629,0,,56155
16,489034,530097,dup,HG03095,0,,41063
16,624322,635512,dup,NA18747,0,,11190
16,801057,901536,dup,HG00151,0,,100479
16,848001,862299,dup,HG00759,0,,14298
16,848995,942120,dup,HG00759,0,,93125
16,876640,890661,dup,HG00759,0,,14021
16,1094173,1100199,dup,HG00335,0,,6026
16,1138986,1151109,dup,HG00097,0,,12123
16,1294308,1305384,dup,HG00133,0,,11076
16,1313868,1338223,dup,HG01110,0,,24355
16,1406694,1414926,dup,HG00266,0,,8232
16,2636285,2660863,dup,HG00566,0,,24578
16,2700515,2740487,dup,HG00108,0,,39972
16,3071601,3107597,dup,HG02282,0,,35996
16,3105680,3120945,dup,HG03297,0,,15265
16,3120075,3132578,dup,HG01342,0,,12503
16,3212830,3237674,dup,HG00129,0,,24844
16,3464289,3469799,dup,NA19350,0,,5510
16,3492554,3498680,dup,NA07037,0,,6126
16,4023075,4027103,dup,NA18618,0,,4028
16,4159835,4172363,dup,HG04152,0,,12528
16,4702860,4727717,dup,HG03479,0,,24857
16,4798965,4802062,dup,HG00717,0,,3097
16,4873819,4924309,dup,HG01954,0,,50490
16,5007959,5357306,dup,HG02816,0,,349347
16,5008036,5129277,dup,HG02816,0,,121241
16,5216399,5256865,dup,HG02816,0,,40466
16,5515219,5527398,dup,HG01956,0,,12179
16,6064804,6163011,dup,HG03943,0,,98207
16,6065317,6161476,dup,HG03943,0,,96159
16,6074157,6142411,dup,HG03943,0,,68254
16,6515441,6572623,dup,HG03237,0,,57182
16,6678343,6825854,dup,HG03237,0,,147511
16,6802509,6815720,dup,HG00290,0,,13211
16,6878113,6897228,dup,HG02108,0,,19115
16,6934337,6953889,dup,HG02108,0,,19552
16,6939023,7194105,dup,HG03237,0,,255082
16,6959557,6989222,dup,HG03237,0,,29665
16,7410003,7415813,dup,NA20807,0,,5810
16,7738597,7831823,dup,HG00356,0,,93226
16,7738624,7832227,dup,HG00356,0,,93603
16,8070717,8092067,dup,NA20299,0,,21350
16,8600488,8632299,dup,HG02721,0,,31811
16,8785187,8902692,dup,HG00566,0,,117505
16,8822634,8833353,dup,HG00531,0,,10719
16,8837121,8858795,dup,HG00531,0,,21674
16,8867537,8907183,dup,HG00531,0,,39646
16,8903808,8917482,dup,HG00531,0,,13674
16,8931773,8943520,dup,HG01345,0,,11747
16,8971192,9029638,dup,HG03479,0,,58446
16,8978086,9010163,dup,HG00531,0,,32077
16,9042181,9049716,dup,HG02922,0,,7535
16,9081395,9106197,dup,HG02661,0,,24802
16,9093963,9102761,dup,HG02661,0,,8798
16,9225171,9282884,dup,HG03063,0,,57713
16,9250242,9288215,dup,HG03063,0,,37973
16,10134761,10146945,dup,HG02763,0,,12184
16,10276463,10336974,dup,NA18740,0,,60511
16,10367899,10392893,dup,HG01974,0,,24994
16,10373514,10449731,dup,HG01974,0,,76217
16,10589143,10622603,dup,HG01260,0,,33460
16,11102711,11106097,dup,HG00436,0,,3386
16,11791030,11800541,dup,HG04029,0,,9511
16,11824920,11829976,dup,NA18640,0,,5056
16,11837176,11841397,dup,HG01485,0,,4221
16,11926549,11931048,dup,HG00097,0,,4499
16,12445471,12462532,dup,HG02108,0,,17061
16,12540811,12555606,dup,HG03902,0,,14795
16,12792676,12809949,dup,HG00449,0,,17273
16,12904057,12918116,dup,HG03738,0,,14059
16,13408567,13468845,dup,HG04017,0,,60278
16,13484319,13489017,dup,HG00273,0,,4698
16,13637394,13649689,dup,HG01889,0,,12295
16,15059676,15076875,dup,HG00096,0,,17199
16,15080267,15105113,dup,HG00096,0,,24846
16,15099303,15123498,dup,HG00096,0,,24195
16,15124939,15176448,dup,HG00766,0,,51509
16,15125630,15141357,dup,HG00766,0,,15727
16,15224081,15299674,dup,HG00264,0,,75593
16,15506618,15521050,dup,HG00334,0,,14432
16,15509623,15616575,dup,HG00334,0,,106952
16,15526434,15533915,dup,HG03072,0,,7481
16,15546271,15713928,dup,HG00334,0,,167657
16,15615606,15693458,dup,HG00334,0,,77852
16,15695973,15727168,dup,HG00334,0,,31195
16,15796613,16096714,dup,HG00334,0,,300101
16,15971819,16012472,dup,HG00334,0,,40653
16,16024468,16034381,dup,HG00334,0,,9913
16,16039800,16043884,dup,HG03072,0,,4084
16,16063217,16091192,dup,HG00334,0,,27975
16,16102084,16308131,dup,HG00334,0,,206047
16,16105775,16221381,dup,HG00334,0,,115606
16,16224980,16273970,dup,HG00334,0,,48990
16,16631704,16651111,dup,HG00116,0,,19407
16,16656861,16680180,dup,HG00442,0,,23319
16,16830213,16851381,dup,HG00128,0,,21168
16,16845799,17039912,dup,HG03890,0,,194113
16,16887215,16917574,dup,HG03890,0,,30359
16,17098413,17142701,dup,HG03890,0,,44288
16,17334901,17369513,dup,HG03890,0,,34612
16,17372925,17503346,dup,HG03890,0,,130421
16,17573419,18025142,dup,HG03890,0,,451723
16,17829859,18003108,dup,HG03890,0,,173249
16,17934514,18009744,dup,HG01920,0,,75230
16,18119962,18141500,dup,NA20807,0,,21538
16,18150065,18241262,dup,HG00096,0,,91197
16,18257465,18267839,dup,HG00244,0,,10374
16,18292522,18331728,dup,HG00244,0,,39206
16,18568383,18614231,dup,HG00442,0,,45848
16,18612931,18634863,dup,HG00476,0,,21932
16,19136839,19185854,dup,HG00266,0,,49015
16,19142622,19178458,dup,HG01353,0,,35836
16,19988450,19992535,dup,HG01242,0,,4085
16,20360189,20500986,dup,HG01917,0,,140797
16,20530725,20619856,dup,HG00096,0,,89131
16,20545137,20554003,dup,HG00238,0,,8866
16,20553074,20568333,dup,HG01108,0,,15259
16,21196917,21350097,dup,HG02657,0,,153180
16,21199704,21278816,dup,HG02657,0,,79112
16,21518346,21544882,dup,HG01067,0,,26536
16,21541685,21569415,dup,HG01067,0,,27730
16,21573321,21580382,dup,HG00096,0,,7061
16,21588291,21593314,dup,HG00096,0,,5023
16,21610363,21742894,dup,HG00179,0,,132531
16,21799650,21840420,dup,HG00179,0,,40770
16,21813169,22447776,dup,HG01094,0,,634607
16,21945853,22040352,dup,HG01094,0,,94499
16,22094107,22284976,dup,HG01094,0,,190869
16,22094984,22123655,dup,HG01094,0,,28671
16,22132629,22178870,dup,HG01094,0,,46241
16,22307434,22363777,dup,HG01094,0,,56343
16,22429868,22447003,dup,HG00596,0,,17135
16,22611652,22662020,dup,HG00096,0,,50368
16,22623100,22783757,dup,HG00096,0,,160657
16,22650742,22695701,dup,HG00096,0,,44959
16,22832411,22859830,dup,HG01861,0,,27419
16,23608128,23616407,dup,HG00634,0,,8279
16,24205332,24214572,dup,HG00262,0,,9240
16,24542401,24546435,dup,HG01161,0,,4034
16,25067883,25098423,dup,NA19209,0,,30540
16,25109275,25131156,dup,HG03692,0,,21881
16,25825678,25836904,dup,HG01072,0,,11226
16,26072785,26089306,dup,HG01031,0,,16521
16,26072809,26113831,dup,HG01031,0,,41022
16,26084727,26101209,dup,HG01031,0,,16482
16,26094384,26114342,dup,HG01031,0,,19958
16,26176326,26200340,dup,HG04033,0,,24014
16,26620950,26624834,dup,HG00956,0,,3884
16,26860769,26874745,dup,HG03731,0,,13976
16,27051519,27087976,dup,HG02684,0,,36457
16,27053480,27091809,dup,NA18606,0,,38329
16,27078013,27106963,dup,HG01510,0,,28950
16,27212581,27324945,dup,NA20790,0,,112364
16,28578164,28607576,dup,HG03594,0,,29412
16,28614507,28626916,dup,HG00113,0,,12409
16,28818551,28829996,dup,HG00178,0,,11445
16,28835467,28850377,dup,HG00178,0,,14910
16,28853027,28873298,dup,HG02655,0,,20271
16,28871932,28919215,dup,HG00178,0,,47283
16,28985113,29025474,dup,HG00178,0,,40361
16,29251604,29269611,dup,HG02380,0,,18007
16,29320671,29352807,dup,HG02380,0,,32136
16,29412443,29430896,dup,HG00530,0,,18453
16,29431514,29443720,dup,HG00613,0,,12206
16,31343492,31424425,dup,HG03291,0,,80933
16,31347269,31406746,dup,HG03291,0,,59477
16,31399698,31416513,dup,HG03291,0,,16815
16,31563676,31635187,dup,HG01599,0,,71511
16,31574387,31608668,dup,HG01599,0,,34281
16,31599719,31637854,dup,HG01599,0,,38135
16,31778026,31786970,dup,HG02733,0,,8944
16,31998194,32020170,dup,HG00632,0,,21976
16,32328771,32370968,dup,HG00325,0,,42197
16,32366481,32410672,dup,HG00325,0,,44191
16,32418983,32469917,dup,HG00325,0,,50934
16,32611029,32642738,dup,HG00171,0,,31709
16,32831659,32863935,dup,HG00325,0,,32276
16,32903491,32927819,dup,HG00154,0,,24328
16,33446163,33480261,dup,HG01051,0,,34098
16,33470755,33495606,dup,HG01051,0,,24851
16,33484521,33543753,dup,HG01051,0,,59232
16,33524565,33570784,dup,HG01051,0,,46219
16,33588532,33626594,dup,HG01051,0,,38062
16,33819771,33868342,dup,HG02970,0,,48571
16,33880663,33954894,dup,HG02970,0,,74231
16,33949791,33964080,dup,HG02970,0,,14289
16,34408680,34427818,dup,HG02069,0,,19138
16,34457085,34712399,dup,NA19761,0,,255314
16,34811937,34831939,dup,HG02069,0,,20002
16,34835224,34841353,dup,HG02069,0,,6129
16,34839704,34955096,dup,HG02069,0,,115392
16,34971847,35148881,dup,HG00096,0,,177034
16,35020654,35064203,dup,HG00407,0,,43549
16,35057447,35128263,dup,HG02870,0,,70816
16,35070678,35134170,dup,HG02870,0,,63492
16,35182962,35198000,dup,HG00129,0,,15038
16,46463561,46523690,dup,HG00319,0,,60129
16,46551838,46633487,dup,HG00319,0,,81649
16,46581009,46749921,dup,HG01841,0,,168912
16,46663741,46688722,dup,HG01841,0,,24981
16,46698893,46717181,dup,HG01113,0,,18288
16,46711913,46772692,dup,HG01841,0,,60779
16,46761335,46931511,dup,HG01841,0,,170176
16,47297344,47526973,dup,HG01841,0,,229629
16,47355616,47496856,dup,HG01841,0,,141240
16,47497906,47593829,dup,NA18967,0,,95923
16,47584039,47666778,dup,NA21137,0,,82739
16,48938852,48964484,dup,HG00553,0,,25632
16,50032755,50044741,dup,HG00353,0,,11986
16,50459724,50511552,dup,NA12489,0,,51828
16,50463040,50500770,dup,NA12489,0,,37730
16,50470754,50495018,dup,NA12489,0,,24264
16,50688165,50888604,dup,NA19457,0,,200439
16,52300393,52399434,dup,HG02088,0,,99041
16,52567059,52658469,dup,HG01431,0,,91410
16,52817103,52834619,dup,NA20764,0,,17516
16,53091851,53095128,dup,HG04171,0,,3277
16,54637850,54641048,dup,NA19795,0,,3198
16,55729562,55784484,dup,HG00851,0,,54922
16,55798890,55822423,dup,HG00096,0,,23533
16,55832207,55864521,dup,HG02583,0,,32314
16,56447836,56474848,dup,HG02660,0,,27012
16,56655176,56719498,dup,HG01789,0,,64322
16,56660208,56712360,dup,HG00233,0,,52152
16,58041666,58078656,dup,NA19138,0,,36990
16,58045221,58080347,dup,HG03069,0,,35126
16,58117985,58209079,dup,HG02299,0,,91094
16,58120186,58180739,dup,HG02299,0,,60553
16,58477355,58496171,dup,HG01669,0,,18816
16,59979003,59989109,dup,NA20849,0,,10106
16,60943102,60953626,dup,HG01395,0,,10524
16,61325205,61338199,dup,HG01351,0,,12994
16,61366334,61408609,dup,HG01351,0,,42275
16,61391823,61463797,dup,HG01921,0,,71974
16,62525086,62529858,dup,HG01566,0,,4772
16,63301261,63387243,dup,NA19704,0,,85982
16,63798702,63821210,dup,HG03452,0,,22508
16,65365279,65421197,dup,HG01092,0,,55918
16,66604535,66611327,dup,NA19658,0,,6792
16,66974352,67053665,dup,HG03696,0,,79313
16,66988043,67065274,dup,HG03696,0,,77231
16,68042789,68069235,dup,HG00437,0,,26446
16,68709949,68715582,dup,HG02502,0,,5633
16,68786658,68795683,dup,HG01893,0,,9025
16,68804204,68825114,dup,HG00331,0,,20910
16,68839349,68877975,dup,NA19092,0,,38626
16,68840282,68856727,dup,NA19092,0,,16445
16,68881477,68941723,dup,HG03488,0,,60246
16,69710980,69789973,dup,HG02079,0,,78993
16,69748523,69753761,dup,HG02079,0,,5238
16,69769717,69807146,dup,HG02079,0,,37429
16,69772272,69833765,dup,HG02079,0,,61493
16,69796079,69958161,dup,HG02079,0,,162082
16,69850328,69858081,dup,HG01069,0,,7753
16,69873330,69955738,dup,HG02079,0,,82408
16,70011210,70068652,dup,HG00324,0,,57442
16,70063388,70088411,dup,HG00324,0,,25023
16,70120137,70154509,dup,HG00324,0,,34372
16,70181849,70196732,dup,HG00707,0,,14883
16,70230647,70260763,dup,HG00255,0,,30116
16,70286447,70296897,dup,HG00255,0,,10450
16,70848115,71104698,dup,HG00096,0,,256583
16,70977461,70980531,dup,HG00115,0,,3070
16,71056862,71206510,dup,HG00096,0,,149648
16,71370010,71437036,dup,HG03452,0,,67026
16,71860795,71865353,dup,HG00115,0,,4558
16,71866702,71869740,dup,HG01389,0,,3038
16,72080868,72098986,dup,HG00452,0,,18118
16,72094527,72110961,dup,HG00452,0,,16434
16,72108348,72118125,dup,HG01067,0,,9777
16,72267216,72282516,dup,NA18871,0,,15300
16,72283447,72323100,dup,HG00598,0,,39653
16,72315890,72334390,dup,HG03698,0,,18500
16,72319029,72335128,dup,HG03809,0,,16099
16,72404008,72452284,dup,HG02634,0,,48276
16,72572514,72655255,dup,HG01360,0,,82741
16,72676977,72680328,dup,HG00553,0,,3351
16,72722349,72763258,dup,HG03829,0,,40909
16,73506314,73514515,dup,HG01625,0,,8201
16,73661012,73683161,dup,HG01583,0,,22149
16,74331695,74356363,dup,HG00671,0,,24668
16,74371245,74388031,dup,HG00127,0,,16786
16,74393945,74434300,dup,HG00096,0,,40355
16,74479010,74522014,dup,HG00671,0,,43004
16,74532276,74549808,dup,HG00671,0,,17532
16,74616877,74628857,dup,NA18530,0,,11980
16,75070788,75090852,dup,HG01148,0,,20064
16,75102684,75117668,dup,HG01791,0,,14984
16,75171856,75183164,dup,HG00123,0,,11308
16,75535784,75551337,dup,HG02014,0,,15553
16,75557882,75578554,dup,HG02014,0,,20672
16,76001531,76023018,dup,NA18968,0,,21487
16,76581213,76608116,dup,HG03963,0,,26903
16,76581597,76610429,dup,HG01190,0,,28832
16,76630707,76654532,dup,NA20765,0,,23825
16,76853004,76882843,dup,HG01606,0,,29839
16,76924016,76988866,dup,HG03054,0,,64850
16,77200731,77228179,dup,HG00409,0,,27448
16,77423670,77432414,dup,HG01512,0,,8744
16,77523358,77683773,dup,NA20321,0,,160415
16,77706965,77767154,dup,HG04182,0,,60189
16,78059009,78075920,dup,HG01710,0,,16911
16,78151161,78176329,dup,HG02489,0,,25168
16,78259980,78285649,dup,HG03848,0,,25669
16,78427463,78430555,dup,NA20126,0,,3092
16,78502761,78635427,dup,NA20814,0,,132666
16,78591017,78615223,dup,NA20814,0,,24206
16,78591088,78625651,dup,NA20814,0,,34563
16,79193109,79197875,dup,HG03108,0,,4766
16,79258142,79279851,dup,HG00234,0,,21709
16,79891940,79931294,dup,NA20778,0,,39354
16,80334410,80354342,dup,HG01670,0,,19932
16,80366382,80374093,dup,NA19027,0,,7711
16,80376206,80474632,dup,HG01670,0,,98426
16,80528124,80555166,dup,HG02025,0,,27042
16,80599574,80676664,dup,HG01670,0,,77090
16,80622252,80667051,dup,HG01670,0,,44799
16,80622585,80688413,dup,NA18599,0,,65828
16,80667102,80736546,dup,HG01670,0,,69444
16,80844376,80873825,dup,HG01670,0,,29449
16,80859711,80894267,dup,HG00335,0,,34556
16,80903685,80912823,dup,HG00335,0,,9138
16,80915882,80939277,dup,HG00335,0,,23395
16,80935447,80954378,dup,HG00335,0,,18931
16,80952103,80972115,dup,HG00335,0,,20012
16,80955128,81001175,dup,HG00335,0,,46047
16,80988394,81037481,dup,NA06985,0,,49087
16,80999879,81029615,dup,NA06985,0,,29736
16,81014781,81078068,dup,HG01670,0,,63287
16,81170952,81271182,dup,HG02952,0,,100230
16,81406397,81507201,dup,HG02661,0,,100804
16,81511556,81685022,dup,HG02661,0,,173466
16,81729624,81902767,dup,HG02661,0,,173143
16,82123112,82182527,dup,HG04061,0,,59415
16,82167956,82234694,dup,HG03607,0,,66738
16,82319921,82410165,dup,HG00344,0,,90244
16,82416538,82445893,dup,HG04061,0,,29355
16,82433252,82477196,dup,HG04061,0,,43944
16,82929444,82953359,dup,HG01089,0,,23915
16,83144145,83191556,dup,HG01191,0,,47411
16,84044637,84128737,dup,HG02685,0,,84100
16,84045563,84127370,dup,HG02685,0,,81807
16,84205924,84286965,dup,HG03009,0,,81041
16,84286966,84423825,dup,HG03009,0,,136859
16,84324443,84450881,dup,HG03009,0,,126438
16,84461212,84501339,dup,HG00362,0,,40127
16,84468049,84586911,dup,HG00362,0,,118862
16,84475996,84589210,dup,HG00362,0,,113214
16,84505783,84552158,dup,HG00362,0,,46375
16,84561078,84577016,dup,HG00362,0,,15938
16,84603042,84634405,dup,NA19438,0,,31363
16,84831076,84932623,dup,HG01850,0,,101547
16,84846102,84880501,dup,HG01850,0,,34399
16,84869093,84975163,dup,HG01850,0,,106070
16,84872096,84908740,dup,HG01850,0,,36644
16,84926739,84968039,dup,HG02702,0,,41300
16,85186754,85190300,dup,HG01063,0,,3546
16,85356679,85359912,dup,HG03731,0,,3233
16,85487756,85491115,dup,HG00701,0,,3359
16,85524500,85576325,dup,HG02450,0,,51825
16,85792449,85804922,dup,HG03692,0,,12473
16,86753477,86770293,dup,HG02721,0,,16816
16,86876523,86914039,dup,HG03875,0,,37516
16,86885399,86896237,dup,HG03875,0,,10838
16,87304359,87319573,dup,HG01805,0,,15214
16,87312916,87337047,dup,HG00284,0,,24131
16,87333223,87393753,dup,HG04107,0,,60530
16,87335730,87356318,dup,HG04107,0,,20588
16,87354369,87386557,dup,HG00610,0,,32188
16,87588895,87597321,dup,HG00406,0,,8426
16,87693152,87699655,dup,HG01786,0,,6503
16,87777802,87785899,dup,HG00266,0,,8097
16,87978159,87983285,dup,HG00264,0,,5126
16,88571266,88604720,dup,HG02583,0,,33454
16,88638733,88642276,dup,HG00112,0,,3543
16,88812369,88965984,dup,HG02476,0,,153615
16,88822582,88835157,dup,HG02476,0,,12575
16,88904404,88948473,dup,HG02476,0,,44069
16,89155502,89189895,dup,HG00266,0,,34393
16,89155832,89189945,dup,HG04134,0,,34113
16,89388297,89401674,dup,HG04140,0,,13377
16,89425913,89478809,dup,NA21108,0,,52896
16,89494886,89507785,dup,HG01798,0,,12899
16,89581130,89594063,dup,HG02128,0,,12933
16,89599102,89663873,dup,HG00266,0,,64771
16,89746523,89760874,dup,HG01551,0,,14351
16,89879535,89890068,dup,HG01850,0,,10533
16,90010941,90105846,dup,HG02595,0,,94905
16,90086621,90163679,dup,HG02461,0,,77058
16,90100331,90130891,dup,HG02461,0,,30560
16,90131873,90136814,dup,HG00099,0,,4941
16,90138653,90164754,dup,NA18933,0,,26101
17,80928395,80928532,del,NA18523,0,,137
17,1602149,1602918,del,NA20798,0,,769
17,66227556,66227777,del,NA20537,0,,221
17,65772460,65774932,del,HG01070,0,,2472
17,70380435,70384457,del,HG00671,0,,4022
17,34211158,34212059,del,NA18989,0,,901
17,75641497,75651289,del,NA12286,0,,9792
17,50116516,50125522,del,NA18619,0,,9006
17,44281452,45168501,del,NA18874,0,,887049
17,34966454,34967352,del,NA19471,0,,898
17,4035954,4036088,del,NA18557,0,,134
17,5277487,5277857,del,NA19443,0,,370
17,62571135,62572769,del,NA19452,0,,1634
17,57363913,57365706,del,HG01069,0,,1793
17,35778921,35782535,del,NA18572,0,,3614
17,35756361,35759418,del,HG00369,0,,3057
17,1257976,1258470,del,NA19072,0,,494
17,36796031,36797025,del,NA19676,0,,994
17,74294205,74296163,del,NA11893,0,,1958
17,46904632,46907522,del,HG00672,0,,2890
17,8711645,8713992,del,NA18635,0,,2347
17,27149016,27150222,del,HG00141,0,,1206
17,3200733,3201052,del,NA19434,0,,319
17,13161260,13161450,del,NA12340,0,,190
17,13531671,13533174,del,NA19428,0,,1503
17,46615800,46617220,del,NA19776,0,,1420
17,56732080,56732757,del,NA19355,0,,677
17,35937799,35940392,del,NA19350,0,,2593
17,77315933,77316024,del,NA19371,0,,91
17,122865,123233,del,HG00702,0,,368
17,41633746,41637888,del,NA18537,0,,4142
17,896676,897122,del,HG01351,0,,446
17,25291236,25750659,del,HG00276,0,,459423
17,1055014,1055149,del,HG00704,0,,135
17,14050979,14051496,del,NA19920,0,,517
17,6980710,6981002,del,HG00524,0,,292
17,85013,85765,del,NA18534,0,,752
17,72320744,72329084,del,HG00543,0,,8340
17,65417517,65421347,del,HG00138,0,,3830
17,58654111,58655857,del,HG01149,0,,1746
17,6649983,6651046,del,NA19834,0,,1063
17,485266,485910,del,NA18987,0,,644
17,54900992,54904725,del,HG00275,0,,3733
17,10201619,10202085,del,NA19700,0,,466
17,16400766,16412135,del,HG00479,0,,11369
17,18182766,18182899,del,HG00338,0,,133
17,61182127,61187997,del,HG01204,0,,5870
17,41083649,41084525,del,HG00253,0,,876
17,29186703,29187066,del,HG01072,0,,363
17,34508816,34552722,del,HG01522,0,,43906
17,55726415,55726610,del,HG00473,0,,195
17,8596044,8596194,del,NA19394,0,,150
17,12118518,12119652,del,NA19360,0,,1134
17,30718590,30721158,del,NA12827,0,,2568
17,21840596,21848717,del,NA19725,0,,8121
17,48896323,48898116,del,NA19009,0,,1793
17,78977738,78994441,del,HG00476,0,,16703
17,54938072,54938603,del,NA12003,0,,531
17,9652362,9656410,del,NA19382,0,,4048
17,205512,206359,del,NA19331,0,,847
17,5147148,5148363,del,NA20289,0,,1215
17,11479826,11484999,del,NA18960,0,,5173
17,1916937,1917063,del,NA18577,0,,126
17,20678730,20680289,del,NA18510,0,,1559
17,35689185,35694672,del,HG00258,0,,5487
17,8828521,8828850,del,NA19235,0,,329
17,76474527,76474933,del,NA12751,0,,406
17,65450046,65451760,del,HG01060,0,,1714
17,3734466,3736122,del,HG00343,0,,1656
17,77139862,77146644,del,HG00689,0,,6782
17,63123222,63129221,del,HG00334,0,,5999
17,79470484,79471471,del,HG00656,0,,987
17,61865541,61865910,del,NA19360,0,,369
17,17523189,17523905,del,HG01465,0,,716
17,72510739,72510953,del,HG00436,0,,214
17,80996729,80996870,del,NA18623,0,,141
17,46400330,46402335,del,HG01491,0,,2005
17,79903243,79904352,del,HG00512,0,,1109
17,42372880,42374491,del,NA18910,0,,1611
17,57920241,57920716,del,NA19448,0,,475
17,27593312,27594126,del,NA20826,0,,814
17,16573727,16587215,del,HG01173,0,,13488
17,76240965,76242225,del,NA19088,0,,1260
17,27173618,27179590,del,HG01140,0,,5972
17,63114650,63118573,del,NA19901,0,,3923
17,1254003,1254821,del,HG00704,0,,818
17,6882410,6883780,del,NA18596,0,,1370
17,39389385,39406589,del,NA19130,0,,17204
17,60870029,60871103,del,HG00114,0,,1074
17,27766191,27766286,del,NA18870,0,,95
17,7264586,7265997,del,NA12777,0,,1411
17,80466885,80468078,del,NA19225,0,,1193
17,5085251,5085748,del,NA18498,0,,497
17,7996854,7997236,del,NA19428,0,,382
17,39190702,39197248,del,NA19350,0,,6546
17,25291134,25791652,del,NA19663,0,,500518
17,21849413,21851166,del,NA19704,0,,1753
17,65945085,65946884,del,NA18977,0,,1799
17,5594782,5595326,del,HG01342,0,,544
17,71370216,71370972,del,NA19153,0,,756
17,4365525,4365892,del,NA19313,0,,367
17,6204218,6205301,del,NA18870,0,,1083
17,44888488,44888655,del,HG01173,0,,167
17,21550647,22208792,del,HG00595,0,,658145
17,19571910,19572320,del,NA19663,0,,410
17,26782397,26783495,del,NA06994,0,,1098
17,30098748,30098852,del,NA19700,0,,104
17,64940049,64941081,del,NA19076,0,,1032
17,74786527,74790878,del,NA19381,0,,4351
17,36682131,36683427,del,NA19311,0,,1296
17,37986361,37988587,del,NA20510,0,,2226
17,17710316,17715822,del,HG00176,0,,5506
17,17234308,17235346,del,NA19107,0,,1038
17,1146390,1147735,del,HG00252,0,,1345
17,10761661,10766614,del,NA18510,0,,4953
17,2719928,2721217,del,NA18530,0,,1289
17,64137224,64137569,del,NA19908,0,,345
17,19498709,19538564,del,NA19703,0,,39855
17,72510398,72510719,del,NA19371,0,,321
17,28988477,28989134,del,HG00284,0,,657
17,51641481,51643031,del,HG00699,0,,1550
17,4960873,4964406,del,NA20795,0,,3533
17,2582661,3422908,del,NA18574,0,,840247
17,81025596,81025682,del,HG00421,0,,86
17,1098363,1099391,del,HG01137,0,,1028
17,4232194,4233918,del,NA19319,0,,1724
17,67997269,68000277,del,NA19663,0,,3008
17,71759597,71767973,del,NA19652,0,,8376
17,72334469,72335818,del,NA19782,0,,1349
17,15696473,15703004,del,NA19372,0,,6531
17,78694569,78698363,del,NA19324,0,,3794
17,193767,197057,del,HG00560,0,,3290
17,52608128,52609261,del,HG01136,0,,1133
17,8237103,8239176,del,NA18553,0,,2073
17,29989527,29991450,del,NA19102,0,,1923
17,34510216,34554422,del,HG01389,0,,44206
17,4028347,4028806,del,NA18949,0,,459
17,50653817,50664247,del,HG00353,0,,10430
17,55089616,55092522,del,NA19749,0,,2906
17,15867686,15868152,del,HG01198,0,,466
17,54161695,54167594,del,NA18940,0,,5899
17,77673299,77673383,del,HG00256,0,,84
17,47826819,47827882,del,HG01384,0,,1063
17,1502919,1506875,del,HG01080,0,,3956
17,59063826,59064951,del,HG00707,0,,1125
17,21254974,22032959,del,HG00381,0,,777985
17,6988840,6990069,del,NA19396,0,,1229
17,79285360,79286612,del,HG01095,0,,1252
17,41847777,41849128,del,HG00268,0,,1351
17,21553173,22211358,del,HG00683,0,,658185
17,58411922,58413946,del,NA19436,0,,2024
17,34593616,34652222,del,HG01095,0,,58606
17,54599543,54602627,del,NA18874,0,,3084
17,6292646,6295562,del,HG00159,0,,2916
17,35755166,35758672,del,HG00127,0,,3506
17,35514743,35516280,del,NA18909,0,,1537
17,9203448,9206275,del,HG00335,0,,2827
17,12345649,12347219,del,NA18867,0,,1570
17,29113720,29113897,del,NA18606,0,,177
17,9178946,9181524,del,NA19225,0,,2578
17,75227218,75228525,del,NA19835,0,,1307
17,485502,486086,del,HG00581,0,,584
17,25568258,25569344,del,NA19235,0,,1086
17,6855226,6856594,del,HG00133,0,,1368
17,6030858,6037294,del,HG00173,0,,6436
17,10886854,10895731,del,NA19075,0,,8877
17,2795290,2796507,del,HG01350,0,,1217
17,63272053,63272372,del,NA19723,0,,319
17,75245848,75245932,del,NA18572,0,,84
17,37448147,37448754,del,NA18916,0,,607
17,21482907,21483812,del,NA19404,0,,905
17,2430330,2436757,del,HG00418,0,,6427
17,41552814,41557325,del,NA19909,0,,4511
17,56730372,56731911,del,NA20513,0,,1539
17,35796658,35797580,del,NA19707,0,,922
17,19902304,19902707,del,NA19201,0,,403
17,8751738,8751912,del,NA19225,0,,174
17,5147147,5148363,del,NA18871,0,,1216
17,827663,828675,del,HG00671,0,,1012
17,16095144,16095626,del,HG00731,0,,482
17,75828393,75828578,del,HG01083,0,,185
17,66563147,66565226,del,NA19453,0,,2079
17,77438304,77438418,del,NA07051,0,,114
17,80276682,80277187,del,HG01383,0,,505
17,44223907,44224221,del,HG01492,0,,314
17,16861073,16863312,del,NA18867,0,,2239
17,65291301,65291461,del,NA18599,0,,160
17,10890616,10895422,del,HG00595,0,,4806
17,25743063,25750926,del,NA19374,0,,7863
17,608619,612995,del,HG00611,0,,4376
17,3786243,3786397,del,NA06986,0,,154
17,7729823,7732331,del,NA19371,0,,2508
17,77048772,77055994,del,NA19982,0,,7222
17,3464496,3471605,del,HG00464,0,,7109
17,48991171,48997888,del,NA19189,0,,6717
17,1287642,1296112,del,NA18627,0,,8470
17,35776916,35782722,del,HG00663,0,,5806
17,57257473,57259346,del,NA19377,0,,1873
17,51853116,51860572,del,HG00284,0,,7456
17,20662587,20663060,del,HG00500,0,,473
17,13531683,13532693,del,NA19707,0,,1010
17,43931840,43932102,del,NA11831,0,,262
17,72879602,72880478,del,NA18501,0,,876
17,22060464,22066716,del,NA12155,0,,6252
17,41163352,41164584,del,HG00662,0,,1232
17,3504332,3561423,del,HG00140,0,,57091
17,3771267,3771586,del,NA19116,0,,319
17,13161065,13161485,del,NA18597,0,,420
17,76282236,76283430,del,HG00589,0,,1194
17,19419158,19419821,del,HG01060,0,,663
17,57870215,57871184,del,HG00245,0,,969
17,8732682,8732886,del,NA19818,0,,204
17,30106624,30107543,del,HG01047,0,,919
17,7307016,7311422,del,HG00344,0,,4406
17,15590150,15595354,del,HG01342,0,,5204
17,21550207,22208335,del,HG01375,0,,658128
17,42122479,42124665,del,NA18523,0,,2186
17,5143719,5156555,del,HG01489,0,,12836
17,44362833,44365097,del,HG00692,0,,2264
17,1604113,1604747,del,NA20289,0,,634
17,61926182,61927087,del,HG00620,0,,905
17,73107728,73108238,del,NA19355,0,,510
17,65514573,65514637,del,NA11830,0,,64
17,18270202,18271706,del,HG01060,0,,1504
17,9342016,9344577,del,NA19372,0,,2561
17,1646970,1647748,del,NA19723,0,,778
17,46159865,46162273,del,NA19394,0,,2408
17,80997180,80997482,del,NA19394,0,,302
17,65438335,65443873,del,NA12413,0,,5538
17,55687809,55689914,del,NA19062,0,,2105
17,39199137,39206213,del,HG00357,0,,7076
17,50116612,50126361,del,HG00625,0,,9749
17,69005508,69009370,del,HG00500,0,,3862
17,11570980,11571852,del,NA18611,0,,872
17,16402080,16404490,del,HG00533,0,,2410
17,215812,216146,del,NA19834,0,,334
17,74783325,74788308,del,NA18593,0,,4983
17,78945328,78946824,del,HG01072,0,,1496
17,32050124,32055580,del,NA18545,0,,5456
17,42791256,42796422,del,NA12718,0,,5166
17,58857943,58868277,del,NA20770,0,,10334
17,217377,217582,del,HG01124,0,,205
17,33888819,33889123,del,HG01047,0,,304
17,8669631,8671420,del,HG00478,0,,1789
17,78883473,78887495,del,NA20542,0,,4022
17,73091906,73093076,del,NA19355,0,,1170
17,80369874,80369983,del,NA18620,0,,109
17,79998487,79999978,del,NA19834,0,,1491
17,17553974,17558140,del,NA19719,0,,4166
17,71745862,71747908,del,NA19373,0,,2046
17,5270843,5271336,del,NA18608,0,,493
17,1452778,1453135,del,NA19920,0,,357
17,37287460,37289857,del,NA18632,0,,2397
17,72510158,72510262,del,NA18609,0,,104
17,184399,184561,del,NA18635,0,,162
17,39383616,39395322,del,NA19147,0,,11706
17,1146547,1147897,del,NA12058,0,,1350
17,56807853,56808828,del,NA19068,0,,975
17,59331927,59334548,del,NA18636,0,,2621
17,77125448,77125603,del,HG00641,0,,155
17,52312795,52313429,del,NA19010,0,,634
17,33777976,33781255,del,NA19114,0,,3279
17,38582384,38589435,del,HG01197,0,,7051
17,14240917,14242023,del,HG01108,0,,1106
17,5653703,5655532,del,NA19347,0,,1829
17,15771552,15772069,del,HG00366,0,,517
17,2714112,2715162,del,NA19819,0,,1050
17,41066,42722,del,NA18572,0,,1656
17,64985127,64986070,del,NA19914,0,,943
17,77875893,77876233,del,HG01489,0,,340
17,34411639,34517955,del,HG00705,0,,106316
17,63380762,63380920,del,NA18861,0,,158
17,21554394,22212468,del,NA19720,0,,658074
17,35778929,35782406,del,NA20786,0,,3477
17,39965019,39965738,del,NA19404,0,,719
17,65866810,65866926,del,NA07357,0,,116
17,2570595,2571635,del,NA19375,0,,1040
17,33115853,33122089,del,NA20507,0,,6236
17,6940548,6940932,del,NA19324,0,,384
17,4295139,4325677,del,HG00698,0,,30538
17,34593516,34670222,del,HG00285,0,,76706
17,41671651,41672664,del,NA19394,0,,1013
17,19165982,19165975,del,HG00436,0,,-7
17,6995135,7236381,del,NA18986,0,,241246
17,58411897,58413921,del,NA19374,0,,2024
17,78655431,78655613,del,HG00274,0,,182
17,658629,658965,del,NA18523,0,,336
17,60190436,60191880,del,NA19381,0,,1444
17,30293459,30295330,del,NA19000,0,,1871
17,7524413,7524919,del,NA18505,0,,506
17,29659591,29659941,del,NA19761,0,,350
17,10749955,10750246,del,NA19375,0,,291
17,44203086,44203760,del,NA12045,0,,674
17,73091943,73092674,del,NA19920,0,,731
17,64287066,64290972,del,NA18516,0,,3906
17,14189910,14191555,del,HG00353,0,,1645
17,4860753,4862252,del,NA18941,0,,1499
17,79486532,79487270,del,NA20502,0,,738
17,21107187,21111538,del,HG01073,0,,4351
17,3492541,3510835,del,HG00613,0,,18294
17,3422702,3422966,del,NA19355,0,,264
17,38058909,38059300,del,HG00137,0,,391
17,49623996,49627052,del,NA19473,0,,3056
17,39444993,39445106,del,NA12003,0,,113
17,15268962,15271981,del,HG00656,0,,3019
17,27196260,27204123,del,HG00421,0,,7863
17,62213179,62214151,del,HG00635,0,,972
17,36442863,36443866,del,NA18988,0,,1003
17,59043793,59045592,del,NA18986,0,,1799
17,80932875,80934841,del,NA20582,0,,1966
17,70537398,70539421,del,NA19225,0,,2023
17,53463383,53465417,del,HG00641,0,,2034
17,1146466,1147722,del,NA19396,0,,1256
17,73573128,73573495,del,NA18522,0,,367
17,17266173,17273817,del,NA19474,0,,7644
17,39150213,39155969,del,NA18873,0,,5756
17,8682794,8684023,del,HG00264,0,,1229
17,46944359,46949735,del,HG00698,0,,5376
17,77992012,78000841,del,NA19116,0,,8829
17,777861,777970,del,HG01073,0,,109
17,5085181,5085733,del,NA19700,0,,552
17,68091780,68097426,del,NA12282,0,,5646
17,73875370,73879430,del,NA18912,0,,4060
17,8289402,8289715,del,NA19317,0,,313
17,5587702,5588656,del,HG00472,0,,954
17,16859323,16863456,del,NA19393,0,,4133
17,71369974,71370805,del,NA19172,0,,831
17,1534544,1535448,del,NA18633,0,,904
17,56527656,56530912,del,HG00638,0,,3256
17,52319658,52327635,del,NA18544,0,,7977
17,40602369,40603905,del,NA18868,0,,1536
17,887459,887633,del,NA18960,0,,174
17,28179038,28181704,del,NA19390,0,,2666
17,81010559,81010815,del,HG01250,0,,256
17,52783864,52784538,del,NA19379,0,,674
17,55587034,55588041,del,NA19700,0,,1007
17,77462616,77494022,del,HG00613,0,,31406
17,66960926,66961259,del,NA18968,0,,333
17,61673714,61676957,del,HG00610,0,,3243
17,16204644,16206918,del,HG00271,0,,2274
17,79807274,79811325,del,HG01489,0,,4051
17,80044716,80053122,del,HG01101,0,,8406
17,34510216,34549922,del,NA20533,0,,39706
17,31797855,31798027,del,NA18945,0,,172
17,60870250,60870519,del,NA19707,0,,269
17,43211747,43217948,del,HG00276,0,,6201
17,79577680,79578003,del,HG00690,0,,323
17,194966,196822,del,NA12828,0,,1856
17,76018360,76026511,del,HG00525,0,,8151
17,27357061,27360439,del,NA18613,0,,3378
17,81105013,81106772,del,NA19444,0,,1759
17,74306238,74306411,del,NA18523,0,,173
17,41223763,41224698,del,NA19901,0,,935
17,75483715,75483759,del,NA11894,0,,44
17,76919316,76921922,del,HG01066,0,,2606
17,40529931,40536068,del,HG00243,0,,6137
17,41667339,41668389,del,HG01440,0,,1050
17,49053421,49053687,del,NA12716,0,,266
17,1318781,1319043,del,NA18989,0,,262
17,34592716,34651522,del,NA12777,0,,58806
17,50799426,50800787,del,HG01488,0,,1361
17,21884582,21889322,del,NA19449,0,,4740
17,1654705,1655449,del,HG00463,0,,744
17,35755366,35758781,del,HG01125,0,,3415
17,35737901,35738793,del,NA19102,0,,892
17,12279824,12281746,del,NA19334,0,,1922
17,20611037,20614565,del,NA19900,0,,3528
17,8584505,8585441,del,HG01389,0,,936
17,39421829,39432413,del,HG00258,0,,10584
17,7524414,7524919,del,HG00237,0,,505
17,7336409,7337703,del,NA19682,0,,1294
17,58411966,58413922,del,NA19431,0,,1956
17,194797,197694,del,HG00596,0,,2897
17,42668206,42668458,del,HG01462,0,,252
17,31255855,31255902,del,HG01069,0,,47
17,71216622,71217683,del,NA19701,0,,1061
17,79576754,79577877,del,NA19107,0,,1123
17,26846941,26850639,del,NA12347,0,,3698
17,57257666,57259622,del,NA19377,0,,1956
17,43830720,43830844,del,HG00280,0,,124
17,65796131,65800647,del,NA19916,0,,4516
17,75929207,75929995,del,NA12842,0,,788
17,78416698,78416961,del,NA18563,0,,263
17,61542172,61546808,del,NA19257,0,,4636
17,62938571,62943894,del,NA20808,0,,5323
17,1604172,1604905,del,NA19723,0,,733
17,75264005,75273237,del,NA19725,0,,9232
17,6661754,6662039,del,NA18520,0,,285
17,74335317,74336687,del,NA19247,0,,1370
17,38378911,38380658,del,NA19707,0,,1747
17,77228532,77230149,del,NA19004,0,,1617
17,17903397,17903561,del,NA18907,0,,164
17,41153413,41154265,del,NA18501,0,,852
17,33237315,33238141,del,HG00693,0,,826
17,13089300,13098604,del,HG00702,0,,9304
17,47351789,47353092,del,NA19651,0,,1303
17,19410134,19410441,del,HG00580,0,,307
17,45115925,45133313,del,HG00137,0,,17388
17,6101838,6126946,del,NA19457,0,,25108
17,4826118,4828793,del,HG00437,0,,2675
17,80592383,80597728,del,NA18908,0,,5345
17,30162220,30164769,del,NA20520,0,,2549
17,8732774,8732880,del,NA18867,0,,106
17,79128321,79128660,del,NA19404,0,,339
17,71745619,71747908,del,HG01176,0,,2289
17,58655607,58656232,del,HG01488,0,,625
17,65447915,65448770,del,NA18950,0,,855
17,69124307,69134118,del,HG00536,0,,9811
17,36406128,36419033,del,NA19675,0,,12905
17,59351022,59356296,del,HG00464,0,,5274
17,80970679,80976450,del,NA18558,0,,5771
17,41516952,41518240,del,HG00377,0,,1288
17,36963471,36965094,del,NA07347,0,,1623
17,78834686,78835351,del,HG00641,0,,665
17,81013177,81013601,del,HG01073,0,,424
17,1966086,1966956,del,HG00542,0,,870
17,8732638,8732863,del,NA19436,0,,225
17,2398940,2402679,del,NA18910,0,,3739
17,31299270,31302668,del,HG00158,0,,3398
17,39582296,39584303,del,HG00345,0,,2007
17,58968398,58973014,del,HG00702,0,,4616
17,193794,194314,del,NA19099,0,,520
17,70789985,70795207,del,NA18522,0,,5222
17,30475610,30480474,del,HG00367,0,,4864
17,65028533,65038644,del,NA18566,0,,10111
17,79689829,79692834,del,HG00284,0,,3005
17,43059753,43060055,del,NA19328,0,,302
17,70561223,70566140,del,HG01204,0,,4917
17,29201025,29202961,del,HG00253,0,,1936
17,77903516,77905522,del,HG00159,0,,2006
17,73309671,73310674,del,HG00313,0,,1003
17,43925068,43929246,del,NA06986,0,,4178
17,6874732,6875034,del,NA19732,0,,302
17,76281488,76283787,del,HG00702,0,,2299
17,25263703,25265902,del,HG00280,0,,2199
17,4640640,4641518,del,NA19719,0,,878
17,72114872,72142006,del,NA19901,0,,27134
17,15591616,15597122,del,NA20341,0,,5506
17,39197500,39197638,del,NA18549,0,,138
17,35138543,35146711,del,HG01079,0,,8168
17,21550164,22208310,del,NA19704,0,,658146
17,32466571,32470740,del,HG00280,0,,4169
17,37095397,37097500,del,HG01108,0,,2103
17,75065064,75067480,del,NA19130,0,,2416
17,7141016,7142822,del,HG01437,0,,1806
17,6950416,6994982,del,NA18986,0,,44566
17,59319132,59322130,del,NA18546,0,,2998
17,48276416,48279322,del,NA18617,0,,2906
17,52158663,52168001,del,NA18625,0,,9338
17,38582227,38589373,del,HG01197,0,,7146
17,49534105,49538986,del,NA18522,0,,4881
17,77060895,77062804,del,NA20291,0,,1909
17,667991,668812,del,NA19783,0,,821
17,7832316,7835122,del,HG00557,0,,2806
17,1475742,1490977,del,NA19403,0,,15235
17,72882582,72886306,del,HG00693,0,,3724
17,15789557,15793788,del,NA18537,0,,4231
17,15043901,15058720,del,HG01137,0,,14819
17,5214206,5222566,del,NA19470,0,,8360
17,35755572,35760243,del,NA19384,0,,4671
17,39244608,39264608,del,HG00551,0,,20000
17,35778616,35782672,del,NA20506,0,,4056
17,62787165,62795363,del,NA18535,0,,8198
17,18351716,18465622,del,HG00122,0,,113906
17,80942016,80942158,del,HG00245,0,,142
17,10006586,10006906,del,HG00337,0,,320
17,54160177,54172957,del,NA12489,0,,12780
17,50122168,50122642,del,HG00593,0,,474
17,74969236,74972632,del,HG00590,0,,3396
17,9135691,9137153,del,NA19719,0,,1462
17,74279683,74280628,del,NA19390,0,,945
17,75376886,75382487,del,NA18567,0,,5601
17,28346267,28353366,del,HG00263,0,,7099
17,79840086,79841446,del,NA19449,0,,1360
17,70300830,70301089,del,NA18856,0,,259
17,6464122,6464942,del,HG01124,0,,820
17,45575869,45577476,del,NA19003,0,,1607
17,58654196,58655940,del,NA19443,0,,1744
17,34408375,34436810,del,NA19114,0,,28435
17,51852582,51860535,del,HG01060,0,,7953
17,30944687,30949319,del,NA19462,0,,4632
17,8596010,8596191,del,HG00613,0,,181
17,18806479,18806785,del,NA19213,0,,306
17,56187959,56190299,del,HG00554,0,,2340
17,73954173,73954627,del,NA19920,0,,454
17,7241148,7243566,del,HG00634,0,,2418
17,7564612,7566196,del,HG00257,0,,1584
17,48102506,48102594,del,HG00534,0,,88
17,37480142,37480667,del,NA19359,0,,525
17,39506744,39525727,del,NA18908,0,,18983
17,73272693,73273100,del,HG01079,0,,407
17,15789557,15793784,del,NA19238,0,,4227
17,27600291,27602221,del,NA11932,0,,1930
17,75557353,75558505,del,HG01125,0,,1152
17,61749462,61751746,del,NA19468,0,,2284
17,77998271,77998723,del,NA18989,0,,452
17,38512016,38513922,del,HG01073,0,,1906
17,42810347,42818283,del,HG00707,0,,7936
17,74623990,74629371,del,HG00421,0,,5381
17,7995581,7996309,del,NA11920,0,,728
17,37319959,37320215,del,NA19129,0,,256
17,74294822,74297909,del,HG01055,0,,3087
17,58579716,58581472,del,NA19712,0,,1756
17,32106580,32113744,del,HG00500,0,,7164
17,33165456,33165566,del,HG00463,0,,110
17,56979473,56990382,del,NA20530,0,,10909
17,73182087,73200090,del,NA20798,0,,18003
17,56677687,56678658,del,NA19334,0,,971
17,41333885,41335550,del,NA19153,0,,1665
17,1428314,1430089,del,HG00318,0,,1775
17,18605937,18611500,del,NA18924,0,,5563
17,49154354,49154426,del,HG00369,0,,72
17,6871554,6877174,del,NA19240,0,,5620
17,26843801,26844116,del,HG00581,0,,315
17,68573466,68575840,del,HG00640,0,,2374
17,30603833,30603949,del,HG00326,0,,116
17,75263903,75273169,del,NA20807,0,,9266
17,49402375,49406361,del,NA19684,0,,3986
17,79170025,79170406,del,NA19678,0,,381
17,6940397,6940753,del,HG00245,0,,356
17,48309447,48318774,del,NA20508,0,,9327
17,57729678,57731689,del,NA20588,0,,2011
17,21550333,22208484,del,HG01072,0,,658151
17,54670316,54675322,del,HG00403,0,,5006
17,20239477,20248398,del,HG00589,0,,8921
17,80344054,80344230,del,HG00276,0,,176
17,3734784,3735842,del,HG00325,0,,1058
17,41160068,41160536,del,NA19328,0,,468
17,72639087,72639234,del,HG00232,0,,147
17,18784804,18785405,del,NA18950,0,,601
17,76018112,76026365,del,HG00525,0,,8253
17,27380224,27380352,del,NA11919,0,,128
17,60934361,60934485,del,HG00137,0,,124
17,70380483,70384642,del,HG00671,0,,4159
17,58653716,58656672,del,NA19360,0,,2956
17,75483916,75483672,del,NA19197,0,,-244
17,41117000,41399710,del,NA19785,0,,282710
17,71291958,71292471,del,NA20126,0,,513
17,45565538,45566905,del,HG00629,0,,1367
17,80369768,80369930,del,NA18577,0,,162
17,43915122,43915509,del,HG00737,0,,387
17,5339088,5340078,del,NA18519,0,,990
17,203335,203413,del,NA18636,0,,78
17,15183463,15185724,del,NA19435,0,,2261
17,79502304,79502631,del,NA18917,0,,327
17,12279653,12281731,del,NA19313,0,,2078
17,10226020,10232064,del,NA18599,0,,6044
17,485266,486101,del,NA12283,0,,835
17,54705191,54706161,del,NA19207,0,,970
17,35093789,35094479,del,NA19248,0,,690
17,4640607,4641336,del,NA19788,0,,729
17,48309247,48318809,del,HG01067,0,,9562
17,78025201,78028509,del,HG01437,0,,3308
17,55089724,55092848,del,NA20814,0,,3124
17,10347323,10357188,del,NA19664,0,,9865
17,35250486,35250934,del,NA19327,0,,448
17,79998743,80000234,del,NA19435,0,,1491
17,58516670,58518156,del,HG00525,0,,1486
17,35755597,35758790,del,HG01522,0,,3193
17,20049510,20052836,del,HG00595,0,,3326
17,17210787,17210903,del,HG00581,0,,116
17,7882771,7884098,del,NA19467,0,,1327
17,20796162,20800855,del,HG01048,0,,4693
17,41912803,41913922,del,NA18873,0,,1119
17,27389379,27393382,del,NA19000,0,,4003
17,29074774,29076850,del,NA19078,0,,2076
17,28712363,28712601,del,HG01365,0,,238
17,48102111,48102261,del,NA18520,0,,150
17,34592016,34655922,del,HG01383,0,,63906
17,79334684,79335725,del,NA19390,0,,1041
17,74280803,74282019,del,HG01171,0,,1216
17,13622985,13627343,del,HG01359,0,,4358
17,66066958,66078275,del,HG00672,0,,11317
17,27782190,27784382,del,NA19391,0,,2192
17,59999685,60000659,del,HG00556,0,,974
17,27125714,27126054,del,HG00654,0,,340
17,25568224,25569185,del,NA19213,0,,961
17,68102751,68104215,del,NA18599,0,,1464
17,72316066,72316770,del,HG01383,0,,704
17,66312062,66315531,del,NA19078,0,,3469
17,1594777,1603199,del,HG00372,0,,8422
17,18815477,18817755,del,HG00254,0,,2278
17,49897934,49899106,del,NA19313,0,,1172
17,16309216,16313722,del,HG00428,0,,4506
17,61543497,61544353,del,HG01072,0,,856
17,4287650,4290144,del,NA19054,0,,2494
17,2714091,2721380,del,HG00187,0,,7289
17,64004422,64014534,del,NA18539,0,,10112
17,3211686,3214513,del,NA19713,0,,2827
17,48844115,48844490,del,NA19138,0,,375
17,1246559,1246991,del,NA19439,0,,432
17,79610351,79610666,del,NA18542,0,,315
17,77990116,78002922,del,NA19474,0,,12806
17,41094722,41097229,del,HG01075,0,,2507
17,42888720,42891743,del,HG00328,0,,3023
17,7264572,7265830,del,HG00262,0,,1258
17,9657549,9660668,del,NA19452,0,,3119
17,60476897,60495807,del,HG00536,0,,18910
17,51853266,51860272,del,NA12273,0,,7006
17,43123914,43128189,del,NA18511,0,,4275
17,56207497,56213609,del,NA20819,0,,6112
17,7996799,7997273,del,NA20334,0,,474
17,3257453,3266988,del,HG01550,0,,9535
17,20823286,20825761,del,NA19917,0,,2475
17,479642,480061,del,NA19315,0,,419
17,11411664,11413238,del,NA19005,0,,1574
17,56777863,56778953,del,HG00437,0,,1090
17,919664,921361,del,NA19429,0,,1697
17,32982087,32983412,del,NA18868,0,,1325
17,60468412,60472804,del,NA18606,0,,4392
17,37191912,37194244,del,NA20769,0,,2332
17,2435093,2435657,del,NA19908,0,,564
17,122940,123299,del,HG01061,0,,359
17,1097206,1100210,del,HG00654,0,,3004
17,2735261,2735582,del,HG00705,0,,321
17,1209636,1210086,del,HG00271,0,,450
17,76505129,76505311,del,NA19648,0,,182
17,25536539,25540381,del,NA18508,0,,3842
17,1912700,1913564,del,HG00584,0,,864
17,44314867,44315591,del,NA12778,0,,724
17,37083155,37085025,del,NA18985,0,,1870
17,64354546,64354742,del,NA18522,0,,196
17,2395425,2398067,del,NA20787,0,,2642
17,1034578,1034937,del,HG00463,0,,359
17,103446,106000,del,HG01047,0,,2554
17,9065215,9065332,del,HG01060,0,,117
17,894432,895740,del,NA20771,0,,1308
17,30436737,30437055,del,HG01134,0,,318
17,12381157,12387698,del,NA19338,0,,6541
17,21877851,21882051,del,NA18593,0,,4200
17,74362234,74365305,del,NA20341,0,,3071
17,42069346,42070684,del,NA19004,0,,1338
17,29406949,29407175,del,NA18532,0,,226
17,6129055,6132773,del,NA19235,0,,3718
17,69549107,69554310,del,HG00137,0,,5203
17,699979,704816,del,NA18617,0,,4837
17,29932459,29932771,del,NA18956,0,,312
17,38688394,38689416,del,NA20539,0,,1022
17,801626,802237,del,NA18637,0,,611
17,45634782,45635284,del,HG00152,0,,502
17,10614015,10651431,del,NA20756,0,,37416
17,44176394,44176717,del,NA20520,0,,323
17,41437988,41440208,del,HG00237,0,,2220
17,61603848,61616988,del,NA18574,0,,13140
17,14011258,14042339,del,NA18985,0,,31081
17,39429291,39433693,del,HG00421,0,,4402
17,21552001,22210170,del,HG00311,0,,658169
17,38300085,38302957,del,NA12272,0,,2872
17,34591816,34653822,del,HG01515,0,,62006
17,29015057,29025922,del,NA19350,0,,10865
17,65772498,65774826,del,HG00309,0,,2328
17,39391216,39395322,del,NA20356,0,,4106
17,2713999,2721292,del,HG00267,0,,7293
17,57109683,57118204,del,NA19059,0,,8521
17,32106636,32113819,del,HG00500,0,,7183
17,36167643,36169329,del,HG00705,0,,1686
17,25464295,25467377,del,NA18874,0,,3082
17,80581217,80586243,del,NA19457,0,,5026
17,75211866,75212322,del,HG00344,0,,456
17,17508521,17515218,del,NA19066,0,,6697
17,41490452,41493201,del,NA19434,0,,2749
17,5143381,5156494,del,HG01489,0,,13113
17,70493778,70496920,del,NA19002,0,,3142
17,44086723,44086961,del,NA19707,0,,238
17,5595704,5597498,del,NA20799,0,,1794
17,67344363,67348824,del,NA19144,0,,4461
17,33821316,33824922,del,HG01082,0,,3606
17,8149259,8149396,del,NA18595,0,,137
17,27019327,27020006,del,HG00188,0,,679
17,949480,949612,del,HG00326,0,,132
17,1387229,1393659,del,NA18637,0,,6430
17,1097750,1098205,del,HG00708,0,,455
17,41401872,41402578,del,NA12748,0,,706
17,59118770,59128792,del,HG00258,0,,10022
17,72378505,72379665,del,HG00266,0,,1160
17,43496199,43497241,del,NA12749,0,,1042
17,194866,197222,del,NA18544,0,,2356
17,11557370,11557691,del,NA11893,0,,321
17,47166552,47171632,del,HG00329,0,,5080
17,39239281,39260463,del,HG01137,0,,21182
17,17024328,17025261,del,HG00663,0,,933
17,79334873,79335138,del,HG01356,0,,265
17,3835964,3837448,del,NA18917,0,,1484
17,40218815,40222091,del,HG01465,0,,3276
17,7995202,7996946,del,HG00183,0,,1744
17,21551635,22209804,del,HG00476,0,,658169
17,35754466,35759222,del,NA20527,0,,4756
17,13318649,13318914,del,NA19703,0,,265
17,75941571,75942642,del,NA19347,0,,1071
17,58062217,58080210,del,HG01375,0,,17993
17,5960460,5962799,del,NA19334,0,,2339
17,77279998,77280108,del,NA18546,0,,110
17,17979860,17981004,del,NA19704,0,,1144
17,4042307,4042421,del,HG01187,0,,114
17,42651524,42652145,del,NA19247,0,,621
17,34510216,34551722,del,HG00237,0,,41506
17,46687416,46690222,del,HG01389,0,,2806
17,2430451,2432100,del,NA18498,0,,1649
17,68102842,68104435,del,NA18612,0,,1593
17,38406473,38407166,del,NA19346,0,,693
17,144375,144985,del,NA18853,0,,610
17,21370328,21372135,del,NA19435,0,,1807
17,32873527,32873861,del,NA19313,0,,334
17,66548791,66549121,del,HG01377,0,,330
17,59830,60027,del,NA19137,0,,197
17,58579848,58581273,del,NA19204,0,,1425
17,15043901,15058721,del,NA19054,0,,14820
17,20459866,20460272,del,NA19469,0,,406
17,8713363,8715262,del,HG00656,0,,1899
17,34593216,34651622,del,HG00156,0,,58406
17,7407553,7409483,del,HG00133,0,,1930
17,72880524,72883288,del,NA19700,0,,2764
17,65294448,65295118,del,HG01124,0,,670
17,51442981,51447477,del,NA18965,0,,4496
17,18791138,18792163,del,NA20811,0,,1025
17,27019315,27020122,del,HG00464,0,,807
17,21556985,22215098,del,NA19247,0,,658113
17,77990116,78000622,del,NA20127,0,,10506
17,70815227,70821360,del,HG00156,0,,6133
17,2734530,2736550,del,HG01133,0,,2020
17,18366878,18367759,del,HG00111,0,,881
17,74849874,74850822,del,NA19651,0,,948
17,11028134,11036339,del,HG01052,0,,8205
17,36947812,36949306,del,NA20813,0,,1494
17,39243693,39263731,del,NA18630,0,,20038
17,26468713,26469273,del,HG00418,0,,560
17,60468349,60472690,del,NA18606,0,,4341
17,6988734,6989969,del,HG00247,0,,1235
17,30268781,30270883,del,NA19469,0,,2102
17,61578675,61578812,del,NA18624,0,,137
17,19331388,19332671,del,NA18963,0,,1283
17,39237756,39239128,del,NA19072,0,,1372
17,29830238,29831491,del,NA19625,0,,1253
17,55490701,55491507,del,NA19914,0,,806
17,72630946,72634418,del,NA19436,0,,3472
17,71370005,71370842,del,NA19901,0,,837
17,81013285,81013799,del,HG00320,0,,514
17,15183458,15185695,del,HG00421,0,,2237
17,64021196,64022997,del,HG00693,0,,1801
17,65963838,65965750,del,HG01124,0,,1912
17,4564532,4566178,del,HG00339,0,,1646
17,65274196,65309590,del,NA18985,0,,35394
17,80920315,80920423,del,HG00324,0,,108
17,26763,67111,dup,HG01935,0,,40348
17,27658,151887,dup,HG01935,0,,124229
17,157424,206889,dup,HG01935,0,,49465
17,165984,193707,dup,HG01935,0,,27723
17,214432,272769,dup,HG01935,0,,58337
17,220688,296408,dup,HG01935,0,,75720
17,274883,798776,dup,NA20317,0,,523893
17,398418,559966,dup,HG01935,0,,161548
17,412032,479537,dup,HG01935,0,,67505
17,524625,608933,dup,HG01935,0,,84308
17,620866,649521,dup,NA20317,0,,28655
17,652263,675010,dup,NA20317,0,,22747
17,679451,730316,dup,NA18978,0,,50865
17,696070,858356,dup,NA11918,0,,162286
17,743965,775891,dup,NA20278,0,,31926
17,789237,806860,dup,HG01577,0,,17623
17,789438,823227,dup,HG00159,0,,33789
17,822113,840206,dup,HG00629,0,,18093
17,842463,851590,dup,HG00130,0,,9127
17,854955,874353,dup,HG00334,0,,19398
17,877287,912733,dup,NA11918,0,,35446
17,925401,953765,dup,HG00629,0,,28364
17,1241287,1259875,dup,NA18542,0,,18588
17,1434188,1462624,dup,HG02661,0,,28436
17,2941563,2958134,dup,NA19318,0,,16571
17,3058418,3123742,dup,HG04100,0,,65324
17,3183131,3195128,dup,HG00428,0,,11997
17,3466046,3476384,dup,HG00266,0,,10338
17,3473838,3542418,dup,HG02768,0,,68580
17,3758496,3777510,dup,HG00634,0,,19014
17,3855017,3866670,dup,HG04171,0,,11653
17,4045545,4120185,dup,HG02804,0,,74640
17,4051353,4117268,dup,HG02804,0,,65915
17,4207097,4233648,dup,HG01806,0,,26551
17,4207624,4389558,dup,HG01806,0,,181934
17,4288090,4295655,dup,HG02238,0,,7565
17,4316107,4385215,dup,HG01806,0,,69108
17,4341529,4366440,dup,HG01806,0,,24911
17,4357125,4385590,dup,HG01806,0,,28465
17,4383689,4388253,dup,HG01806,0,,4564
17,4405765,4423991,dup,HG01804,0,,18226
17,4406710,4460300,dup,HG01804,0,,53590
17,4444445,4458334,dup,HG01804,0,,13889
17,5772646,5791905,dup,HG03919,0,,19259
17,6181161,6294489,dup,HG01705,0,,113328
17,6294331,6311612,dup,HG00259,0,,17281
17,6849694,6854142,dup,NA21119,0,,4448
17,7016238,7027868,dup,HG01067,0,,11630
17,7101361,7164664,dup,HG02489,0,,63303
17,7196105,7225856,dup,HG02489,0,,29751
17,8209260,8260147,dup,NA12046,0,,50887
17,8215753,8240968,dup,NA12046,0,,25215
17,8319303,8323535,dup,HG01142,0,,4232
17,8651013,8661831,dup,HG04222,0,,10818
17,9331684,9337370,dup,HG04152,0,,5686
17,9430844,9439825,dup,HG00099,0,,8981
17,9944611,9948911,dup,HG03619,0,,4300
17,11076232,11083816,dup,HG03258,0,,7584
17,11180961,11188596,dup,HG02026,0,,7635
17,11876956,11881849,dup,HG00766,0,,4893
17,12019421,12071535,dup,NA20760,0,,52114
17,12102750,12111239,dup,HG01589,0,,8489
17,12116326,12171812,dup,NA20760,0,,55486
17,12928179,13054281,dup,NA20760,0,,126102
17,13088987,13110924,dup,HG00656,0,,21937
17,13136038,13187092,dup,NA20760,0,,51054
17,13291590,13305388,dup,NA19681,0,,13798
17,13623667,13627488,dup,HG01359,0,,3821
17,13940438,13984555,dup,HG01058,0,,44117
17,13985985,13996634,dup,HG01058,0,,10649
17,14011447,14040006,dup,NA18985,0,,28559
17,14126839,14220873,dup,HG03572,0,,94034
17,14224374,14483419,dup,HG03572,0,,259045
17,14241867,14248195,dup,HG03572,0,,6328
17,14284612,14628667,dup,HG03572,0,,344055
17,14300914,14367997,dup,HG03572,0,,67083
17,14489639,14632921,dup,HG03572,0,,143282
17,14668589,15084842,dup,HG03572,0,,416253
17,15112458,15159531,dup,HG03572,0,,47073
17,15251554,15281359,dup,HG03572,0,,29805
17,15287341,15482010,dup,HG03572,0,,194669
17,15323152,15369177,dup,HG03572,0,,46025
17,15551728,15575500,dup,HG01896,0,,23772
17,15642774,15678186,dup,HG00476,0,,35412
17,15690934,15794694,dup,HG00096,0,,103760
17,16359177,16427369,dup,NA19670,0,,68192
17,16359255,16485894,dup,NA19670,0,,126639
17,16643880,16654775,dup,HG00118,0,,10895
17,16661446,16704453,dup,HG00096,0,,43007
17,16711552,16724682,dup,HG00125,0,,13130
17,17167049,17182927,dup,NA20587,0,,15878
17,17525807,17533935,dup,HG01342,0,,8128
17,18178309,18182452,dup,HG02164,0,,4143
17,18276875,18290108,dup,HG00375,0,,13233
17,18359814,18376676,dup,HG00096,0,,16862
17,18507410,18522042,dup,HG01396,0,,14632
17,18535780,18562334,dup,HG01242,0,,26554
17,18585563,18736902,dup,HG00096,0,,151339
17,18624594,18633671,dup,HG00103,0,,9077
17,18823479,18922632,dup,HG01136,0,,99153
17,18834952,18917835,dup,HG01136,0,,82883
17,19655627,19662137,dup,HG01879,0,,6510
17,20145719,20223913,dup,HG03072,0,,78194
17,20244371,20315729,dup,HG03072,0,,71358
17,20308178,20344948,dup,HG00138,0,,36770
17,20373996,20449901,dup,HG03072,0,,75905
17,20458723,20603359,dup,HG03072,0,,144636
17,21003694,21021415,dup,HG01479,0,,17721
17,21225982,21303206,dup,HG00101,0,,77224
17,21330382,21340958,dup,HG01500,0,,10576
17,21346256,21414492,dup,NA21088,0,,68236
17,21528873,21554136,dup,HG02968,0,,25263
17,21703241,21724426,dup,HG02968,0,,21185
17,21729716,21740452,dup,HG02968,0,,10736
17,21798466,21840450,dup,HG02968,0,,41984
17,21836380,21858925,dup,HG01951,0,,22545
17,21860917,21893288,dup,HG02968,0,,32371
17,21907018,21942030,dup,HG02968,0,,35012
17,21954858,22202566,dup,NA19786,0,,247708
17,22195788,22241501,dup,NA19786,0,,45713
17,25384946,25418485,dup,HG03765,0,,33539
17,25385174,25405822,dup,HG03765,0,,20648
17,25441924,25452490,dup,NA19320,0,,10566
17,25464241,25467289,dup,HG01063,0,,3048
17,25964467,26072382,dup,HG03875,0,,107915
17,25965210,26016306,dup,HG03875,0,,51096
17,26048876,26072852,dup,HG03875,0,,23976
17,26740949,26745374,dup,HG00102,0,,4425
17,28280824,28291338,dup,HG02769,0,,10514
17,28868903,28934538,dup,HG01341,0,,65635
17,29015611,29024528,dup,HG01989,0,,8917
17,29115930,29127962,dup,NA20520,0,,12032
17,29217946,29229754,dup,HG02394,0,,11808
17,29918814,29933928,dup,HG00607,0,,15114
17,30338897,30370571,dup,NA18501,0,,31674
17,30426773,30457935,dup,HG03199,0,,31162
17,30426898,30538629,dup,HG03199,0,,111731
17,30485344,30492000,dup,HG02012,0,,6656
17,30852472,30872544,dup,HG00096,0,,20072
17,30856477,30923597,dup,NA19011,0,,67120
17,30868138,30927536,dup,HG02360,0,,59398
17,31297615,31313007,dup,HG02890,0,,15392
17,31766081,31770405,dup,NA18577,0,,4324
17,33510888,33522297,dup,HG03642,0,,11409
17,33510970,33522973,dup,HG00628,0,,12003
17,33680255,33761818,dup,HG00338,0,,81563
17,33680807,33769384,dup,HG01269,0,,88577
17,34112988,34124865,dup,HG01682,0,,11877
17,34327658,34382479,dup,HG02429,0,,54821
17,34415343,34423413,dup,HG02060,0,,8070
17,34436099,34482872,dup,HG00096,0,,46773
17,34817046,34871801,dup,NA20359,0,,54755
17,34817476,34956918,dup,HG01986,0,,139442
17,34839220,34922975,dup,HG01986,0,,83755
17,34863538,34894780,dup,HG01986,0,,31242
17,34920539,35265627,dup,NA20359,0,,345088
17,34958835,34989526,dup,NA20359,0,,30691
17,35019331,35079323,dup,NA20359,0,,59992
17,35117732,35481805,dup,NA20359,0,,364073
17,35261693,35288271,dup,NA20359,0,,26578
17,35433630,35549919,dup,NA20359,0,,116289
17,35555307,35754669,dup,NA20359,0,,199362
17,35759429,35775895,dup,NA20359,0,,16466
17,35766646,35970992,dup,NA20359,0,,204346
17,35999539,36136181,dup,NA20359,0,,136642
17,36141337,36213855,dup,NA20359,0,,72518
17,37391258,37406398,dup,HG03028,0,,15140
17,39054216,39275194,dup,HG03913,0,,220978
17,39058976,39198614,dup,HG03913,0,,139638
17,39211024,39221728,dup,HG00274,0,,10704
17,39222579,39234687,dup,HG03913,0,,12108
17,39242768,39265301,dup,HG00409,0,,22533
17,39531703,39539741,dup,HG00242,0,,8038
17,39644899,39728847,dup,HG02549,0,,83948
17,39661013,39692381,dup,HG02549,0,,31368
17,39702609,39752678,dup,NA18564,0,,50069
17,39761925,39781173,dup,NA18564,0,,19248
17,39831292,39835346,dup,HG02879,0,,4054
17,40511637,40524404,dup,HG00190,0,,12767
17,40701968,40708661,dup,HG01241,0,,6693
17,40769039,40779504,dup,NA18526,0,,10465
17,40778071,40783213,dup,HG01485,0,,5142
17,41092251,41107331,dup,NA20582,0,,15080
17,41408139,41431534,dup,NA18960,0,,23395
17,41438739,41655202,dup,NA20753,0,,216463
17,41578295,41627968,dup,NA20753,0,,49673
17,41825200,41842938,dup,NA20856,0,,17738
17,41860321,41872659,dup,HG00128,0,,12338
17,41939806,41965756,dup,HG04198,0,,25950
17,41945470,41959643,dup,HG04198,0,,14173
17,43716060,43735111,dup,HG02778,0,,19051
17,44131127,44137999,dup,HG00271,0,,6872
17,44165338,44211686,dup,HG00097,0,,46348
17,44230893,44262697,dup,HG00096,0,,31804
17,44341412,44366497,dup,HG00097,0,,25085
17,45121488,45133231,dup,HG00108,0,,11743
17,45143125,45153759,dup,HG01497,0,,10634
17,45428124,45492991,dup,HG02121,0,,64867
17,45536350,45544290,dup,HG03772,0,,7940
17,45832107,45861269,dup,HG02522,0,,29162
17,46153456,46159342,dup,HG01599,0,,5886
17,46881258,46884315,dup,HG01280,0,,3057
17,46885421,46891940,dup,HG01893,0,,6519
17,47205925,47211753,dup,HG01878,0,,5828
17,48980414,49000797,dup,HG02274,0,,20383
17,49386003,49406874,dup,HG01058,0,,20871
17,51443007,51447344,dup,HG00436,0,,4337
17,51865367,51869435,dup,HG02604,0,,4068
17,51920259,51934681,dup,HG01892,0,,14422
17,52708932,52778331,dup,NA20903,0,,69399
17,52709178,52853287,dup,NA20903,0,,144109
17,52860267,52992440,dup,NA20903,0,,132173
17,52997184,53075366,dup,NA20903,0,,78182
17,53243859,53254373,dup,NA19756,0,,10514
17,56177287,56194476,dup,HG00407,0,,17189
17,56206964,56213515,dup,HG00096,0,,6551
17,57524834,57530900,dup,HG00130,0,,6066
17,57940422,57963585,dup,NA20894,0,,23163
17,58129048,58174729,dup,HG01968,0,,45681
17,58517907,58525193,dup,HG00263,0,,7286
17,59927945,59934556,dup,NA19383,0,,6611
17,59943779,60001431,dup,HG02521,0,,57652
17,59944146,59967621,dup,HG02521,0,,23475
17,60485063,60637451,dup,HG00096,0,,152388
17,60928944,60939659,dup,NA19648,0,,10715
17,61324293,61348600,dup,HG03733,0,,24307
17,61355785,61361258,dup,HG01841,0,,5473
17,61542192,61546087,dup,HG01890,0,,3895
17,61951741,61963345,dup,HG00099,0,,11604
17,61961141,61977434,dup,HG00099,0,,16293
17,61971491,61984891,dup,HG00099,0,,13400
17,61992866,61998750,dup,HG00622,0,,5884
17,62010986,62069215,dup,HG03088,0,,58229
17,63618651,63689613,dup,HG03736,0,,70962
17,63715123,64045308,dup,HG03736,0,,330185
17,64247549,64260846,dup,NA19206,0,,13297
17,64276896,64279944,dup,HG03007,0,,3048
17,64304778,64308277,dup,NA19923,0,,3499
17,64793007,64827642,dup,HG03668,0,,34635
17,65268555,65313100,dup,NA18985,0,,44545
17,65928303,65993030,dup,HG02974,0,,64727
17,65930829,65947468,dup,HG02974,0,,16639
17,66333019,66361628,dup,HG02283,0,,28609
17,66624034,66644017,dup,HG00956,0,,19983
17,66648788,66657811,dup,NA18964,0,,9023
17,67286871,67325404,dup,HG01250,0,,38533
17,67298840,67324700,dup,HG01250,0,,25860
17,67597573,67636813,dup,HG04118,0,,39240
17,69042623,69064491,dup,HG03817,0,,21868
17,71329742,71350915,dup,NA19323,0,,21173
17,71748188,71758715,dup,HG00127,0,,10527
17,71826642,71924969,dup,HG00380,0,,98327
17,71827811,71991720,dup,NA06989,0,,163909
17,71827926,72691000,dup,HG00380,0,,863074
17,71999544,72099661,dup,NA06989,0,,100117
17,72102077,72245608,dup,HG01242,0,,143531
17,72237894,72448063,dup,NA06989,0,,210169
17,72523534,72683022,dup,NA06989,0,,159488
17,73057637,73063281,dup,HG01378,0,,5644
17,73461832,73473958,dup,HG02805,0,,12126
17,73925853,73955842,dup,NA19676,0,,29989
17,73932828,73952019,dup,NA19676,0,,19191
17,74543526,74582462,dup,HG03888,0,,38936
17,74549134,74569557,dup,HG03888,0,,20423
17,74624641,74629210,dup,HG00421,0,,4569
17,75061606,75177066,dup,HG00662,0,,115460
17,75217148,75234690,dup,HG01770,0,,17542
17,75471099,75563010,dup,HG03428,0,,91911
17,76573869,76586928,dup,HG03727,0,,13059
17,76822152,76841479,dup,NA19160,0,,19327
17,77365256,77394104,dup,HG00127,0,,28848
17,77373197,77410572,dup,HG00127,0,,37375
17,77664437,77679188,dup,HG02733,0,,14751
17,78069688,78074025,dup,HG01988,0,,4337
17,78143377,78173056,dup,NA18632,0,,29679
17,78155559,78169497,dup,HG00629,0,,13938
17,78167936,78176339,dup,NA18632,0,,8403
17,78248216,78277191,dup,HG00766,0,,28975
17,78604974,78614032,dup,HG00108,0,,9058
17,78894820,78918436,dup,HG01989,0,,23616
17,78952429,78986336,dup,HG01989,0,,33907
17,79100329,79110432,dup,HG00097,0,,10103
17,79816170,79848556,dup,HG00451,0,,32386
17,79962632,79973337,dup,NA12815,0,,10705
17,80313000,80323636,dup,HG00120,0,,10636
17,80326922,80356448,dup,NA20519,0,,29526
17,80392501,80420462,dup,NA07048,0,,27961
17,80943438,81007855,dup,HG01936,0,,64417
17,80953733,80973622,dup,HG01936,0,,19889
17,80975317,80997039,dup,HG00112,0,,21722
17,81036632,81068945,dup,HG01990,0,,32313
17,81045737,81067315,dup,HG01082,0,,21578
17,81079681,81127445,dup,HG01915,0,,47764
17,81085789,81153042,dup,HG00409,0,,67253
18,14530299,14531827,del,HG00419,0,,1528
18,7138390,7143224,del,HG00740,0,,4834
18,29032504,29033975,del,HG00258,0,,1471
18,33979841,33981571,del,HG00651,0,,1730
18,14279819,14299351,del,HG00160,0,,19532
18,76615409,76616063,del,HG00596,0,,654
18,77454317,77454399,del,NA20520,0,,82
18,1962784,1962999,del,NA19430,0,,215
18,12600583,12605018,del,NA19213,0,,4435
18,60021,60852,del,HG00689,0,,831
18,74365364,74365670,del,NA19711,0,,306
18,8634165,8634281,del,NA18572,0,,116
18,44926939,44929069,del,NA19471,0,,2130
18,27695058,27695485,del,NA19334,0,,427
18,34060860,34061088,del,NA20334,0,,228
18,76338436,76338764,del,HG00427,0,,328
18,45095014,45095061,del,NA19093,0,,47
18,13647103,13647594,del,NA12005,0,,491
18,55931102,55937141,del,NA12340,0,,6039
18,633677,640275,del,HG00693,0,,6598
18,59283862,59284098,del,NA19982,0,,236
18,10331018,10331158,del,HG00501,0,,140
18,54244949,54245623,del,NA20537,0,,674
18,31131776,31132782,del,HG01133,0,,1006
18,19562280,19563064,del,HG01350,0,,784
18,21361598,21362998,del,HG01378,0,,1400
18,75639524,75642166,del,NA20542,0,,2642
18,50356055,50360569,del,NA19472,0,,4514
18,72529627,72539784,del,NA19676,0,,10157
18,6503666,6505272,del,HG00185,0,,1606
18,51179275,51180542,del,HG00663,0,,1267
18,57546764,57547709,del,NA20346,0,,945
18,58116971,58122793,del,HG01108,0,,5822
18,64049209,64049722,del,HG01107,0,,513
18,43706011,43707440,del,NA20761,0,,1429
18,61028247,61028893,del,NA19312,0,,646
18,9284979,9286146,del,HG00119,0,,1167
18,30497385,30503540,del,NA19147,0,,6155
18,67953648,67955307,del,HG00335,0,,1659
18,3997014,3997471,del,NA19395,0,,457
18,33953631,33956668,del,NA18510,0,,3037
18,65547088,65553565,del,NA19474,0,,6477
18,69991155,70048676,del,HG01137,0,,57521
18,26970311,26971937,del,NA12763,0,,1626
18,34749435,34758152,del,NA19116,0,,8717
18,41763939,41776940,del,NA20761,0,,13001
18,66221318,66221641,del,NA18611,0,,323
18,69376283,69378557,del,HG00280,0,,2274
18,55797196,55798678,del,HG01075,0,,1482
18,75005845,75006042,del,NA19391,0,,197
18,11509695,11511474,del,NA19235,0,,1779
18,5996985,5997406,del,NA19190,0,,421
18,23347185,23350774,del,NA18582,0,,3589
18,76905176,76906159,del,HG00306,0,,983
18,2830221,2835431,del,NA18873,0,,5210
18,60158207,60159462,del,NA19360,0,,1255
18,72879876,72888335,del,NA19660,0,,8459
18,67208356,67217456,del,HG01197,0,,9100
18,51303245,51305790,del,NA12058,0,,2545
18,62161378,62172469,del,NA19085,0,,11091
18,37877029,37891090,del,HG00683,0,,14061
18,24571620,24572341,del,NA12546,0,,721
18,52391229,52394143,del,HG00263,0,,2914
18,207030,207706,del,NA20507,0,,676
18,74337042,74337843,del,HG01359,0,,801
18,3349141,3351123,del,NA19238,0,,1982
18,72017358,72019836,del,NA19056,0,,2478
18,60530675,60533717,del,HG00737,0,,3042
18,57258178,57258516,del,HG01190,0,,338
18,7143716,7145422,del,HG00331,0,,1706
18,44527378,44529843,del,NA19720,0,,2465
18,66773171,66773315,del,NA19397,0,,144
18,39010400,39012219,del,HG00475,0,,1819
18,77588966,77589199,del,HG00513,0,,233
18,34555203,34557766,del,NA12286,0,,2563
18,30132600,30139622,del,NA12763,0,,7022
18,20519939,20523225,del,NA19438,0,,3286
18,49188029,49190560,del,HG01190,0,,2531
18,77233730,77235561,del,NA19377,0,,1831
18,63827206,63836123,del,HG00689,0,,8917
18,53476553,53487160,del,NA18499,0,,10607
18,63828805,63834619,del,NA18523,0,,5814
18,39143402,39143481,del,NA18592,0,,79
18,76169415,76171406,del,NA19384,0,,1991
18,14260774,14264021,del,NA20287,0,,3247
18,53198277,53202343,del,HG00595,0,,4066
18,73575040,73583429,del,NA18977,0,,8389
18,69164836,69449905,del,HG00329,0,,285069
18,26101420,26101563,del,NA20528,0,,143
18,28477505,28480746,del,NA19681,0,,3241
18,43941672,43946334,del,NA18606,0,,4662
18,64777225,64779621,del,NA19010,0,,2396
18,20199146,20468291,del,HG01102,0,,269145
18,8984657,8985357,del,NA19138,0,,700
18,71245333,71247359,del,HG00611,0,,2026
18,32925384,32927953,del,HG01334,0,,2569
18,46396484,46396901,del,HG01389,0,,417
18,30850887,30856352,del,HG00478,0,,5465
18,23747805,23751322,del,NA18874,0,,3517
18,75669459,75669815,del,NA12748,0,,356
18,77679511,77681765,del,NA19463,0,,2254
18,4513853,4515327,del,NA19238,0,,1474
18,68724367,68724678,del,NA19189,0,,311
18,3568918,3571759,del,NA18603,0,,2841
18,77169001,77169166,del,HG01066,0,,165
18,14450641,14460492,del,HG01190,0,,9851
18,22892474,22892804,del,NA19360,0,,330
18,14550616,14567422,del,NA19084,0,,16806
18,40252683,40257737,del,NA19920,0,,5054
18,41976707,41982074,del,NA12751,0,,5367
18,4571540,4575462,del,HG00324,0,,3922
18,32952099,32958099,del,HG00330,0,,6000
18,31813795,31815199,del,NA18870,0,,1404
18,2472723,2472837,del,NA18508,0,,114
18,42838107,42838809,del,HG00190,0,,702
18,52501950,52504156,del,NA19236,0,,2206
18,35531795,35537783,del,HG01083,0,,5988
18,3181222,3181712,del,NA18608,0,,490
18,45785630,45785896,del,NA19379,0,,266
18,77924078,77926714,del,NA18871,0,,2636
18,36816200,36816176,del,HG00324,0,,-24
18,21990742,21992047,del,HG00274,0,,1305
18,42863195,42863424,del,NA19395,0,,229
18,75811828,75812720,del,NA18959,0,,892
18,38258516,38266522,del,NA18539,0,,8006
18,46593647,46593878,del,NA18543,0,,231
18,56770034,56771402,del,HG01098,0,,1368
18,26286179,26287821,del,NA19002,0,,1642
18,9784200,9793238,del,NA20828,0,,9038
18,55177172,55177487,del,HG01082,0,,315
18,66205016,66208472,del,HG01489,0,,3456
18,29003278,29004167,del,NA18907,0,,889
18,54691811,54692087,del,NA19390,0,,276
18,2930334,2936826,del,NA12043,0,,6492
18,23347121,23350616,del,NA18548,0,,3495
18,74176854,74183440,del,NA19682,0,,6586
18,4988228,5012789,del,NA20582,0,,24561
18,38259892,38266749,del,NA19712,0,,6857
18,76893237,76898256,del,HG00559,0,,5019
18,988076,1049209,del,NA19452,0,,61133
18,20398806,20401251,del,NA18867,0,,2445
18,14482776,14485453,del,HG00276,0,,2677
18,47160271,47163624,del,NA18990,0,,3353
18,5927634,5934110,del,NA18510,0,,6476
18,63829977,63834927,del,NA18507,0,,4950
18,10217229,10223760,del,NA18989,0,,6531
18,11681640,11686419,del,NA19346,0,,4779
18,59706972,59707188,del,HG00705,0,,216
18,69484415,69485781,del,NA19657,0,,1366
18,59394916,59395048,del,HG00339,0,,132
18,27170258,27172203,del,NA19383,0,,1945
18,27215562,27222268,del,NA07000,0,,6706
18,58230587,58233360,del,NA19190,0,,2773
18,3635447,3638227,del,NA19213,0,,2780
18,28223890,28224152,del,NA19393,0,,262
18,67953648,67955308,del,HG01149,0,,1660
18,2963309,2964250,del,NA19394,0,,941
18,72884916,72888461,del,NA19660,0,,3545
18,2262181,2265153,del,HG01083,0,,2972
18,37566535,37567139,del,NA19346,0,,604
18,24330336,24340900,del,HG00702,0,,10564
18,77679559,77681697,del,HG00565,0,,2138
18,654174,655930,del,NA19469,0,,1756
18,48537174,48538968,del,NA20512,0,,1794
18,45099894,45100206,del,HG00473,0,,312
18,64959013,64967261,del,HG00690,0,,8248
18,3996116,3997472,del,HG01377,0,,1356
18,39133504,39135063,del,NA12413,0,,1559
18,52865004,52865084,del,NA12750,0,,80
18,13618882,13620918,del,HG00654,0,,2036
18,76268296,76268738,del,HG00366,0,,442
18,46492279,46493402,del,HG00448,0,,1123
18,626752,627457,del,NA19213,0,,705
18,2189523,2190787,del,NA19076,0,,1264
18,12019416,12025610,del,HG01377,0,,6194
18,32370306,32370546,del,NA19463,0,,240
18,22664132,22664558,del,HG00252,0,,426
18,63906992,63911802,del,NA19681,0,,4810
18,57670689,57672034,del,NA19401,0,,1345
18,4813796,4814478,del,HG00321,0,,682
18,73394101,73401954,del,NA20756,0,,7853
18,6497129,6499317,del,HG01061,0,,2188
18,15242599,15243284,del,NA19390,0,,685
18,77944274,77944369,del,NA20581,0,,95
18,20054138,20067226,del,NA18874,0,,13088
18,62385767,62386081,del,NA20529,0,,314
18,71057786,71058716,del,HG01069,0,,930
18,74827849,74828020,del,HG01171,0,,171
18,41566385,41569808,del,HG00684,0,,3423
18,27814773,27816387,del,HG00276,0,,1614
18,3635383,3636920,del,HG00656,0,,1537
18,4306301,4314407,del,HG00737,0,,8106
18,31759162,31760947,del,NA19172,0,,1785
18,33348373,33357687,del,HG00122,0,,9314
18,3523607,3524673,del,NA18621,0,,1066
18,77184834,77184967,del,NA20506,0,,133
18,49196735,49198873,del,NA19445,0,,2138
18,9205223,9206932,del,NA20525,0,,1709
18,33989051,33991133,del,HG00245,0,,2082
18,67101743,67101876,del,HG00656,0,,133
18,37211747,37260429,del,NA20529,0,,48682
18,21490978,21491121,del,NA18550,0,,143
18,55177306,55177936,del,NA19700,0,,630
18,46997698,47005311,del,NA18487,0,,7613
18,10218753,10219577,del,NA12829,0,,824
18,689859,690320,del,NA18516,0,,461
18,55664900,55665180,del,NA19437,0,,280
18,10150607,10151015,del,NA11918,0,,408
18,45736990,45739505,del,HG01149,0,,2515
18,69232741,69234495,del,NA19085,0,,1754
18,64889707,64894301,del,HG01377,0,,4594
18,51827636,51828115,del,HG01197,0,,479
18,35825531,35838201,del,NA19443,0,,12670
18,57429494,57437730,del,NA07051,0,,8236
18,15242495,15245994,del,NA20768,0,,3499
18,59185641,59189049,del,NA19664,0,,3408
18,74293921,74295449,del,HG00258,0,,1528
18,9111496,9112086,del,NA19382,0,,590
18,11896354,11898324,del,NA20507,0,,1970
18,3322344,3323216,del,NA19391,0,,872
18,3479056,3482685,del,NA19374,0,,3629
18,47656103,47661858,del,NA18577,0,,5755
18,4705233,4707518,del,HG00338,0,,2285
18,33856006,33856795,del,HG00699,0,,789
18,23762971,23766128,del,HG00684,0,,3157
18,24857092,24858095,del,NA07051,0,,1003
18,72485258,72485430,del,NA20278,0,,172
18,40054077,40057652,del,NA19780,0,,3575
18,40920612,40924201,del,NA19394,0,,3589
18,52447197,52447557,del,NA20505,0,,360
18,76373624,76374470,del,NA19403,0,,846
18,60592689,60592908,del,NA20317,0,,219
18,63723716,63732172,del,HG01176,0,,8456
18,73913365,73922637,del,HG00698,0,,9272
18,41267652,41269095,del,NA19004,0,,1443
18,69859600,69935512,del,HG01366,0,,75912
18,47911019,47911284,del,NA18593,0,,265
18,66746416,66758472,del,NA20771,0,,12056
18,28677307,28677810,del,HG01108,0,,503
18,60357802,60361088,del,NA19676,0,,3286
18,61312728,61318217,del,NA19313,0,,5489
18,63304899,63305720,del,HG00592,0,,821
18,74459164,74460567,del,NA19471,0,,1403
18,72879683,72884563,del,NA19660,0,,4880
18,3560158,3561966,del,NA19448,0,,1808
18,59583944,59585671,del,NA18530,0,,1727
18,14449616,14461022,del,NA18536,0,,11406
18,77085962,77086496,del,HG00372,0,,534
18,76043113,76048173,del,NA18595,0,,5060
18,13887179,13887387,del,NA18546,0,,208
18,77652931,77654274,del,NA19070,0,,1343
18,3349559,3349963,del,NA19398,0,,404
18,67410588,67414842,del,NA19663,0,,4254
18,68904089,68904778,del,NA19713,0,,689
18,20677609,20677878,del,NA19147,0,,269
18,13778459,13782412,del,NA19401,0,,3953
18,1207362,1212441,del,HG00419,0,,5079
18,4506520,4510742,del,HG01171,0,,4222
18,19687162,19687451,del,NA19463,0,,289
18,70723146,70726790,del,HG00329,0,,3644
18,6543757,6544968,del,NA19916,0,,1211
18,35550025,35551942,del,NA19707,0,,1917
18,70766660,70769260,del,NA19382,0,,2600
18,5492281,5492519,del,HG00478,0,,238
18,76738316,76741022,del,HG00672,0,,2706
18,22951308,22951474,del,NA19108,0,,166
18,1874440,1874786,del,NA20519,0,,346
18,65819236,65822461,del,NA19908,0,,3225
18,66274835,66275914,del,NA18610,0,,1079
18,3635432,3637000,del,HG00702,0,,1568
18,71427394,71433397,del,NA19430,0,,6003
18,50612353,50612986,del,HG00554,0,,633
18,33201198,33201524,del,NA19904,0,,326
18,60879300,60879849,del,HG00282,0,,549
18,27238809,27241427,del,NA18507,0,,2618
18,45379613,45379807,del,NA19445,0,,194
18,69342430,69344447,del,NA20582,0,,2017
18,63831016,63834922,del,NA18873,0,,3906
18,73271729,73272158,del,NA10851,0,,429
18,33791274,33791834,del,NA18874,0,,560
18,54741721,54741930,del,NA19383,0,,209
18,4258246,4258829,del,NA19443,0,,583
18,71876812,71883460,del,NA20759,0,,6648
18,77184777,77184931,del,HG01107,0,,154
18,49444746,49444902,del,NA18984,0,,156
18,10546889,10547110,del,NA19720,0,,221
18,11953046,11954013,del,NA20582,0,,967
18,7194491,7196066,del,NA19835,0,,1575
18,14280455,14283680,del,NA18579,0,,3225
18,18780672,18781148,del,HG00319,0,,476
18,24523356,24534805,del,HG00278,0,,11449
18,76662488,76666324,del,HG00324,0,,3836
18,62835410,62839841,del,NA20296,0,,4431
18,74323507,74323770,del,NA18541,0,,263
18,8535148,8535634,del,NA19920,0,,486
18,57916899,57925128,del,NA18505,0,,8229
18,70353219,70353421,del,NA18623,0,,202
18,57454201,57456070,del,HG00556,0,,1869
18,43695336,43697823,del,NA19747,0,,2487
18,67149578,67151574,del,NA19685,0,,1996
18,63907136,63911760,del,HG01497,0,,4624
18,46333864,46333970,del,NA19430,0,,106
18,38006374,38007000,del,HG01073,0,,626
18,38260816,38266372,del,NA19057,0,,5556
18,28230678,28231311,del,NA18547,0,,633
18,634727,639193,del,HG00543,0,,4466
18,30828668,31467821,del,NA07347,0,,639153
18,9877535,9877907,del,NA19239,0,,372
18,75084883,75084964,del,HG00323,0,,81
18,53929026,53930998,del,NA19397,0,,1972
18,11880079,11880391,del,HG00705,0,,312
18,77523411,77523489,del,HG00313,0,,78
18,2635652,2636369,del,NA18616,0,,717
18,12503663,12504397,del,NA06989,0,,734
18,58929798,58934249,del,NA18963,0,,4451
18,77518967,77548823,del,NA19681,0,,29856
18,54021970,54026550,del,NA18557,0,,4580
18,76290697,76294729,del,HG01377,0,,4032
18,4955592,4955989,del,HG00334,0,,397
18,64219694,64221253,del,HG01254,0,,1559
18,63700205,63709006,del,NA19457,0,,8801
18,43676845,43677694,del,HG00596,0,,849
18,22452059,22452268,del,HG00125,0,,209
18,9043811,9047283,del,NA20536,0,,3472
18,71074213,71077501,del,NA19080,0,,3288
18,27086537,27090164,del,NA19093,0,,3627
18,70123413,70129309,del,HG00650,0,,5896
18,24134023,24134444,del,NA18619,0,,421
18,14300834,14317176,del,NA18611,0,,16342
18,75295778,75298092,del,NA18544,0,,2314
18,36216598,36218955,del,NA19469,0,,2357
18,76202121,76203340,del,HG00525,0,,1219
18,44429550,44430955,del,NA18952,0,,1405
18,27950973,27953150,del,HG00337,0,,2177
18,10222278,10223604,del,HG00584,0,,1326
18,51136403,51137772,del,NA19909,0,,1369
18,25974116,25981537,del,NA18523,0,,7421
18,3765995,3770677,del,NA19819,0,,4682
18,46834012,46836023,del,NA19657,0,,2011
18,3504048,3507473,del,NA11994,0,,3425
18,74730327,74730931,del,HG00707,0,,604
18,53363711,53365505,del,NA19108,0,,1794
18,61297275,61303558,del,HG00634,0,,6283
18,30495688,30501262,del,NA12891,0,,5574
18,74298930,74299355,del,NA18989,0,,425
18,5180407,5183565,del,HG00242,0,,3158
18,69763011,69764066,del,NA19463,0,,1055
18,47893874,47898737,del,NA19704,0,,4863
18,45989432,45994935,del,NA20770,0,,5503
18,68914566,68915522,del,NA18636,0,,956
18,37061632,37061962,del,NA12890,0,,330
18,10220363,10225916,del,NA18871,0,,5553
18,41229941,41231518,del,NA20540,0,,1577
18,62041801,62042482,del,NA19377,0,,681
18,32047993,32049765,del,NA20815,0,,1772
18,11559097,11565417,del,NA19172,0,,6320
18,9404060,9407132,del,HG00246,0,,3072
18,10431300,10431485,del,NA19777,0,,185
18,74407996,74408562,del,NA18627,0,,566
18,36577492,36585133,del,NA19914,0,,7641
18,51868777,51870969,del,NA18945,0,,2192
18,64300520,64317178,del,NA19334,0,,16658
18,66204798,66209156,del,HG00120,0,,4358
18,4506457,4510843,del,NA19701,0,,4386
18,14552169,14568725,del,NA19066,0,,16556
18,31547180,31551951,del,HG00112,0,,4771
18,60726956,60739596,del,NA18608,0,,12640
18,40749718,40749886,del,NA20521,0,,168
18,71002537,71004126,del,HG00369,0,,1589
18,75005987,75006178,del,HG01366,0,,191
18,20154874,20160561,del,HG00158,0,,5687
18,65846411,65895919,del,HG00246,0,,49508
18,29108589,29108810,del,HG00672,0,,221
18,66228957,66229335,del,NA20533,0,,378
18,8529064,8529543,del,NA19681,0,,479
18,7082884,7082968,del,NA19239,0,,84
18,77454318,77454602,del,NA18582,0,,284
18,4535387,4536734,del,HG00260,0,,1347
18,74104475,74104720,del,HG01550,0,,245
18,40304194,40304846,del,HG01342,0,,652
18,52841386,52844699,del,NA12716,0,,3313
18,46539041,46545615,del,NA20799,0,,6574
18,72880836,72887457,del,NA19660,0,,6621
18,75833016,75834358,del,NA19099,0,,1342
18,13465822,13466866,del,NA18486,0,,1044
18,14781243,14781510,del,NA18511,0,,267
18,5300888,5301988,del,HG00189,0,,1100
18,63723831,63732361,del,NA19074,0,,8530
18,77669529,77670327,del,NA11930,0,,798
18,34451344,34489717,del,HG00375,0,,38373
18,58672170,58672845,del,HG00319,0,,675
18,42625416,42626099,del,NA18516,0,,683
18,7522160,7522674,del,HG00366,0,,514
18,20199155,20468282,del,NA19713,0,,269127
18,37811796,37812603,del,HG00258,0,,807
18,9621929,9622235,del,HG00442,0,,306
18,24970175,24981555,del,NA20509,0,,11380
18,36656917,36666632,del,NA19446,0,,9715
18,66992815,66994095,del,HG00698,0,,1280
18,14285298,14304793,del,HG01060,0,,19495
18,1219331,1219480,del,HG00311,0,,149
18,20025203,20027035,del,NA19431,0,,1832
18,14050844,14051379,del,NA19355,0,,535
18,59591597,59591781,del,NA12155,0,,184
18,21289428,21289897,del,NA18505,0,,469
18,31143912,31144230,del,NA19190,0,,318
18,2589679,2589856,del,NA19404,0,,177
18,5457105,5457205,del,NA18550,0,,100
18,35963747,35967807,del,NA19379,0,,4060
18,61003426,61004512,del,NA19331,0,,1086
18,45715331,45731242,del,NA20536,0,,15911
18,63334389,63340129,del,NA19908,0,,5740
18,93768,94879,del,NA19436,0,,1111
18,76709891,76710049,del,HG01052,0,,158
18,9297063,9297742,del,NA18999,0,,679
18,34035510,34037589,del,NA19914,0,,2079
18,31121692,31128193,del,HG00578,0,,6501
18,3367478,3372991,del,HG00448,0,,5513
18,42145668,42152643,del,HG00323,0,,6975
18,75241798,75243058,del,NA19311,0,,1260
18,29888162,29889490,del,NA19901,0,,1328
18,36577666,36586972,del,NA19834,0,,9306
18,44928297,44929266,del,NA19440,0,,969
18,7353290,7354220,del,NA18530,0,,930
18,3635255,3636505,del,NA19390,0,,1250
18,11855871,11856637,del,HG01187,0,,766
18,64130020,64133159,del,NA19257,0,,3139
18,32088037,32089283,del,NA11993,0,,1246
18,76595235,76595757,del,HG01351,0,,522
18,51184938,51197149,del,NA20588,0,,12211
18,34509333,34512014,del,NA19114,0,,2681
18,42145721,42152556,del,HG00323,0,,6835
18,50007638,50007775,del,HG00136,0,,137
18,77625727,77625891,del,HG01204,0,,164
18,77408550,77408735,del,HG00310,0,,185
18,23478783,23505403,del,HG00637,0,,26620
18,68055559,68056208,del,NA19355,0,,649
18,33390250,33390581,del,NA19390,0,,331
18,63128115,63178996,del,NA19722,0,,50881
18,3367512,3372694,del,HG00448,0,,5182
18,26234507,26234735,del,HG01183,0,,228
18,11237391,11237490,del,NA19137,0,,99
18,32759920,32767818,del,NA19138,0,,7898
18,293330,304281,del,NA19712,0,,10951
18,28405220,28412516,del,NA19010,0,,7296
18,67172987,67174517,del,HG00653,0,,1530
18,22334972,22343245,del,NA19654,0,,8273
18,6272555,6273491,del,HG00257,0,,936
18,3630128,3631677,del,NA18537,0,,1549
18,14259031,14297747,del,HG00458,0,,38716
18,32530959,32531236,del,HG01354,0,,277
18,72450302,72450534,del,HG01051,0,,232
18,19816416,19821135,del,NA20502,0,,4719
18,13143690,13143860,del,NA18563,0,,170
18,43895623,43896468,del,NA20585,0,,845
18,7216123,7217009,del,NA18980,0,,886
18,1199563,1200309,del,NA18489,0,,746
18,6910929,6911520,del,HG00737,0,,591
18,2262267,2265372,del,NA19436,0,,3105
18,55908738,55909335,del,NA19428,0,,597
18,24791586,24791870,del,HG00308,0,,284
18,4330209,4335626,del,NA18522,0,,5417
18,23633281,23633641,del,NA18907,0,,360
18,38445144,38445351,del,NA19701,0,,207
18,43676680,43677694,del,HG00629,0,,1014
18,77908788,77910904,del,NA19093,0,,2116
18,75992379,75992484,del,NA07056,0,,105
18,6107633,6110130,del,NA18565,0,,2497
18,77653796,77655446,del,HG01051,0,,1650
18,39585688,39586322,del,HG00479,0,,634
18,73901668,73902040,del,HG00560,0,,372
18,48356523,48361006,del,NA19920,0,,4483
18,64006978,64008002,del,NA18517,0,,1024
18,3740779,3741206,del,HG01350,0,,427
18,73074102,73080442,del,HG00683,0,,6340
18,299247,300724,del,NA18630,0,,1477
18,45095271,45096070,del,NA19819,0,,799
18,5209639,5210658,del,NA12273,0,,1019
18,39060522,39068424,del,NA18530,0,,7902
18,44927150,44927238,del,NA18559,0,,88
18,73777140,73786319,del,NA18560,0,,9179
18,69348684,69353862,del,HG00331,0,,5178
18,14275214,14294799,del,NA20536,0,,19585
18,10689448,10689688,del,NA19776,0,,240
18,168526,177588,del,HG00732,0,,9062
18,31985132,31985933,del,NA18596,0,,801
18,1852007,1852319,del,NA19679,0,,312
18,30226291,30229211,del,HG01491,0,,2920
18,19897589,19898472,del,HG00663,0,,883
18,77365951,77366034,del,NA20810,0,,83
18,3504088,3507479,del,NA11994,0,,3391
18,38486288,38487050,del,HG00327,0,,762
18,63350789,63352791,del,NA18638,0,,2002
18,76233273,76235559,del,NA19247,0,,2286
18,64959316,64965272,del,NA19448,0,,5956
18,50962972,50963562,del,NA19332,0,,590
18,4022858,4022960,del,HG00346,0,,102
18,75381812,75383050,del,HG01082,0,,1238
18,66745594,66756999,del,NA18963,0,,11405
18,28717938,28718786,del,HG00607,0,,848
18,67440621,67453379,del,NA20532,0,,12758
18,26273266,26278272,del,HG00559,0,,5006
18,9324172,9327288,del,NA19438,0,,3116
18,43773312,43775599,del,NA18487,0,,2287
18,50462565,50463030,del,NA11920,0,,465
18,56795021,56803203,del,HG01140,0,,8182
18,1196672,1885548,del,NA19248,0,,688876
18,8569965,8572431,del,HG00108,0,,2466
18,46521935,46523184,del,NA20771,0,,1249
18,72620908,72631985,del,NA18989,0,,11077
18,54160505,54160856,del,HG00740,0,,351
18,35306060,35306632,del,HG00551,0,,572
18,1854688,1854921,del,HG00653,0,,233
18,76157383,76160470,del,NA20537,0,,3087
18,77057746,77058984,del,HG01124,0,,1238
18,23436065,23436962,del,NA18539,0,,897
18,20825200,20825533,del,HG00543,0,,333
18,2372220,2376971,del,NA19116,0,,4751
18,32982174,32988008,del,HG00672,0,,5834
18,75669955,75670233,del,NA18868,0,,278
18,71129546,71161187,del,NA20503,0,,31641
18,24307605,24311117,del,HG00473,0,,3512
18,24555662,24557024,del,NA19783,0,,1362
18,27489016,27490858,del,NA07037,0,,1842
18,63635466,63640220,del,NA19438,0,,4754
18,27988222,28050914,del,HG00634,0,,62692
18,59861666,59865235,del,NA19063,0,,3569
18,69428112,69441441,del,HG00249,0,,13329
18,633729,637284,del,HG00693,0,,3555
18,65295573,65317246,del,HG01052,0,,21673
18,11865086,11866911,del,NA18488,0,,1825
18,11337250,11344391,del,NA18597,0,,7141
18,1903091,1984847,del,HG00114,0,,81756
18,30724956,30737164,del,NA11932,0,,12208
18,32665958,32669960,del,HG00325,0,,4002
18,59672725,59674184,del,HG01137,0,,1459
18,9225118,9225453,del,NA19700,0,,335
18,11971916,11972237,del,NA11829,0,,321
18,74408034,74408599,del,HG00328,0,,565
18,77929681,77933132,del,HG00566,0,,3451
18,3635909,3637378,del,NA18950,0,,1469
18,3074921,3076161,del,HG00318,0,,1240
18,47870303,47876356,del,NA18871,0,,6053
18,37043928,37045120,del,NA19625,0,,1192
18,10160724,10160974,del,NA19099,0,,250
18,14549337,14550487,del,NA12383,0,,1150
18,55019016,55021122,del,HG00338,0,,2106
18,836710,837665,del,NA19401,0,,955
18,46979020,46979601,del,NA19371,0,,581
18,75261123,75261481,del,NA18945,0,,358
18,55851229,55851959,del,HG00436,0,,730
18,47850761,47852114,del,NA20798,0,,1353
18,37876886,37890912,del,HG00683,0,,14026
18,38677,80667,del,HG00592,0,,41990
18,36639852,36640098,del,NA19371,0,,246
18,47955917,47961478,del,NA12283,0,,5561
18,69591102,69607643,del,NA19075,0,,16541
18,53757024,53757821,del,NA19904,0,,797
18,10286520,10292704,del,HG01083,0,,6184
18,33187709,33188691,del,NA18635,0,,982
18,43977427,43978915,del,NA18907,0,,1488
18,2668022,2671056,del,NA20806,0,,3034
18,55002689,55006352,del,NA19360,0,,3663
18,69078361,69079062,del,HG01334,0,,701
18,64339234,64339466,del,HG01080,0,,232
18,32333296,32333645,del,NA18907,0,,349
18,27139247,27142637,del,NA19452,0,,3390
18,1144434,1151681,del,HG00258,0,,7247
18,57063103,57064165,del,NA19474,0,,1062
18,6052382,6056304,del,NA19064,0,,3922
18,43941646,43946279,del,NA18606,0,,4633
18,25070868,25072167,del,NA19235,0,,1299
18,76295466,76296724,del,NA12347,0,,1258
18,11676953,11679159,del,HG01140,0,,2206
18,77983253,77999242,del,HG01048,0,,15989
18,45094978,45096070,del,NA19471,0,,1092
18,41976707,41982075,del,HG00338,0,,5368
18,19503381,19503875,del,NA19374,0,,494
18,14280067,14299599,del,NA12155,0,,19532
18,76658665,76658731,del,HG00699,0,,66
18,58019858,58024653,del,NA18573,0,,4795
18,60770688,60771020,del,HG00311,0,,332
18,14145974,14151056,del,NA19474,0,,5082
18,30960077,30962975,del,NA18595,0,,2898
18,31121629,31128171,del,HG00578,0,,6542
18,53312937,53322692,del,HG01048,0,,9755
18,74347196,74347997,del,NA12489,0,,801
18,28771328,28775924,del,NA18487,0,,4596
18,3335191,3336630,del,NA19372,0,,1439
18,52228888,52233882,del,HG00634,0,,4994
18,12587344,12587553,del,HG01357,0,,209
18,21626164,21627319,del,NA18508,0,,1155
18,59448218,59451609,del,NA19440,0,,3391
18,9043817,9047334,del,NA20536,0,,3517
18,58486422,58487202,del,NA19438,0,,780
18,51205969,51210574,del,NA20518,0,,4605
18,74504689,74504793,del,HG01083,0,,104
18,36144563,36145503,del,NA18501,0,,940
18,38116302,38120360,del,HG01350,0,,4058
18,40598,87399,dup,HG00592,0,,46801
18,82935,104848,dup,HG01519,0,,21913
18,119962,143905,dup,HG01840,0,,23943
18,128077,323706,dup,HG00261,0,,195629
18,153985,282924,dup,NA12827,0,,128939
18,294060,304168,dup,HG01889,0,,10108
18,340895,344933,dup,HG01048,0,,4038
18,340957,547583,dup,HG01048,0,,206626
18,352246,550862,dup,HG00261,0,,198616
18,355537,464364,dup,HG01048,0,,108827
18,484517,519607,dup,HG01048,0,,35090
18,551569,745897,dup,HG00261,0,,194328
18,640491,689131,dup,NA20809,0,,48640
18,1631846,1639788,dup,HG01841,0,,7942
18,1721521,1842828,dup,HG01746,0,,121307
18,1875910,1921255,dup,HG00261,0,,45345
18,1906571,1985566,dup,HG00105,0,,78995
18,2183351,2238360,dup,HG00620,0,,55009
18,2183436,2306979,dup,HG00261,0,,123543
18,2239686,2432002,dup,HG00620,0,,192316
18,2395069,2566411,dup,HG00261,0,,171342
18,2403927,2465130,dup,NA19355,0,,61203
18,2634219,2643514,dup,HG01624,0,,9295
18,2659472,2734289,dup,HG00189,0,,74817
18,2683161,2733655,dup,HG01624,0,,50494
18,2747876,2774872,dup,NA20858,0,,26996
18,2789996,2793380,dup,HG01933,0,,3384
18,2830243,2834901,dup,HG01092,0,,4658
18,3200017,3415245,dup,HG00245,0,,215228
18,3206428,3282326,dup,HG03937,0,,75898
18,3274912,3397932,dup,HG03937,0,,123020
18,3389933,3421193,dup,HG03937,0,,31260
18,3982202,3988629,dup,HG01518,0,,6427
18,4151476,4171783,dup,HG02953,0,,20307
18,4881324,4894442,dup,HG01870,0,,13118
18,6655363,6663605,dup,HG00610,0,,8242
18,6930547,7042396,dup,HG01363,0,,111849
18,7055700,7061761,dup,HG01363,0,,6061
18,7078557,7202091,dup,HG01841,0,,123534
18,7079063,7092865,dup,HG00650,0,,13802
18,7109337,7113398,dup,HG00650,0,,4061
18,7119861,7135439,dup,HG00650,0,,15578
18,7150147,7158502,dup,HG00650,0,,8355
18,7214405,7250062,dup,HG00650,0,,35657
18,7332662,7344788,dup,HG00650,0,,12126
18,7465465,7565122,dup,HG00650,0,,99657
18,7605161,7662994,dup,HG02666,0,,57833
18,8195742,8211183,dup,NA21089,0,,15441
18,8196144,8215420,dup,NA21089,0,,19276
18,9690513,9696573,dup,HG02884,0,,6060
18,9693933,9733695,dup,HG04134,0,,39762
18,9927953,9961571,dup,HG00117,0,,33618
18,9931409,10085246,dup,NA12004,0,,153837
18,9948731,10005973,dup,HG00117,0,,57242
18,9999794,10121974,dup,HG00117,0,,122180
18,10167855,10228703,dup,HG02445,0,,60848
18,10169336,10216925,dup,NA12829,0,,47589
18,10327443,10347696,dup,NA21097,0,,20253
18,11177920,11191318,dup,HG00123,0,,13398
18,11613645,11645254,dup,HG00130,0,,31609
18,11840725,11854123,dup,HG03567,0,,13398
18,11915115,11926890,dup,HG02020,0,,11775
18,11940337,11946117,dup,HG02491,0,,5780
18,12045352,12076108,dup,NA19023,0,,30756
18,12187416,12201615,dup,HG02811,0,,14199
18,12232120,12260966,dup,HG03854,0,,28846
18,12911153,12927425,dup,HG00160,0,,16272
18,14063028,14098928,dup,HG01920,0,,35900
18,14259601,14277082,dup,HG00146,0,,17481
18,14282372,14295289,dup,HG00099,0,,12917
18,14300818,14312830,dup,HG00437,0,,12012
18,14314521,14328871,dup,HG00437,0,,14350
18,14803791,14811140,dup,HG00096,0,,7349
18,14815739,14838588,dup,HG03999,0,,22849
18,18538466,18567168,dup,HG03212,0,,28702
18,18540430,18584531,dup,HG03212,0,,44101
18,18992301,19168100,dup,HG01986,0,,175799
18,19611932,19615180,dup,HG01277,0,,3248
18,20101407,20112815,dup,HG01583,0,,11408
18,20221173,20235330,dup,NA19655,0,,14157
18,20242262,20303132,dup,NA19108,0,,60870
18,21622765,21632830,dup,NA18942,0,,10065
18,22350795,22353882,dup,HG02060,0,,3087
18,23347149,23350698,dup,HG01878,0,,3549
18,23480707,23508209,dup,HG02323,0,,27502
18,23762913,23766165,dup,HG00100,0,,3252
18,23777843,23791563,dup,HG03130,0,,13720
18,24529280,24566954,dup,HG03765,0,,37674
18,24645022,24668774,dup,NA12286,0,,23752
18,24965049,24982821,dup,HG00595,0,,17772
18,24967831,24980258,dup,NA20509,0,,12427
18,25153272,25167657,dup,HG00729,0,,14385
18,25366884,25381743,dup,HG01795,0,,14859
18,26336998,26397922,dup,HG02603,0,,60924
18,26411295,26442677,dup,HG02603,0,,31382
18,26573259,26629937,dup,HG02678,0,,56678
18,27831610,27835556,dup,HG02190,0,,3946
18,27989990,28052194,dup,HG00475,0,,62204
18,28863797,28870201,dup,HG01843,0,,6404
18,28962912,29016180,dup,HG02072,0,,53268
18,29306768,29315119,dup,HG02952,0,,8351
18,29372074,29429468,dup,HG02292,0,,57394
18,29381386,29482547,dup,HG02292,0,,101161
18,29441286,29489061,dup,HG02292,0,,47775
18,29542037,29574010,dup,HG00554,0,,31973
18,29646954,29678554,dup,HG00662,0,,31600
18,29652540,29670898,dup,HG00662,0,,18358
18,29667399,29678130,dup,HG00662,0,,10731
18,30584706,30629705,dup,HG03898,0,,44999
18,30755995,30774651,dup,NA19818,0,,18656
18,31296552,31365365,dup,HG00332,0,,68813
18,32563232,32577526,dup,HG00698,0,,14294
18,32813756,32846457,dup,HG01197,0,,32701
18,33304597,33310629,dup,HG03088,0,,6032
18,33374296,33392603,dup,NA19773,0,,18307
18,33804852,33810219,dup,HG01947,0,,5367
18,34114914,34238319,dup,NA12004,0,,123405
18,34124892,34152163,dup,NA18971,0,,27271
18,34239828,34461171,dup,NA12004,0,,221343
18,34742839,34760465,dup,HG03636,0,,17626
18,34777395,34800824,dup,NA19475,0,,23429
18,35102711,35116567,dup,HG02156,0,,13856
18,35134173,35142127,dup,HG01893,0,,7954
18,35250234,35270924,dup,HG04094,0,,20690
18,35825939,35856495,dup,NA19019,0,,30556
18,36631820,36652687,dup,HG00288,0,,20867
18,36650192,36657625,dup,HG00288,0,,7433
18,37133355,37179893,dup,NA20503,0,,46538
18,37328707,37333031,dup,HG03442,0,,4324
18,38674093,38680192,dup,HG01325,0,,6099
18,38733375,38747339,dup,HG03821,0,,13964
18,38776938,38938621,dup,HG01852,0,,161683
18,38786528,39335240,dup,HG01852,0,,548712
18,38895045,39696823,dup,HG01852,0,,801778
18,38957661,39074955,dup,HG01852,0,,117294
18,39160862,39290442,dup,NA12004,0,,129580
18,39296931,39363300,dup,HG01852,0,,66369
18,39382242,39435847,dup,HG00180,0,,53605
18,39398135,39561383,dup,NA11829,0,,163248
18,39564159,39584665,dup,HG01852,0,,20506
18,39589181,39707525,dup,HG01852,0,,118344
18,40588915,40612361,dup,NA18595,0,,23446
18,41907011,42033905,dup,HG00111,0,,126894
18,42039595,42081488,dup,HG00111,0,,41893
18,43395399,43426127,dup,HG03118,0,,30728
18,43395438,43426629,dup,HG03118,0,,31191
18,43554835,43567779,dup,NA12234,0,,12944
18,43576596,43788953,dup,HG02585,0,,212357
18,43577118,43664501,dup,HG03479,0,,87383
18,43669939,43792103,dup,HG02585,0,,122164
18,44222795,44264710,dup,HG02562,0,,41915
18,44282680,44410229,dup,HG03738,0,,127549
18,44284741,44413851,dup,HG00651,0,,129110
18,44285910,44335235,dup,HG03738,0,,49325
18,44517394,44529491,dup,HG03452,0,,12097
18,44525074,44536216,dup,HG03452,0,,11142
18,44616013,44745761,dup,HG02420,0,,129748
18,44619406,44687740,dup,HG02420,0,,68334
18,44780193,44851135,dup,HG02420,0,,70942
18,45172498,45192834,dup,HG02837,0,,20336
18,45715387,45734592,dup,HG01515,0,,19205
18,49177778,49195464,dup,NA18953,0,,17686
18,49536928,49541299,dup,HG00171,0,,4371
18,49638974,49709320,dup,NA18642,0,,70346
18,49726155,49757216,dup,NA19729,0,,31061
18,49735527,49764066,dup,NA19729,0,,28539
18,52391112,52394196,dup,HG00112,0,,3084
18,54320726,54337630,dup,HG02610,0,,16904
18,55945598,55972243,dup,NA18745,0,,26645
18,56018525,56106379,dup,NA18519,0,,87854
18,56479755,56494715,dup,NA19137,0,,14960
18,56505191,56516081,dup,HG03695,0,,10890
18,57652523,57667536,dup,HG02317,0,,15013
18,58334103,58392088,dup,HG00274,0,,57985
18,59136944,59150396,dup,NA19213,0,,13452
18,59137639,59152572,dup,NA19213,0,,14933
18,60611058,60669010,dup,HG03907,0,,57952
18,60611371,60672483,dup,HG00133,0,,61112
18,60612452,60663276,dup,HG00366,0,,50824
18,61012073,61015097,dup,HG00112,0,,3024
18,61310970,61326666,dup,HG03078,0,,15696
18,61381884,61473078,dup,NA19114,0,,91194
18,61478898,61512513,dup,HG03702,0,,33615
18,61498489,61653311,dup,NA19114,0,,154822
18,61589566,61621450,dup,NA18616,0,,31884
18,61669363,61952589,dup,NA19114,0,,283226
18,61825889,61841749,dup,HG00458,0,,15860
18,61979007,61983459,dup,HG02282,0,,4452
18,62066256,62089468,dup,HG03603,0,,23212
18,62114187,62149319,dup,NA20802,0,,35132
18,62158359,62178400,dup,NA19085,0,,20041
18,62171261,62193012,dup,NA10847,0,,21751
18,62205492,62225487,dup,NA20802,0,,19995
18,62221234,62241979,dup,HG04060,0,,20745
18,62560117,62570882,dup,HG02111,0,,10765
18,62573959,62593560,dup,NA19670,0,,19601
18,62600446,62622526,dup,NA19670,0,,22080
18,62911688,62921546,dup,HG00656,0,,9858
18,63131034,63181419,dup,NA20812,0,,50385
18,63200725,63206716,dup,HG00122,0,,5991
18,63907090,63911897,dup,HG00097,0,,4807
18,64301620,64318735,dup,NA19331,0,,17115
18,64402412,64432994,dup,NA20801,0,,30582
18,64414059,64430032,dup,NA20514,0,,15973
18,64534845,64577614,dup,HG01804,0,,42769
18,64678104,64736579,dup,HG03616,0,,58475
18,64726676,64754058,dup,HG03616,0,,27382
18,64745100,64799119,dup,HG03616,0,,54019
18,65125223,65266370,dup,NA20875,0,,141147
18,65203288,65230935,dup,NA20875,0,,27647
18,65241698,65247754,dup,HG03713,0,,6056
18,65253148,65262505,dup,HG00181,0,,9357
18,65259617,65291043,dup,HG00181,0,,31426
18,65295956,65318253,dup,HG01052,0,,22297
18,65320834,65486705,dup,HG00181,0,,165871
18,65631753,65690866,dup,HG00181,0,,59113
18,65647545,65695314,dup,NA20890,0,,47769
18,65781979,65832855,dup,NA21100,0,,50876
18,65787583,65814299,dup,NA18504,0,,26716
18,65846334,65898600,dup,HG00246,0,,52266
18,66005953,66123983,dup,NA19098,0,,118030
18,66123984,66182718,dup,HG02394,0,,58734
18,66540112,66609191,dup,HG02185,0,,69079
18,66616523,66733082,dup,HG02185,0,,116559
18,66758587,66767107,dup,NA19019,0,,8520
18,67066128,67456195,dup,NA06984,0,,390067
18,67464324,67521705,dup,NA06984,0,,57381
18,67543730,67559141,dup,HG03947,0,,15411
18,67688736,67715562,dup,NA06984,0,,26826
18,67922841,67957574,dup,NA06984,0,,34733
18,68025864,68083380,dup,HG00614,0,,57516
18,68171873,68324686,dup,NA06984,0,,152813
18,68261076,68268093,dup,HG01089,0,,7017
18,68276079,68318331,dup,HG03265,0,,42252
18,68326128,68427520,dup,NA06984,0,,101392
18,68419934,68439920,dup,NA06984,0,,19986
18,68420408,68432936,dup,HG03018,0,,12528
18,68432722,68735031,dup,NA06984,0,,302309
18,68659872,68700386,dup,HG03745,0,,40514
18,68741164,69007845,dup,NA06984,0,,266681
18,68768919,68797607,dup,HG03854,0,,28688
18,68832261,68855921,dup,HG03888,0,,23660
18,69012512,69251241,dup,HG00242,0,,238729
18,69282166,69347725,dup,HG03397,0,,65559
18,69641483,69741074,dup,NA06984,0,,99591
18,69743989,69768976,dup,NA06984,0,,24987
18,69780387,69933703,dup,NA06984,0,,153316
18,69848248,69884839,dup,NA06984,0,,36591
18,69997715,70052510,dup,HG01137,0,,54795
18,70114588,70120235,dup,HG01813,0,,5647
18,70122073,70290985,dup,NA06984,0,,168912
18,70325654,70340298,dup,NA06984,0,,14644
18,70598850,70627104,dup,NA06984,0,,28254
18,70638827,70643745,dup,HG00186,0,,4918
18,70879097,71102019,dup,NA06984,0,,222922
18,70879492,71030234,dup,NA20822,0,,150742
18,71170203,71262223,dup,NA06984,0,,92020
18,71314269,71470652,dup,HG00177,0,,156383
18,71315313,71339831,dup,HG02371,0,,24518
18,71415830,71450711,dup,HG02138,0,,34881
18,71444747,71460543,dup,HG02138,0,,15796
18,71452664,71512178,dup,HG02138,0,,59514
18,71475742,71605924,dup,HG01625,0,,130182
18,71614781,71652083,dup,NA06984,0,,37302
18,71915456,72012492,dup,NA06984,0,,97036
18,72026198,72042019,dup,HG02392,0,,15821
18,72036974,72120575,dup,NA06984,0,,83601
18,72121949,72281773,dup,NA06984,0,,159824
18,72124813,72134588,dup,NA20795,0,,9775
18,72186799,72212225,dup,HG02394,0,,25426
18,72282113,72377584,dup,HG02394,0,,95471
18,72335593,72407196,dup,NA06984,0,,71603
18,72413815,72766710,dup,NA06984,0,,352895
18,72779480,73456184,dup,NA06984,0,,676704
18,73257029,73272107,dup,NA06984,0,,15078
18,73301598,73326245,dup,NA06984,0,,24647
18,73316258,73324307,dup,HG02312,0,,8049
18,73453660,73481374,dup,HG03703,0,,27714
18,73471011,73658933,dup,NA06984,0,,187922
18,73674396,73921548,dup,NA06984,0,,247152
18,73792606,73810877,dup,HG03743,0,,18271
18,73925346,74149560,dup,NA06984,0,,224214
18,73928867,73939208,dup,NA06984,0,,10341
18,74026670,74035186,dup,HG02870,0,,8516
18,74152912,74323402,dup,NA06984,0,,170490
18,74176587,74183253,dup,NA19676,0,,6666
18,74404312,74475643,dup,NA06984,0,,71331
18,74413818,74471785,dup,HG01709,0,,57967
18,74623723,74714885,dup,NA06984,0,,91162
18,74719161,74738989,dup,NA06984,0,,19828
18,74744804,75077655,dup,NA06984,0,,332851
18,74843281,74939348,dup,NA06984,0,,96067
18,74848174,74923254,dup,HG02252,0,,75080
18,75154843,75357801,dup,NA06984,0,,202958
18,75214988,75240044,dup,HG02345,0,,25056
18,75379753,75401931,dup,NA06984,0,,22178
18,75388793,75615162,dup,NA06984,0,,226369
18,75398294,75413660,dup,NA06984,0,,15366
18,75447359,75471630,dup,HG02628,0,,24271
18,75623674,75721676,dup,NA06984,0,,98002
18,75775014,75906695,dup,NA06984,0,,131681
18,75839120,75921911,dup,HG03631,0,,82791
18,75914025,75956582,dup,NA06984,0,,42557
18,75960644,76064439,dup,NA06984,0,,103795
18,75976549,75990553,dup,NA06984,0,,14004
18,76003598,76011776,dup,NA06984,0,,8178
18,76072294,76160875,dup,NA06984,0,,88581
18,76154565,76168152,dup,NA06984,0,,13587
18,76180440,76348376,dup,NA06984,0,,167936
18,76277473,76296503,dup,HG02819,0,,19030
18,76279650,76295344,dup,HG04003,0,,15694
18,76383042,76392705,dup,HG04003,0,,9663
18,76427382,76485763,dup,NA06984,0,,58381
18,76544238,76748253,dup,NA06984,0,,204015
18,76763881,76872789,dup,NA06984,0,,108908
18,76782633,76827833,dup,NA19431,0,,45200
18,76847927,77011969,dup,HG02896,0,,164042
18,76993586,77351185,dup,NA06984,0,,357599
18,77015829,77072971,dup,HG02896,0,,57142
18,77074344,77088112,dup,HG02896,0,,13768
18,77312110,77349707,dup,HG00266,0,,37597
18,77355464,77376594,dup,HG00266,0,,21130
18,77368703,77402231,dup,HG00596,0,,33528
18,77406532,77453043,dup,HG02661,0,,46511
18,77464447,77472227,dup,HG00179,0,,7780
18,77517704,77548800,dup,HG02661,0,,31096
18,77549692,77572241,dup,HG02661,0,,22549
18,77558861,77591938,dup,HG02661,0,,33077
18,77559861,77914915,dup,HG02661,0,,355054
18,77857360,77940079,dup,HG02661,0,,82719
18,77893992,77982097,dup,NA06984,0,,88105
18,77983200,78000086,dup,HG01047,0,,16886
19,40464309,40464881,del,NA20769,0,,572
19,23465127,23466772,del,NA19719,0,,1645
19,3711234,3718505,del,HG01137,0,,7271
19,59050429,59052029,del,NA18909,0,,1600
19,53936268,53973010,del,HG00705,0,,36742
19,35661079,35665797,del,NA18623,0,,4718
19,55636994,55637596,del,NA19380,0,,602
19,16144256,16144499,del,HG00258,0,,243
19,23837880,23843872,del,NA19429,0,,5992
19,58437605,58437773,del,NA12829,0,,168
19,45473105,45474248,del,HG01492,0,,1143
19,14853269,14854385,del,NA20770,0,,1116
19,15984070,15984205,del,HG01136,0,,135
19,7663549,7663900,del,HG00475,0,,351
19,20044868,20045288,del,HG00404,0,,420
19,55292916,55339922,del,NA18542,0,,47006
19,2017661,2018364,del,HG00672,0,,703
19,57529533,57529783,del,HG00281,0,,250
19,55486595,55486926,del,NA19007,0,,331
19,36760478,36762989,del,NA20317,0,,2511
19,10034514,10040007,del,NA20808,0,,5493
19,3725600,3728122,del,NA18942,0,,2522
19,549016,559022,del,NA19470,0,,10006
19,58373248,58374430,del,NA19909,0,,1182
19,33819255,33819933,del,HG00536,0,,678
19,46796802,46797133,del,HG01389,0,,331
19,12694876,12698930,del,HG01519,0,,4054
19,7818619,7819889,del,NA07347,0,,1270
19,1950284,1951825,del,NA19444,0,,1541
19,49291911,49293474,del,NA19711,0,,1563
19,13838085,13838484,del,HG00159,0,,399
19,17426034,17426190,del,HG00325,0,,156
19,17661956,17662945,del,NA19782,0,,989
19,2033040,2033182,del,NA11932,0,,142
19,33650773,33655823,del,HG00699,0,,5050
19,23908090,23914360,del,HG00437,0,,6270
19,55906903,55908041,del,NA19198,0,,1138
19,54062407,54062500,del,HG01101,0,,93
19,1046716,1051022,del,HG01083,0,,4306
19,21903050,21905567,del,NA20541,0,,2517
19,22907550,22908599,del,HG00478,0,,1049
19,56598716,56600622,del,HG00629,0,,1906
19,51077889,51082511,del,NA20536,0,,4622
19,2582855,2585888,del,HG01095,0,,3033
19,24459052,24464775,del,HG01052,0,,5723
19,786550,786695,del,HG00251,0,,145
19,43507806,43753316,del,NA18856,0,,245510
19,22819556,22823095,del,HG00610,0,,3539
19,48773616,48776022,del,HG00449,0,,2406
19,36118574,36118979,del,HG01375,0,,405
19,12660832,12665759,del,NA18999,0,,4927
19,12424207,12426278,del,NA18951,0,,2071
19,35119202,35121577,del,HG00345,0,,2375
19,18566036,18566642,del,HG00096,0,,606
19,15726760,15787787,del,NA20768,0,,61027
19,55465259,55465831,del,NA20510,0,,572
19,23046895,23047419,del,NA18592,0,,524
19,4542016,4547222,del,HG00607,0,,5206
19,54856150,54856581,del,NA19077,0,,431
19,41454125,41521757,del,HG00707,0,,67632
19,57737312,57738855,del,HG00731,0,,1543
19,18242158,18242478,del,NA19914,0,,320
19,48983057,48983182,del,HG00313,0,,125
19,21981197,21984481,del,NA19819,0,,3284
19,49790908,49801098,del,NA18572,0,,10190
19,35340008,35342576,del,NA19371,0,,2568
19,11294842,11296505,del,HG00578,0,,1663
19,50663831,50666762,del,HG00613,0,,2931
19,38522216,38523257,del,NA19789,0,,1041
19,54678316,54678427,del,NA18552,0,,111
19,57284024,57284225,del,NA19390,0,,201
19,42971976,42972903,del,HG00309,0,,927
19,4036316,4036500,del,HG01357,0,,184
19,3529764,3530436,del,NA19312,0,,672
19,56211480,56211945,del,NA18951,0,,465
19,56125216,56127522,del,NA19681,0,,2306
19,9222944,9225121,del,NA12546,0,,2177
19,2972498,2973816,del,NA19373,0,,1318
19,20723487,20732703,del,HG00619,0,,9216
19,5885170,5885848,del,NA19726,0,,678
19,28405434,28411098,del,NA19397,0,,5664
19,39688280,39690191,del,HG01174,0,,1911
19,17141630,17145533,del,NA19248,0,,3903
19,53082316,53083322,del,NA19371,0,,1006
19,36840751,36847072,del,NA18624,0,,6321
19,40952984,40955143,del,HG00478,0,,2159
19,23943716,23944943,del,NA19920,0,,1227
19,4228431,4228953,del,NA18567,0,,522
19,17261381,17261818,del,HG01149,0,,437
19,49659748,49660619,del,NA18867,0,,871
19,55472209,55474213,del,NA19777,0,,2004
19,43702584,43712007,del,HG00577,0,,9423
19,54856316,54857022,del,HG00404,0,,706
19,5794047,5797129,del,NA18622,0,,3082
19,45109946,45113496,del,NA19108,0,,3550
19,30621679,30621840,del,HG00282,0,,161
19,22544724,22545423,del,NA19235,0,,699
19,13739100,13739227,del,HG00280,0,,127
19,2901749,2914437,del,HG00120,0,,12688
19,27796106,27797135,del,HG00731,0,,1029
19,585716,591422,del,HG00634,0,,5706
19,10082620,10082599,del,HG00437,0,,-21
19,53872636,53873134,del,NA19079,0,,498
19,9274397,9284445,del,HG00243,0,,10048
19,21050071,21050488,del,NA20332,0,,417
19,16414333,16420925,del,NA18550,0,,6592
19,41972631,42008216,del,NA19446,0,,35585
19,52133116,52147022,del,HG00342,0,,13906
19,57835719,57836417,del,NA10851,0,,698
19,21003382,21003541,del,HG00127,0,,159
19,457062,457172,del,NA20528,0,,110
19,46530683,46533576,del,NA18486,0,,2893
19,52132566,52149422,del,HG01384,0,,16856
19,41867452,41867803,del,NA18985,0,,351
19,43705293,43769191,del,NA19701,0,,63898
19,559939,560560,del,HG00320,0,,621
19,47650562,47652121,del,NA12413,0,,1559
19,1712750,1714303,del,HG00146,0,,1553
19,19801244,19802279,del,NA19373,0,,1035
19,7483896,7484015,del,HG01108,0,,119
19,443281,443451,del,NA20127,0,,170
19,28360895,28366915,del,HG01101,0,,6020
19,30167906,30173853,del,NA19625,0,,5947
19,7154546,7159112,del,NA19380,0,,4566
19,3581047,3581376,del,NA18609,0,,329
19,59035166,59042138,del,NA18950,0,,6972
19,11413673,11415352,del,HG01204,0,,1679
19,49515112,49515108,del,HG01437,0,,-4
19,5362280,5363212,del,HG01067,0,,932
19,6778942,6779117,del,NA19373,0,,175
19,8334915,8336978,del,NA19471,0,,2063
19,50325094,50325413,del,HG01055,0,,319
19,55487870,55528641,del,HG00554,0,,40771
19,43701116,43746322,del,NA18973,0,,45206
19,2131550,2131716,del,NA18909,0,,166
19,52131854,52131987,del,HG00282,0,,133
19,8410716,8414322,del,HG01522,0,,3606
19,19777373,19785245,del,HG01171,0,,7872
19,22141536,23141257,del,NA20504,0,,999721
19,48271024,48278195,del,NA19679,0,,7171
19,54815178,54817602,del,HG00259,0,,2424
19,28132450,28132641,del,HG00239,0,,191
19,12033739,12073269,del,NA19655,0,,39530
19,15913379,15927937,del,NA19240,0,,14558
19,15323072,15324168,del,NA07357,0,,1096
19,9431452,9432104,del,NA19248,0,,652
19,56866457,56869922,del,HG01173,0,,3465
19,45814149,45814612,del,HG01551,0,,463
19,40466489,40467813,del,NA19726,0,,1324
19,45590354,45591455,del,NA19461,0,,1101
19,27956988,27960311,del,HG00306,0,,3323
19,46314914,46316823,del,HG01149,0,,1909
19,15784149,15784308,del,HG00186,0,,159
19,56308059,56309367,del,HG00613,0,,1308
19,12557696,12557985,del,NA19468,0,,289
19,3994544,3994871,del,NA18908,0,,327
19,6726662,6728151,del,NA19399,0,,1489
19,3172972,3174682,del,HG01140,0,,1710
19,52849125,52849584,del,NA18873,0,,459
19,8937774,8937864,del,NA18907,0,,90
19,40623086,40625302,del,NA18616,0,,2216
19,324179,324636,del,HG01083,0,,457
19,40367092,40399033,del,NA20540,0,,31941
19,21644180,21656927,del,HG00321,0,,12747
19,16919845,16923440,del,NA19734,0,,3595
19,48494862,48495081,del,NA07037,0,,219
19,6635296,6636556,del,NA19311,0,,1260
19,1247063,1247367,del,HG00231,0,,304
19,21272554,21334583,del,HG00339,0,,62029
19,19802249,19802629,del,HG00619,0,,380
19,8074272,8079122,del,NA19060,0,,4850
19,1854816,1872322,del,HG01187,0,,17506
19,42398826,42399283,del,NA19700,0,,457
19,18926123,18926292,del,HG00651,0,,169
19,1405078,1405330,del,NA18555,0,,252
19,20441751,20442447,del,NA19663,0,,696
19,39234019,39234238,del,HG01437,0,,219
19,49264539,49265848,del,HG00190,0,,1309
19,39218216,39221822,del,HG00250,0,,3606
19,50553816,50561422,del,NA19382,0,,7606
19,27976022,27979438,del,HG01374,0,,3416
19,15734046,15782137,del,HG00337,0,,48091
19,4565212,4566046,del,HG00734,0,,834
19,23264357,23265342,del,HG00740,0,,985
19,8624776,8625292,del,HG00731,0,,516
19,50924043,50956959,del,HG00138,0,,32916
19,55281716,55373122,del,HG01124,0,,91406
19,548816,553922,del,NA19651,0,,5106
19,2012129,2012307,del,NA19462,0,,178
19,1950216,1951622,del,NA18959,0,,1406
19,37856469,37859787,del,HG00583,0,,3318
19,11052658,11055732,del,HG00464,0,,3074
19,16026436,16030509,del,HG00634,0,,4073
19,49731269,49732397,del,NA19078,0,,1128
19,30057814,30058627,del,NA18505,0,,813
19,9778758,9780391,del,NA18573,0,,1633
19,3529836,3530541,del,HG00178,0,,705
19,24316923,24319790,del,NA18623,0,,2867
19,46817324,46818725,del,NA18989,0,,1401
19,17153870,17157883,del,NA20754,0,,4013
19,17398716,17400472,del,NA19393,0,,1756
19,15784035,15784129,del,NA19147,0,,94
19,44019389,44027876,del,NA12003,0,,8487
19,56053791,56054050,del,HG00375,0,,259
19,17660778,17662366,del,HG00640,0,,1588
19,6758259,6759354,del,NA19701,0,,1095
19,2153878,2153985,del,HG00125,0,,107
19,56518371,56519442,del,NA19350,0,,1071
19,426463,426650,del,HG01204,0,,187
19,56077031,56077875,del,NA19210,0,,844
19,19802232,19802612,del,NA18558,0,,380
19,49051418,49054176,del,NA18558,0,,2758
19,4974108,4976226,del,NA18944,0,,2118
19,55908787,55910574,del,NA18908,0,,1787
19,53084111,53084246,del,HG00732,0,,135
19,27807699,27873374,del,NA19726,0,,65675
19,35721803,35724313,del,NA18538,0,,2510
19,56038868,56039371,del,NA20544,0,,503
19,10048706,10049658,del,NA19467,0,,952
19,57479637,57480723,del,NA19466,0,,1086
19,37273127,37276663,del,HG01173,0,,3536
19,24043431,24376746,del,NA18544,0,,333315
19,54461716,54465322,del,NA18567,0,,3606
19,12268616,12270522,del,HG00701,0,,1906
19,3947125,3949037,del,HG00577,0,,1912
19,2469762,2470881,del,HG01342,0,,1119
19,30953700,30953865,del,HG00133,0,,165
19,9930114,9931253,del,NA18560,0,,1139
19,31878189,31878931,del,NA19438,0,,742
19,12042483,12043204,del,HG00737,0,,721
19,12753337,12754494,del,NA19657,0,,1157
19,8229423,8230437,del,NA19431,0,,1014
19,703716,708522,del,HG00556,0,,4806
19,22938980,22939564,del,NA19707,0,,584
19,38341016,38346272,del,HG00368,0,,5256
19,43405737,43406089,del,NA18486,0,,352
19,52133866,52149622,del,NA20127,0,,15756
19,2713095,2713403,del,NA19786,0,,308
19,48335187,48335554,del,NA18501,0,,367
19,5508816,5511222,del,HG00318,0,,2406
19,51330498,51333892,del,NA19655,0,,3394
19,8375638,8379438,del,HG00619,0,,3800
19,4030165,4030380,del,HG00324,0,,215
19,6266537,6267182,del,NA18612,0,,645
19,39555954,39559469,del,HG00148,0,,3515
19,57706908,57714323,del,NA19908,0,,7415
19,3789993,3791400,del,NA20517,0,,1407
19,6987463,6987792,del,HG01366,0,,329
19,7451062,7454116,del,HG01359,0,,3054
19,21525088,21598833,del,HG00150,0,,73745
19,46254792,46256177,del,NA20798,0,,1385
19,3528686,3528854,del,NA19380,0,,168
19,43290194,43787919,del,NA18535,0,,497725
19,9303972,9305369,del,NA18853,0,,1397
19,18387456,18388658,del,NA18520,0,,1202
19,1137516,1141722,del,HG01170,0,,4206
19,41355752,41387619,del,NA19780,0,,31867
19,428928,429762,del,HG00281,0,,834
19,2084975,2086609,del,HG00428,0,,1634
19,22422998,22426521,del,NA20828,0,,3523
19,22509119,22509302,del,HG00473,0,,183
19,14915279,14922954,del,NA19393,0,,7675
19,21644266,21658672,del,HG00321,0,,14406
19,44892355,44938745,del,NA18874,0,,46390
19,56695433,56725268,del,HG00473,0,,29835
19,55228316,55339922,del,NA19152,0,,111606
19,20298459,20299947,del,NA19457,0,,1488
19,54355944,54369609,del,NA20544,0,,13665
19,12480592,12481659,del,NA19723,0,,1067
19,52133916,52151522,del,HG00249,0,,17606
19,54728651,54748385,del,NA19473,0,,19734
19,54798766,54808072,del,HG00589,0,,9306
19,12963897,12968000,del,NA18567,0,,4103
19,18205728,18207752,del,HG00704,0,,2024
19,34316367,34316578,del,HG01107,0,,211
19,7868451,7869732,del,NA18624,0,,1281
19,771113,775872,del,NA19399,0,,4759
19,14599537,14601699,del,NA19468,0,,2162
19,57727669,57730493,del,NA20790,0,,2824
19,22779126,22780451,del,NA20344,0,,1325
19,28510922,29438326,del,NA12287,0,,927404
19,23818145,23818707,del,NA19002,0,,562
19,15727008,15785343,del,NA07051,0,,58335
19,46383068,46383588,del,HG00422,0,,520
19,15323026,15324153,del,NA19835,0,,1127
19,13301196,13301531,del,NA12829,0,,335
19,58588453,58594378,del,NA11829,0,,5925
19,10592005,10596291,del,NA18987,0,,4286
19,53477136,53477688,del,NA18602,0,,552
19,22117237,23117036,del,NA18949,0,,999799
19,2945687,2948756,del,NA19321,0,,3069
19,8995050,8995197,del,HG00357,0,,147
19,47528265,47528732,del,NA19010,0,,467
19,1325842,1326042,del,NA19257,0,,200
19,43701116,43765322,del,NA19395,0,,64206
19,36840016,36846672,del,HG01350,0,,6656
19,38926606,38929916,del,NA20296,0,,3310
19,11969190,11971036,del,NA18559,0,,1846
19,8243011,8244957,del,NA19472,0,,1946
19,32189257,32192988,del,NA19779,0,,3731
19,51776407,51776719,del,HG00231,0,,312
19,3173078,3175787,del,NA19401,0,,2709
19,43693155,43712254,del,HG01079,0,,19099
19,2423416,2425722,del,HG00173,0,,2306
19,24486126,24490910,del,NA19066,0,,4784
19,21801851,21802297,del,NA19703,0,,446
19,29211288,29211497,del,HG01052,0,,209
19,30374870,30375016,del,HG00476,0,,146
19,4864391,4871488,del,NA20588,0,,7097
19,45341517,45341821,del,NA19376,0,,304
19,53272868,53277506,del,NA12829,0,,4638
19,40263731,40265002,del,NA20815,0,,1271
19,58769729,58769969,del,HG00263,0,,240
19,31287472,31289745,del,HG00259,0,,2273
19,19410483,19411153,del,HG01171,0,,670
19,37046181,37046497,del,HG01334,0,,316
19,3704014,3709180,del,HG00592,0,,5166
19,57777726,57779743,del,NA18868,0,,2017
19,41693166,41697472,del,NA19331,0,,4306
19,46622734,46628312,del,HG00650,0,,5578
19,49183657,49206603,del,NA18941,0,,22946
19,8470950,8474784,del,NA19451,0,,3834
19,50797535,50798188,del,NA19819,0,,653
19,57472035,57479962,del,NA12400,0,,7927
19,56272894,56282897,del,NA19471,0,,10003
19,6858781,6861083,del,NA19334,0,,2302
19,19927418,19928888,del,NA19921,0,,1470
19,39470690,39471839,del,NA18861,0,,1149
19,11779841,11782103,del,NA19661,0,,2262
19,27925364,27982809,del,NA18986,0,,57445
19,1696102,1704955,del,NA18576,0,,8853
19,54798816,54807522,del,HG01170,0,,8706
19,921765,923247,del,NA19428,0,,1482
19,21265502,21580398,del,NA20755,0,,314896
19,42418762,42419000,del,NA18637,0,,238
19,49265158,49265246,del,HG00662,0,,88
19,30316746,30317238,del,HG01441,0,,492
19,14598232,14598645,del,NA19443,0,,413
19,56038258,56038447,del,HG00543,0,,189
19,6730016,6731822,del,HG00245,0,,1806
19,19046629,19047246,del,NA11831,0,,617
19,38274530,38277757,del,NA19457,0,,3227
19,35744010,35753935,del,HG00690,0,,9925
19,47796482,47801179,del,NA19452,0,,4697
19,13942116,13942222,del,HG01082,0,,106
19,54555216,54560622,del,NA19108,0,,5406
19,6508433,6508923,del,HG00634,0,,490
19,50007101,50008306,del,NA19713,0,,1205
19,7780550,7784064,del,HG00584,0,,3514
19,47266362,47269333,del,HG00608,0,,2971
19,39625088,39625417,del,NA19312,0,,329
19,9629349,9636415,del,NA20801,0,,7066
19,49460176,49460779,del,HG00689,0,,603
19,8375622,8379545,del,HG00619,0,,3923
19,40861296,40864250,del,NA18532,0,,2954
19,19776408,19777491,del,NA19055,0,,1083
19,912316,932322,del,HG00634,0,,20006
19,15893215,15896267,del,NA19374,0,,3052
19,12247668,12248088,del,NA19462,0,,420
19,13479550,13479870,del,NA19093,0,,320
19,21096333,21096932,del,NA18908,0,,599
19,55345864,55346018,del,HG01108,0,,154
19,23649361,23650070,del,NA19658,0,,709
19,48270990,48278181,del,HG01190,0,,7191
19,35360716,35361022,del,NA19002,0,,306
19,51406802,51408378,del,HG01066,0,,1576
19,48557841,48566427,del,NA19445,0,,8586
19,41608707,41610190,del,NA19078,0,,1483
19,54295877,54297013,del,HG01079,0,,1136
19,16144075,16144424,del,HG00159,0,,349
19,33572780,33573044,del,NA19200,0,,264
19,21635887,21638097,del,NA18516,0,,2210
19,2713097,2713413,del,HG00662,0,,316
19,21857467,21865774,del,NA12058,0,,8307
19,523158,523618,del,NA19681,0,,460
19,52133016,52149372,del,NA19088,0,,16356
19,12606941,12611271,del,NA19107,0,,4330
19,21063059,21064267,del,NA12761,0,,1208
19,323256,323301,del,HG00274,0,,45
19,9274616,9286022,del,HG01515,0,,11406
19,43701033,43764901,del,HG00421,0,,63868
19,55280316,55339322,del,NA20287,0,,59006
19,17000382,17000553,del,NA12155,0,,171
19,52888816,52891386,del,HG01075,0,,2570
19,17181618,17182545,del,NA06984,0,,927
19,12556643,12558226,del,HG01137,0,,1583
19,294101,298406,del,NA12006,0,,4305
19,20595810,20711950,del,NA19150,0,,116140
19,36151625,36160316,del,NA12155,0,,8691
19,41359917,41391698,del,HG01389,0,,31781
19,30002886,30002995,del,HG00475,0,,109
19,4808070,4814053,del,HG01047,0,,5983
19,3820905,3820981,del,HG00343,0,,76
19,14511550,14513163,del,HG01072,0,,1613
19,6229281,6229671,del,NA19678,0,,390
19,47702194,47703804,del,HG00421,0,,1610
19,23390122,23391434,del,NA18617,0,,1312
19,12039273,12045721,del,HG01489,0,,6448
19,51342235,51342357,del,NA19788,0,,122
19,55470575,55472032,del,HG00267,0,,1457
19,4691762,4694131,del,NA20774,0,,2369
19,10495843,10496573,del,NA18990,0,,730
19,22533457,22533735,del,HG01384,0,,278
19,5810165,5810698,del,NA11843,0,,533
19,54800856,54807620,del,NA20525,0,,6764
19,21717095,21717341,del,NA12890,0,,246
19,1612632,1613104,del,HG00272,0,,472
19,50907554,50907870,del,NA19372,0,,316
19,35851238,35863707,del,HG00232,0,,12469
19,40987630,40990966,del,NA18546,0,,3336
19,34431602,34432582,del,NA19448,0,,980
19,7185628,7185980,del,NA18489,0,,352
19,691550,692081,del,NA11933,0,,531
19,24378853,24392851,del,HG00262,0,,13998
19,54555525,54560642,del,HG01389,0,,5117
19,49947425,49947508,del,NA19403,0,,83
19,8156967,8158412,del,HG00560,0,,1445
19,8665675,8667362,del,HG00513,0,,1687
19,7780171,7780566,del,HG00325,0,,395
19,43185102,43194899,del,HG00174,0,,9797
19,11158178,11159001,del,NA19430,0,,823
19,6387617,6388175,del,NA19985,0,,558
19,56713363,56722147,del,NA19429,0,,8784
19,4616673,4621294,del,HG00663,0,,4621
19,19049616,19052422,del,HG00137,0,,2806
19,53082261,53083458,del,NA18874,0,,1197
19,12403116,12404863,del,HG00343,0,,1747
19,566027,569255,del,HG01497,0,,3228
19,18514835,18515726,del,NA19093,0,,891
19,37736074,37737415,del,NA18637,0,,1341
19,38341321,38345463,del,HG00122,0,,4142
19,50805951,50807507,del,HG00237,0,,1556
19,9659638,9659775,del,HG00613,0,,137
19,981263,981581,del,HG00512,0,,318
19,4125887,4126090,del,NA19390,0,,203
19,54983659,55605594,del,NA18542,0,,621935
19,18044870,18045120,del,NA19257,0,,250
19,10080716,10081422,del,HG00422,0,,706
19,22312189,22314099,del,HG01083,0,,1910
19,4560586,4562823,del,NA19445,0,,2237
19,54798716,54806522,del,HG00186,0,,7806
19,12886216,12892222,del,HG00641,0,,6006
19,4974070,4976218,del,NA18550,0,,2148
19,8222510,8230916,del,HG00590,0,,8406
19,22448273,22450154,del,NA19332,0,,1881
19,38340616,38345722,del,HG00262,0,,5106
19,16485980,16486090,del,HG00271,0,,110
19,6779186,6781048,del,HG00250,0,,1862
19,5336116,5340422,del,HG00699,0,,4306
19,59021249,59023508,del,NA19788,0,,2259
19,10422008,10423117,del,NA19661,0,,1109
19,55714235,55717429,del,HG01069,0,,3194
19,828912,829244,del,NA20287,0,,332
19,13775677,13776850,del,NA19834,0,,1173
19,22768147,22768470,del,NA19098,0,,323
19,13022842,13023256,del,NA20348,0,,414
19,27764458,27770903,del,HG00259,0,,6445
19,5509801,5510769,del,NA18579,0,,968
19,40613089,40615760,del,NA20536,0,,2671
19,12164726,12177597,del,NA18542,0,,12871
19,45675156,45676348,del,NA19000,0,,1192
19,21262487,21264061,del,NA18908,0,,1574
19,27881604,27882417,del,NA19058,0,,813
19,2483707,2484250,del,NA19713,0,,543
19,57202787,57212241,del,NA19713,0,,9454
19,51086562,51088690,del,NA19078,0,,2128
19,50554741,50561372,del,NA19469,0,,6631
19,55228716,55256622,del,HG00692,0,,27906
19,48318676,48320030,del,NA19399,0,,1354
19,43319059,43487666,del,NA20766,0,,168607
19,14009566,14013276,del,HG00513,0,,3710
19,53316616,53319922,del,NA19397,0,,3306
19,55345017,55345869,del,HG01107,0,,852
19,42059314,42062139,del,HG00259,0,,2825
19,6533316,6535422,del,HG00608,0,,2106
19,45960730,45961654,del,HG00343,0,,924
19,15678665,15697788,del,NA19235,0,,19123
19,6968250,6968771,del,NA19452,0,,521
19,42418729,42418905,del,NA19786,0,,176
19,53316666,53320672,del,NA19761,0,,4006
19,20794391,20800882,del,NA18597,0,,6491
19,20259145,20261585,del,NA18856,0,,2440
19,43413205,43432074,del,NA19462,0,,18869
19,24513232,24535302,del,NA19726,0,,22070
19,18297312,18300084,del,NA19712,0,,2772
19,43981371,43981975,del,NA19153,0,,604
19,2257588,2259197,del,NA12058,0,,1609
19,30632013,30634837,del,NA18487,0,,2824
19,50445594,50447308,del,NA20581,0,,1714
19,23805772,23808318,del,HG00443,0,,2546
19,31733642,31733762,del,HG01083,0,,120
19,47097245,47099101,del,NA11843,0,,1856
19,39533082,39540843,del,NA19457,0,,7761
19,30461574,30464125,del,NA06984,0,,2551
19,23115797,23116179,del,NA19444,0,,382
19,17856113,17856803,del,NA11829,0,,690
19,52948969,52949075,del,NA19660,0,,106
19,30316688,30317190,del,HG00326,0,,502
19,22110749,23106419,del,HG00384,0,,995670
19,12649177,12651406,del,NA18986,0,,2229
19,28140077,28143009,del,NA18986,0,,2932
19,4835490,4836370,del,NA18624,0,,880
19,34363386,34363563,del,HG00437,0,,177
19,21088747,21091066,del,HG00566,0,,2319
19,456781,457199,del,NA18910,0,,418
19,9926354,9928355,del,NA19444,0,,2001
19,23608141,23611979,del,NA19107,0,,3838
19,54293167,54293387,del,HG01462,0,,220
19,17087216,17087676,del,NA19376,0,,460
19,16786900,16787108,del,HG01197,0,,208
19,3530284,3530498,del,HG00500,0,,214
19,48752389,48758397,del,NA18977,0,,6008
19,59020281,59021778,del,HG00131,0,,1497
19,41692143,41697678,del,NA19346,0,,5535
19,13306597,13307357,del,NA19456,0,,760
19,57667049,57668689,del,NA18615,0,,1640
19,21445689,21447132,del,NA18611,0,,1443
19,48098774,48104510,del,NA19685,0,,5736
19,36281691,36282324,del,NA18603,0,,633
19,8262048,8264120,del,HG01108,0,,2072
19,1977816,1980622,del,HG00278,0,,2806
19,53734344,53738439,del,NA19114,0,,4095
19,3711216,3711822,del,HG00108,0,,606
19,3119356,3120985,del,NA19382,0,,1629
19,56495747,56496064,del,HG00421,0,,317
19,14975180,15003269,del,NA18868,0,,28089
19,54423223,54424022,del,NA18867,0,,799
19,1182641,1183159,del,HG00326,0,,518
19,27988600,28002019,del,HG00662,0,,13419
19,365614,365714,del,HG00475,0,,100
19,19912507,19912884,del,NA18505,0,,377
19,1852416,1864622,del,HG00254,0,,12206
19,58567935,58568059,del,HG00650,0,,124
19,43536315,43536527,del,NA19920,0,,212
19,42307630,42307805,del,NA18624,0,,175
19,40799381,40825719,del,NA19082,0,,26338
19,8191310,8194046,del,NA19088,0,,2736
19,4036842,4037095,del,HG00524,0,,253
19,49581916,49582422,del,HG00583,0,,506
19,565916,569372,del,NA19318,0,,3456
19,9274425,9284473,del,NA18610,0,,10048
19,38677272,38679302,del,NA19396,0,,2030
19,879447,879664,del,HG00326,0,,217
19,58290764,58294364,del,HG00637,0,,3600
19,47169999,47174788,del,HG00367,0,,4789
19,54887334,54888358,del,NA19355,0,,1024
19,44957823,44963925,del,NA18571,0,,6102
19,2849127,2849484,del,NA18632,0,,357
19,33208874,33223874,del,NA11892,0,,15000
19,44140916,44141122,del,HG00108,0,,206
19,9245516,9246672,del,HG00158,0,,1156
19,49394304,49419876,del,HG00327,0,,25572
19,3173466,3175572,del,HG01182,0,,2106
19,21765773,21766094,del,NA18517,0,,321
19,35309009,35309692,del,NA19914,0,,683
19,40257544,40257850,del,HG00656,0,,306
19,14423883,14426086,del,NA19065,0,,2203
19,23955339,24237246,del,NA20542,0,,281907
19,4065616,4068022,del,NA19657,0,,2406
19,42704579,42706232,del,NA18567,0,,1653
19,53856829,53886477,del,HG01101,0,,29648
19,12556728,12558256,del,HG00177,0,,1528
19,4543116,4547222,del,HG00182,0,,4106
19,35660316,35666022,del,HG00559,0,,5706
19,28783850,28788598,del,HG01061,0,,4748
19,52134017,52150300,del,HG00464,0,,16283
19,48304131,48313697,del,HG00131,0,,9566
19,20947804,20949054,del,NA19372,0,,1250
19,31601336,31602118,del,NA07051,0,,782
19,11476671,11477312,del,NA19909,0,,641
19,1747316,1765022,del,HG01182,0,,17706
19,14381562,14382075,del,HG01465,0,,513
19,4036332,4036654,del,NA19707,0,,322
19,7250892,7252899,del,NA19921,0,,2007
19,4043316,4049322,del,HG00176,0,,6006
19,15879601,16036785,del,HG01052,0,,157184
19,27792734,27795727,del,NA20786,0,,2993
19,43603053,43790054,del,HG01048,0,,187001
19,44881955,44882510,del,HG00138,0,,555
19,39610398,39611189,del,NA18553,0,,791
19,29827164,29830347,del,NA19350,0,,3183
19,52864323,52866543,del,NA19462,0,,2220
19,55001745,55002059,del,NA20518,0,,314
19,58034593,58034820,del,NA20541,0,,227
19,55576044,55577149,del,HG01082,0,,1105
19,43488266,43492240,del,NA19982,0,,3974
19,393670,481238,del,NA18616,0,,87568
19,22191298,23183871,del,NA19434,0,,992573
19,53215240,53334170,del,NA18522,0,,118930
19,47338693,47340504,del,NA19625,0,,1811
19,8334776,8336825,del,NA19471,0,,2049
19,55225416,55373222,del,NA19338,0,,147806
19,20375834,20380270,del,NA18552,0,,4436
19,48936135,48938507,del,NA19429,0,,2372
19,3406302,3406436,del,HG00273,0,,134
19,35270046,35277891,del,HG01342,0,,7845
19,43612482,43677266,del,NA18538,0,,64784
19,51508685,51510920,del,HG00337,0,,2235
19,53504769,53506452,del,NA19916,0,,1683
19,13276956,13277365,del,NA19700,0,,409
19,21635896,21638088,del,NA19152,0,,2192
19,54555086,54562386,del,NA19434,0,,7300
19,49581952,49582258,del,NA12778,0,,306
19,8009856,8010324,del,NA18498,0,,468
19,3089212,3091361,del,NA18550,0,,2149
19,53820789,53821104,del,HG00112,0,,315
19,566149,569357,del,NA19256,0,,3208
19,16234978,16235555,del,HG01441,0,,577
19,3090239,3091402,del,HG01171,0,,1163
19,35140652,35148302,del,NA19455,0,,7650
19,36662674,36662971,del,HG01137,0,,297
19,53937023,53973849,del,HG00135,0,,36826
19,35851816,35863122,del,NA18621,0,,11306
19,23218136,23223383,del,HG01140,0,,5247
19,53518720,53523212,del,NA19654,0,,4492
19,2090722,2093175,del,NA18595,0,,2453
19,42000018,42000671,del,HG00131,0,,653
19,48773616,48779222,del,NA19470,0,,5606
19,42398805,42398982,del,HG01171,0,,177
19,17995137,17995846,del,HG00553,0,,709
19,41153258,41156004,del,HG00437,0,,2746
19,2713188,2714255,del,NA18916,0,,1067
19,51548191,51548683,del,HG00740,0,,492
19,53096316,53097372,del,NA18977,0,,1056
19,54245984,54246184,del,NA19063,0,,200
19,22532182,22571540,del,HG00422,0,,39358
19,51682507,51682965,del,NA19056,0,,458
19,30388790,30393100,del,HG01334,0,,4310
19,29337004,29339755,del,NA19137,0,,2751
19,5882104,5883823,del,NA18867,0,,1719
19,16264809,16264933,del,HG00249,0,,124
19,460016,461922,del,HG00662,0,,1906
19,55577319,55584603,del,NA20804,0,,7284
19,20325922,20326746,del,NA18610,0,,824
19,39676372,39677601,del,HG01351,0,,1229
19,3939264,3939978,del,NA20809,0,,714
19,7663936,7668615,del,HG00513,0,,4679
19,15726798,15785406,del,NA19764,0,,58608
19,21156849,21166038,del,NA18908,0,,9189
19,54461716,54466422,del,HG01148,0,,4706
19,7246861,7247037,del,HG01047,0,,176
19,47702104,47703675,del,HG00421,0,,1571
19,20074335,20753129,del,HG00148,0,,678794
19,49529792,49530099,del,NA19707,0,,307
19,47146443,47147427,del,HG01133,0,,984
19,43034536,43038095,del,HG01551,0,,3559
19,15727000,15785287,del,HG00245,0,,58287
19,22618523,22618698,del,HG00702,0,,175
19,47702075,47703439,del,HG00421,0,,1364
19,50815416,50820322,del,HG01350,0,,4906
19,16388847,16389671,del,NA19916,0,,824
19,47528235,47528702,del,HG01383,0,,467
19,56016410,56017665,del,NA19359,0,,1255
19,43700936,43764804,del,NA18536,0,,63868
19,52896386,52897133,del,NA19067,0,,747
19,53313616,53320322,del,HG00422,0,,6706
19,925616,928022,del,HG00282,0,,2406
19,56260413,56262060,del,NA19355,0,,1647
19,4880217,4884433,del,NA19347,0,,4216
19,11517485,11518622,del,HG01137,0,,1137
19,6779816,6780422,del,HG00260,0,,606
19,13308087,13308844,del,NA19114,0,,757
19,2820719,2821721,del,NA19437,0,,1002
19,16103130,16106080,del,NA20126,0,,2950
19,34727601,34730612,del,NA20814,0,,3011
19,16720381,16720858,del,NA18523,0,,477
19,47796538,47801198,del,NA19452,0,,4660
19,2131350,2131734,del,HG00336,0,,384
19,1967646,1968329,del,NA19373,0,,683
19,8156795,8158237,del,NA19152,0,,1442
19,11268936,11270075,del,HG00690,0,,1139
19,49729868,49731747,del,NA19350,0,,1879
19,32703649,32704486,del,NA18519,0,,837
19,57246005,57246519,del,HG00704,0,,514
19,28247916,28262322,del,NA20818,0,,14406
19,837862,838178,del,NA18606,0,,316
19,52133466,52151572,del,HG00475,0,,18106
19,55488170,55488233,del,NA18858,0,,63
19,52889116,52891522,del,NA19116,0,,2406
19,28002109,28003484,del,NA19012,0,,1375
19,54896068,54897488,del,NA19904,0,,1420
19,22838683,22842516,del,NA19901,0,,3833
19,15761936,15762409,del,HG01075,0,,473
19,18847178,18847549,del,NA19223,0,,371
19,667252,667409,del,HG00275,0,,157
19,21319502,21319622,del,HG00320,0,,120
19,2898982,2904639,del,NA19000,0,,5657
19,34386297,34389048,del,NA18508,0,,2751
19,20262973,20267757,del,HG00734,0,,4784
19,5184592,5184700,del,NA19138,0,,108
19,48104564,48106505,del,HG00324,0,,1941
19,39616866,39616972,del,NA19129,0,,106
19,2104272,2104440,del,NA20513,0,,168
19,17398189,17399858,del,NA19395,0,,1669
19,17637930,17639746,del,NA19789,0,,1816
19,48826518,48827718,del,NA19451,0,,1200
19,56038554,56038845,del,NA12005,0,,291
19,9442052,9451176,del,HG00613,0,,9124
19,2349091,2350369,del,HG01359,0,,1278
19,46444999,46446690,del,HG00111,0,,1691
19,49966108,49966833,del,HG00707,0,,725
19,12671467,12672730,del,NA19130,0,,1263
19,56361402,56363073,del,HG00254,0,,1671
19,2022850,2025433,del,NA19679,0,,2583
19,48856544,48857323,del,NA19469,0,,779
19,54855959,54856679,del,NA19072,0,,720
19,53558135,53558974,del,HG01462,0,,839
19,15327717,15328819,del,NA19429,0,,1102
19,3970816,3974522,del,HG00536,0,,3706
19,818938,819256,del,NA19009,0,,318
19,351242,351529,del,NA18595,0,,287
19,35248003,35248520,del,NA19720,0,,517
19,13769498,13770106,del,NA19434,0,,608
19,54180252,54181475,del,NA19448,0,,1223
19,17100853,17102443,del,NA12775,0,,1590
19,16814849,16816440,del,NA19247,0,,1591
19,10212299,10214584,del,HG00171,0,,2285
19,30001716,30005222,del,NA19382,0,,3506
19,7258362,7259292,del,HG01070,0,,930
19,4512636,4512939,del,NA19901,0,,303
19,36957806,36960277,del,NA18861,0,,2471
19,9911903,9913644,del,HG00233,0,,1741
19,21909809,21910313,del,NA06984,0,,504
19,1545155,1548546,del,HG00657,0,,3391
19,14649868,14653264,del,NA18868,0,,3396
19,37969410,37970106,del,HG01354,0,,696
19,52762806,52771530,del,NA19236,0,,8724
19,8334916,8358922,del,NA19375,0,,24006
19,1923870,1924005,del,HG00249,0,,135
19,9014943,9017757,del,NA19316,0,,2814
19,8440012,8440380,del,NA18868,0,,368
19,23675428,23675764,del,NA20754,0,,336
19,9863578,9871837,del,NA19235,0,,8259
19,3711051,3711346,del,HG01378,0,,295
19,55656716,55661022,del,HG00263,0,,4306
19,43751616,43764722,del,NA19065,0,,13106
19,49552692,49559329,del,HG00331,0,,6637
19,9015161,9017976,del,NA18489,0,,2815
19,28250319,28253731,del,NA19461,0,,3412
19,3528787,3528832,del,HG00740,0,,45
19,6163159,6163490,del,NA19077,0,,331
19,16658654,16660122,del,NA19138,0,,1468
19,12650256,12651318,del,NA19072,0,,1062
19,4786495,4786673,del,HG00699,0,,178
19,457952,458839,del,HG01073,0,,887
19,27831198,27836621,del,NA19130,0,,5423
19,45902341,45904038,del,HG00282,0,,1697
19,19834443,19839662,del,NA19064,0,,5219
19,27807857,27812257,del,NA19703,0,,4400
19,56807867,56808138,del,HG01465,0,,271
19,48372721,48374261,del,HG00261,0,,1540
19,15046391,15049477,del,NA12383,0,,3086
19,4880128,4884590,del,NA19347,0,,4462
19,2502831,2507737,del,NA18595,0,,4906
19,51079516,51082922,del,HG01075,0,,3406
19,5633618,5637183,del,HG00281,0,,3565
19,23856633,23866242,del,NA19102,0,,9609
19,41344584,41375218,del,NA19404,0,,30634
19,15985113,16017399,del,NA19054,0,,32286
19,54752861,54753615,del,HG00513,0,,754
19,20082973,20760237,del,HG01102,0,,677264
19,39505637,39505938,del,NA19116,0,,301
19,8245685,8252721,del,NA20586,0,,7036
19,54555816,54561722,del,HG01515,0,,5906
19,36808604,36808902,del,NA19172,0,,298
19,55608271,55608343,del,HG01187,0,,72
19,48304168,48313742,del,HG00131,0,,9574
19,41360712,41392496,del,NA11843,0,,31784
19,40982657,40983759,del,NA19438,0,,1102
19,49200660,49210737,del,NA19661,0,,10077
19,20712000,20717973,del,NA12891,0,,5973
19,565916,570672,del,NA18511,0,,4756
19,53316674,53319979,del,NA18534,0,,3305
19,52896590,52897356,del,HG01374,0,,766
19,16144075,16144393,del,NA19311,0,,318
19,19801695,19802299,del,NA06986,0,,604
19,58537872,58543301,del,NA19256,0,,5429
19,27996364,27998929,del,NA19835,0,,2565
19,40388294,40404027,del,NA19355,0,,15733
19,18026426,18028084,del,HG00133,0,,1658
19,41345203,41375827,del,HG01136,0,,30624
19,40665291,40666303,del,NA19346,0,,1012
19,46794654,46795452,del,NA19055,0,,798
19,8663711,8664611,del,NA18874,0,,900
19,17605114,17606223,del,NA19908,0,,1109
19,42168564,42169036,del,NA19440,0,,472
19,33996703,33996815,del,HG01072,0,,112
19,2418316,2418583,del,HG00428,0,,267
19,38341138,38345629,del,HG00342,0,,4491
19,1870188,1872325,del,NA18618,0,,2137
19,3172911,3174311,del,HG00285,0,,1400
19,31316673,31318659,del,NA19257,0,,1986
19,3716043,3717364,del,HG00254,0,,1321
19,23995973,24000121,del,HG00501,0,,4148
19,42522454,42522809,del,NA19198,0,,355
19,4662945,4663569,del,NA19088,0,,624
19,53414597,53415038,del,HG00427,0,,441
19,57615837,57618930,del,NA19236,0,,3093
19,14200316,14203722,del,HG00449,0,,3406
19,18539716,18549322,del,HG01182,0,,9606
19,47377267,47379891,del,NA20340,0,,2624
19,49296661,49298936,del,HG00146,0,,2275
19,2730825,2731016,del,HG00448,0,,191
19,8411740,8414481,del,HG00577,0,,2741
19,50369000,50369521,del,NA19818,0,,521
19,23893439,23895550,del,HG00281,0,,2111
19,52888816,52891387,del,NA19461,0,,2571
19,41344530,41375147,del,HG00242,0,,30617
19,18267720,18268193,del,NA18987,0,,473
19,4293122,4294226,del,NA19397,0,,1104
19,19258018,19258292,del,NA20816,0,,274
19,12280852,12280986,del,HG00501,0,,134
19,30289450,30289556,del,NA19373,0,,106
19,6710229,6710315,del,HG00692,0,,86
19,24457746,24467812,del,NA19916,0,,10066
19,6485667,6486929,del,NA19055,0,,1262
19,8212427,8212975,del,NA19676,0,,548
19,51519016,51523322,del,NA19452,0,,4306
19,52132966,52149772,del,NA19722,0,,16806
19,45230872,45234668,del,HG00418,0,,3796
19,2969566,2970957,del,NA18951,0,,1391
19,59096465,59096620,del,NA20518,0,,155
19,39718820,39719435,del,HG00556,0,,615
19,21671988,21675482,del,NA19440,0,,3494
19,15033636,15042670,del,NA19390,0,,9034
19,49889475,49889799,del,NA19328,0,,324
19,1029109,1029548,del,NA19712,0,,439
19,33651875,33652668,del,HG00614,0,,793
19,50553816,50560722,del,NA19213,0,,6906
19,39218816,39221422,del,HG00525,0,,2606
19,37460701,37461285,del,NA19172,0,,584
19,53180766,53182211,del,NA20289,0,,1445
19,45728700,45730016,del,HG00513,0,,1316
19,3334398,3336889,del,NA19663,0,,2491
19,42487288,42488407,del,HG01366,0,,1119
19,1714316,1714798,del,NA19916,0,,482
19,53082112,53083296,del,NA18910,0,,1184
19,55903916,55907922,del,HG00610,0,,4006
19,6933415,6934641,del,NA19063,0,,1226
19,45902447,45904280,del,HG00187,0,,1833
19,35851416,35863022,del,HG00276,0,,11606
19,53936704,53973474,del,NA18873,0,,36770
19,53387383,53388090,del,NA12750,0,,707
19,23108057,23111413,del,NA19467,0,,3356
19,17703909,17704292,del,HG00530,0,,383
19,9435840,9436166,del,HG00258,0,,326
19,56865016,56869822,del,NA19319,0,,4806
19,6539093,6542534,del,HG00593,0,,3441
19,42117133,42119169,del,NA18909,0,,2036
19,56029174,56029354,del,NA18576,0,,180
19,14649913,14653096,del,NA18868,0,,3183
19,21087755,21089727,del,NA20505,0,,1972
19,44957596,44963703,del,NA18501,0,,6107
19,16087963,16096821,del,NA18610,0,,8858
19,45230899,45234266,del,HG00418,0,,3367
19,12039416,12045972,del,NA19315,0,,6556
19,14679300,14679741,del,HG00449,0,,441
19,251548,283564,dup,HG03837,0,,32016
19,266428,341459,dup,HG03837,0,,75031
19,286841,307454,dup,HG00629,0,,20613
19,323368,334484,dup,HG00628,0,,11116
19,572192,582084,dup,NA12873,0,,9892
19,640060,675990,dup,HG00099,0,,35930
19,656766,668988,dup,HG00867,0,,12222
19,712133,716174,dup,HG01051,0,,4041
19,724133,803706,dup,HG00867,0,,79573
19,730718,734483,dup,HG01892,0,,3765
19,732976,745313,dup,HG00867,0,,12337
19,794878,807625,dup,HG00350,0,,12747
19,873393,886368,dup,HG00867,0,,12975
19,954978,967528,dup,HG01855,0,,12550
19,982574,993900,dup,HG01859,0,,11326
19,1012554,1069136,dup,HG00867,0,,56582
19,1012802,1022948,dup,HG02546,0,,10146
19,1264453,1397378,dup,HG00867,0,,132925
19,1273201,1294780,dup,HG02546,0,,21579
19,1356855,1396467,dup,HG00266,0,,39612
19,1486558,1506657,dup,HG01842,0,,20099
19,1510537,1526936,dup,HG01859,0,,16399
19,1948004,2041192,dup,HG00131,0,,93188
19,1989079,1999558,dup,HG02455,0,,10479
19,2314253,2337162,dup,HG03246,0,,22909
19,2720375,2727475,dup,HG01396,0,,7100
19,2733026,2744539,dup,NA12760,0,,11513
19,3789078,3847881,dup,HG00346,0,,58803
19,3805733,3814062,dup,HG01843,0,,8329
19,3907961,3928971,dup,NA19001,0,,21010
19,4007997,4017673,dup,NA18978,0,,9676
19,4137145,4158954,dup,HG01992,0,,21809
19,4217790,4224498,dup,HG01551,0,,6708
19,4294839,4299790,dup,HG01139,0,,4951
19,4365365,4390238,dup,HG00234,0,,24873
19,4997738,5013484,dup,NA12287,0,,15746
19,5447724,5459537,dup,HG03846,0,,11813
19,5558199,5565511,dup,NA20502,0,,7312
19,5633549,5637003,dup,HG00281,0,,3454
19,6377375,6387684,dup,HG00629,0,,10309
19,6868334,6883073,dup,HG01170,0,,14739
19,6890797,6942657,dup,HG04186,0,,51860
19,6896412,7019812,dup,HG01879,0,,123400
19,6972968,7014152,dup,HG01879,0,,41184
19,7066691,7107653,dup,HG04186,0,,40962
19,7410061,7420045,dup,HG03159,0,,9984
19,8398274,8456769,dup,HG03258,0,,58495
19,8431830,8448461,dup,HG01551,0,,16631
19,8591535,8619828,dup,NA18597,0,,28293
19,8632099,8651864,dup,NA18597,0,,19765
19,9009633,9019841,dup,HG00130,0,,10208
19,9233185,9245971,dup,HG02298,0,,12786
19,9415501,9426349,dup,HG02620,0,,10848
19,11914960,12063831,dup,HG00109,0,,148871
19,11922879,11968357,dup,HG00109,0,,45478
19,12005314,12030310,dup,NA20785,0,,24996
19,12039759,12046120,dup,HG00256,0,,6361
19,12048823,12060753,dup,HG00109,0,,11930
19,12500363,12544428,dup,HG02286,0,,44065
19,13094721,13106101,dup,HG01628,0,,11380
19,15161095,15202983,dup,HG00182,0,,41888
19,15162626,15212055,dup,HG01046,0,,49429
19,15163744,15178681,dup,HG01046,0,,14937
19,15190879,15200103,dup,HG01046,0,,9224
19,15783118,15836205,dup,HG01142,0,,53087
19,16252443,16257576,dup,HG03698,0,,5133
19,16305923,16314951,dup,HG02259,0,,9028
19,17442711,17449636,dup,HG02649,0,,6925
19,18080488,18141773,dup,HG03066,0,,61285
19,18107742,18143279,dup,HG03066,0,,35537
19,18302930,18311339,dup,HG01198,0,,8409
19,18580448,18600934,dup,HG03380,0,,20486
19,19764289,19767888,dup,HG01620,0,,3599
19,20027051,20073448,dup,HG03472,0,,46397
19,20239564,20253741,dup,HG02728,0,,14177
19,20821293,20848263,dup,HG02728,0,,26970
19,20853322,20867463,dup,HG02728,0,,14141
19,20862396,20974015,dup,HG02728,0,,111619
19,20975571,20989951,dup,HG02728,0,,14380
19,20989031,21010051,dup,HG02728,0,,21020
19,21007644,21026097,dup,HG02728,0,,18453
19,21055692,21098732,dup,HG00097,0,,43040
19,21752923,21756703,dup,HG00096,0,,3780
19,21907271,21910651,dup,HG01813,0,,3380
19,22273516,22324048,dup,HG02419,0,,50532
19,22415646,22446700,dup,HG00553,0,,31054
19,22784953,22833572,dup,NA21104,0,,48619
19,22919690,22949143,dup,NA21104,0,,29453
19,23018488,23029154,dup,NA21104,0,,10666
19,23086465,23139636,dup,NA21104,0,,53171
19,23142762,23181942,dup,NA21104,0,,39180
19,23188674,23257523,dup,NA21104,0,,68849
19,23301722,23316577,dup,NA21104,0,,14855
19,23328575,23373113,dup,NA21104,0,,44538
19,23390763,23461343,dup,NA19144,0,,70580
19,23456069,23597897,dup,NA19144,0,,141828
19,23474422,23562636,dup,NA19144,0,,88214
19,23654101,23673344,dup,HG00246,0,,19243
19,23817104,23828313,dup,HG03009,0,,11209
19,23826914,23837892,dup,HG02977,0,,10978
19,23839868,23856192,dup,HG03836,0,,16324
19,23875478,23887570,dup,HG03836,0,,12092
19,23925324,23932206,dup,HG03084,0,,6882
19,24009466,24084088,dup,HG02977,0,,74622
19,24089241,24094115,dup,NA20126,0,,4874
19,24115712,24203146,dup,HG02977,0,,87434
19,24229411,24252475,dup,HG02008,0,,23064
19,24258944,24263780,dup,HG00351,0,,4836
19,24274007,24279645,dup,HG02977,0,,5638
19,24277435,24288641,dup,HG02977,0,,11206
19,24285703,24299869,dup,HG01800,0,,14166
19,24311804,24324713,dup,HG01104,0,,12909
19,24328587,24342802,dup,HG02977,0,,14215
19,24336508,24460659,dup,HG02651,0,,124151
19,27839079,28640114,dup,HG02450,0,,801035
19,28246833,28474547,dup,HG00705,0,,227714
19,28659891,28667392,dup,HG01892,0,,7501
19,28682514,28891125,dup,HG02881,0,,208611
19,29513989,29556756,dup,HG02152,0,,42767
19,29827173,29830269,dup,HG02281,0,,3096
19,32378556,32387302,dup,HG04159,0,,8746
19,32390554,32399410,dup,HG02715,0,,8856
19,32998779,33019409,dup,HG03888,0,,20630
19,34209735,34236096,dup,HG01615,0,,26361
19,34787623,34847847,dup,HG02760,0,,60224
19,35284233,35297181,dup,HG00671,0,,12948
19,35699962,35739931,dup,NA19331,0,,39969
19,35701717,35725915,dup,NA19031,0,,24198
19,35851718,35863310,dup,HG00096,0,,11592
19,36152708,36160151,dup,HG01852,0,,7443
19,36199472,36207215,dup,HG00244,0,,7743
19,36521169,36535238,dup,HG02180,0,,14069
19,36812212,36837955,dup,HG01378,0,,25743
19,36909437,36919506,dup,HG02322,0,,10069
19,36930472,36982624,dup,HG02600,0,,52152
19,36966640,37063133,dup,HG02314,0,,96493
19,37123010,37238247,dup,HG01947,0,,115237
19,37601294,37622724,dup,NA21118,0,,21430
19,39465849,39485572,dup,HG02153,0,,19723
19,39499797,39512939,dup,HG02790,0,,13142
19,40696966,40834492,dup,NA18967,0,,137526
19,40709031,40794619,dup,NA18967,0,,85588
19,41354052,41373538,dup,HG00102,0,,19486
19,41428057,41485308,dup,HG01177,0,,57251
19,41446744,41493035,dup,HG01177,0,,46291
19,41625361,41653689,dup,HG04134,0,,28328
19,41949829,42007093,dup,HG02805,0,,57264
19,42186335,42191604,dup,HG01080,0,,5269
19,42253567,42293228,dup,HG03025,0,,39661
19,43222558,43243770,dup,HG04033,0,,21212
19,43242758,43299263,dup,HG00121,0,,56505
19,43315581,43370409,dup,HG00107,0,,54828
19,43369055,43411203,dup,HG00107,0,,42148
19,43423930,43451047,dup,HG00107,0,,27117
19,43448023,43490443,dup,HG00107,0,,42420
19,43480581,43510210,dup,HG00107,0,,29629
19,43505313,43547211,dup,HG00107,0,,41898
19,43548282,43609566,dup,HG00176,0,,61284
19,43596505,43647892,dup,HG01110,0,,51387
19,43654428,43693497,dup,HG00176,0,,39069
19,43701719,43746161,dup,HG00101,0,,44442
19,43765761,43789861,dup,HG00176,0,,24100
19,43823618,43843712,dup,HG00176,0,,20094
19,43875470,43892931,dup,HG02284,0,,17461
19,43887743,43922266,dup,NA20287,0,,34523
19,44177758,44183644,dup,HG03833,0,,5886
19,44191882,44206668,dup,NA19323,0,,14786
19,45486452,45499576,dup,HG01551,0,,13124
19,45826405,45907191,dup,NA07357,0,,80786
19,45845933,45876990,dup,NA07357,0,,31057
19,46180271,46199559,dup,NA20521,0,,19288
19,46483232,46490427,dup,HG01855,0,,7195
19,46637639,46744241,dup,HG00478,0,,106602
19,46640173,46759019,dup,HG00478,0,,118846
19,46663229,46736987,dup,HG00478,0,,73758
19,48250461,48411104,dup,HG02397,0,,160643
19,48384787,48402244,dup,HG04182,0,,17457
19,48561310,48566441,dup,HG01967,0,,5131
19,48815424,48820121,dup,HG02813,0,,4697
19,49068849,49075503,dup,HG01432,0,,6654
19,49556402,49566653,dup,NA18991,0,,10251
19,49633863,49677257,dup,HG02051,0,,43394
19,49634744,49677621,dup,HG00182,0,,42877
19,49650963,49667101,dup,HG02051,0,,16138
19,49964933,49978697,dup,HG02395,0,,13764
19,50365038,50411783,dup,HG02298,0,,46745
19,50381083,50543024,dup,HG02298,0,,161941
19,50460210,50537708,dup,HG02298,0,,77498
19,50566908,50575522,dup,HG00608,0,,8614
19,50584256,50594164,dup,HG00119,0,,9908
19,51233691,51244020,dup,HG01597,0,,10329
19,51255383,51266167,dup,HG00598,0,,10784
19,51263689,51274432,dup,HG03793,0,,10743
19,51330352,51333927,dup,HG00117,0,,3575
19,51350632,51356467,dup,HG02661,0,,5835
19,51373190,51384645,dup,HG04070,0,,11455
19,52134835,52149093,dup,HG00096,0,,14258
19,52289018,52456510,dup,NA11832,0,,167492
19,52372770,52428756,dup,NA11832,0,,55986
19,52531720,52621972,dup,NA11832,0,,90252
19,52893731,52971291,dup,HG01954,0,,77560
19,53098550,53141086,dup,HG02537,0,,42536
19,53142837,53160012,dup,HG02537,0,,17175
19,53151771,53181883,dup,NA20282,0,,30112
19,53190297,53195677,dup,HG00371,0,,5380
19,53198906,53261048,dup,HG01807,0,,62142
19,53207831,53228809,dup,NA18945,0,,20978
19,53243234,53263665,dup,HG01807,0,,20431
19,53262398,53307769,dup,HG01807,0,,45371
19,53323747,53352449,dup,HG01816,0,,28702
19,53376104,53441208,dup,HG01807,0,,65104
19,53520294,53545025,dup,HG02784,0,,24731
19,53599620,53628167,dup,HG02450,0,,28547
19,53656320,53672648,dup,HG00672,0,,16328
19,53657667,53812552,dup,HG02308,0,,154885
19,53679597,53716522,dup,HG01479,0,,36925
19,53850316,53858778,dup,HG02922,0,,8462
19,53884289,53904475,dup,HG04155,0,,20186
19,53918063,54000719,dup,HG00128,0,,82656
19,53944972,53997110,dup,HG00351,0,,52138
19,54560978,54569653,dup,HG02164,0,,8675
19,54641780,54657763,dup,HG00234,0,,15983
19,54654759,54663402,dup,HG01464,0,,8643
19,54727998,54746910,dup,HG00181,0,,18912
19,54763368,54782583,dup,HG03775,0,,19215
19,54781758,54799764,dup,HG03775,0,,18006
19,54808248,54845793,dup,HG03775,0,,37545
19,54849856,54867823,dup,HG03401,0,,17967
19,54987526,54991822,dup,HG01583,0,,4296
19,55032568,55046425,dup,HG03394,0,,13857
19,55266365,55280663,dup,HG00096,0,,14298
19,55338842,55355281,dup,HG00099,0,,16439
19,55542261,55650100,dup,HG00232,0,,107839
19,55543351,55560444,dup,HG00266,0,,17093
19,55595730,55624854,dup,NA18620,0,,29124
19,56347685,56500403,dup,HG03910,0,,152718
19,56354761,56587366,dup,HG03910,0,,232605
19,56359635,56427585,dup,HG03910,0,,67950
19,57172468,57182937,dup,HG02620,0,,10469
19,57518268,57593952,dup,NA19019,0,,75684
19,57620589,57649685,dup,NA19019,0,,29096
19,57673342,57689491,dup,HG00596,0,,16149
19,57687880,57714228,dup,NA19019,0,,26348
19,57988329,58003017,dup,HG01088,0,,14688
19,58202468,58210741,dup,HG03082,0,,8273
19,58321853,58335527,dup,HG01280,0,,13674
19,58380078,58473385,dup,HG01250,0,,93307
19,58483340,58492170,dup,HG03977,0,,8830
19,58581391,58593334,dup,HG03991,0,,11943
19,58768576,58776924,dup,HG02646,0,,8348
20,39530411,39536748,del,NA19664,0,,6337
20,55887894,55892775,del,NA19189,0,,4881
20,8410042,8411122,del,HG00330,0,,1080
20,2183227,2186521,del,HG01170,0,,3294
20,31310706,31314084,del,HG01334,0,,3378
20,58668583,58674502,del,HG01390,0,,5919
20,54208622,54208779,del,HG00140,0,,157
20,7624415,7650294,del,NA19350,0,,25879
20,3878798,3885183,del,NA19720,0,,6385
20,51840508,51841083,del,NA18950,0,,575
20,5161033,5161689,del,NA19374,0,,656
20,60518068,60522979,del,NA18910,0,,4911
20,24593124,24594476,del,HG00282,0,,1352
20,60080677,60081006,del,HG00273,0,,329
20,22953730,22957052,del,HG01188,0,,3322
20,366004,379882,del,NA20760,0,,13878
20,38641893,38647061,del,NA19982,0,,5168
20,44792276,44794006,del,NA12347,0,,1730
20,60663200,60663579,del,NA19678,0,,379
20,31525486,31529389,del,NA18853,0,,3903
20,36819917,36822516,del,NA18610,0,,2599
20,21080216,21087422,del,NA19437,0,,7206
20,52335957,52336530,del,HG00176,0,,573
20,54128554,54129366,del,NA19372,0,,812
20,15310946,15320655,del,NA18516,0,,9709
20,47102022,47103466,del,NA20340,0,,1444
20,41218910,41219968,del,NA12827,0,,1058
20,12641935,12642067,del,HG00478,0,,132
20,1073317,1077222,del,NA19707,0,,3905
20,61716871,61717041,del,NA11994,0,,170
20,62151816,62154522,del,HG00583,0,,2706
20,58139902,58140168,del,HG01082,0,,266
20,60520689,60521835,del,NA18853,0,,1146
20,35161623,35162671,del,NA19312,0,,1048
20,18610273,18611195,del,NA07347,0,,922
20,23103303,23103632,del,NA18516,0,,329
20,61378608,61378791,del,NA18486,0,,183
20,61341410,61343332,del,NA20544,0,,1922
20,7096781,7102846,del,NA19909,0,,6065
20,61304250,61305139,del,NA20535,0,,889
20,25218369,25221867,del,HG01441,0,,3498
20,16240212,16240391,del,NA19385,0,,179
20,23749140,23831239,del,NA18543,0,,82099
20,40959725,40960681,del,NA19904,0,,956
20,13685402,13686114,del,NA18486,0,,712
20,32055884,32064295,del,NA18565,0,,8411
20,22325459,22330258,del,NA18853,0,,4799
20,9647997,9648154,del,HG01073,0,,157
20,44535347,44535783,del,NA10847,0,,436
20,3858390,3860105,del,HG01133,0,,1715
20,3441540,3443306,del,NA19664,0,,1766
20,36513184,36513437,del,HG01082,0,,253
20,15750854,15765623,del,HG00324,0,,14769
20,14435664,14437529,del,NA18487,0,,1865
20,33716057,33716804,del,HG00323,0,,747
20,4012494,4016466,del,NA18516,0,,3972
20,41729438,41730309,del,NA19700,0,,871
20,31310867,31312778,del,NA19397,0,,1911
20,19072762,19075646,del,NA18633,0,,2884
20,59766293,59766472,del,HG01047,0,,179
20,38727140,38732565,del,HG00123,0,,5425
20,1670404,1674240,del,NA19463,0,,3836
20,43305316,43308722,del,HG00274,0,,3406
20,31681351,31681454,del,NA12003,0,,103
20,42391105,42393541,del,NA19443,0,,2436
20,347104,347792,del,NA18596,0,,688
20,32355290,32356318,del,NA18907,0,,1028
20,21486916,21496222,del,HG00419,0,,9306
20,20259779,20261181,del,HG01191,0,,1402
20,50506985,50509622,del,NA18541,0,,2637
20,53325269,53325787,del,NA19436,0,,518
20,48404093,48404591,del,NA19703,0,,498
20,29509066,29536055,del,HG01489,0,,26989
20,8001544,8003491,del,NA18634,0,,1947
20,42465496,42470206,del,NA18867,0,,4710
20,59621020,59621170,del,HG01060,0,,150
20,56563570,56565496,del,HG00353,0,,1926
20,17448718,17448797,del,NA19663,0,,79
20,60358513,60359452,del,NA12144,0,,939
20,55288230,55289332,del,NA18961,0,,1102
20,5702558,5704757,del,NA18499,0,,2199
20,14781443,14827483,del,NA12043,0,,46040
20,49602582,49607103,del,HG00614,0,,4521
20,23746139,23827388,del,NA18526,0,,81249
20,50897569,50901594,del,HG00704,0,,4025
20,46689736,46690938,del,HG01124,0,,1202
20,11349840,11350213,del,HG00096,0,,373
20,32084348,32085840,del,NA18502,0,,1492
20,18027938,18028279,del,NA19372,0,,341
20,565686,566251,del,NA18910,0,,565
20,56961146,56962769,del,NA19474,0,,1623
20,33115811,33116144,del,NA19780,0,,333
20,37068647,37070327,del,HG00346,0,,1680
20,44616895,44626930,del,HG01489,0,,10035
20,3238626,3238763,del,HG00584,0,,137
20,8288515,8289043,del,NA12889,0,,528
20,59128091,59130615,del,NA18973,0,,2524
20,26234242,26235623,del,HG01066,0,,1381
20,34221857,34222448,del,NA19452,0,,591
20,42790272,42790846,del,HG00614,0,,574
20,62949733,62959201,del,NA19078,0,,9468
20,7462813,7464609,del,HG00537,0,,1796
20,53472165,53474720,del,NA19716,0,,2555
20,9169410,9169891,del,NA18613,0,,481
20,52265675,52268090,del,HG01095,0,,2415
20,19104341,19104642,del,NA18956,0,,301
20,4445321,4449530,del,NA19116,0,,4209
20,3696860,3699196,del,HG01437,0,,2336
20,50654701,50655534,del,NA19436,0,,833
20,59848123,59848420,del,NA18576,0,,297
20,57308052,57311872,del,NA18868,0,,3820
20,44204061,44207299,del,NA11881,0,,3238
20,52457964,52458137,del,HG00693,0,,173
20,53326005,53326616,del,NA19360,0,,611
20,61372666,61375222,del,NA18971,0,,2556
20,36474513,36477320,del,NA19360,0,,2807
20,5610205,5613002,del,NA19707,0,,2797
20,12664890,12665021,del,NA18564,0,,131
20,4226310,4228946,del,NA18599,0,,2636
20,24273132,24274478,del,NA11829,0,,1346
20,3013293,3014292,del,HG00324,0,,999
20,22907804,22919139,del,HG00543,0,,11335
20,14586264,14620465,del,NA18538,0,,34201
20,41353491,41354541,del,NA07347,0,,1050
20,62362803,62362911,del,HG00276,0,,108
20,52085606,52090174,del,HG00650,0,,4568
20,7848213,7849687,del,NA19712,0,,1474
20,29816038,29829604,del,NA18522,0,,13566
20,41208680,41288126,del,HG00559,0,,79446
20,48048648,48052971,del,NA19404,0,,4323
20,50492112,50492471,del,NA07346,0,,359
20,3794868,3799121,del,NA19332,0,,4253
20,31458923,31461992,del,NA19093,0,,3069
20,46754771,47131697,del,NA20528,0,,376926
20,36270351,36280488,del,NA20581,0,,10137
20,21122073,21123965,del,NA19257,0,,1892
20,36200017,36203853,del,NA19430,0,,3836
20,3033170,3035562,del,NA18516,0,,2392
20,16221740,16222283,del,NA12005,0,,543
20,60570624,60570943,del,HG00249,0,,319
20,42024916,42026472,del,NA20519,0,,1556
20,18177995,18179160,del,HG00186,0,,1165
20,61178317,61178405,del,HG00437,0,,88
20,7605002,7607569,del,NA19327,0,,2567
20,24456811,24457058,del,HG00418,0,,247
20,60033148,60033298,del,HG00336,0,,150
20,5012987,5017790,del,HG00244,0,,4803
20,25096753,25097240,del,NA19056,0,,487
20,55587379,55587880,del,NA20790,0,,501
20,16238854,16239690,del,NA19383,0,,836
20,61372316,61374972,del,NA19722,0,,2656
20,18978139,18978867,del,NA19374,0,,728
20,52643650,52644434,del,NA19077,0,,784
20,35815609,35815921,del,NA19457,0,,312
20,43327312,43329523,del,NA18486,0,,2211
20,62748771,62748921,del,HG00580,0,,150
20,52329431,52333505,del,HG00650,0,,4074
20,16079002,16085369,del,NA19070,0,,6367
20,58296897,58315615,del,HG00554,0,,18718
20,317246,319140,del,HG00177,0,,1894
20,54213954,54214087,del,HG00327,0,,133
20,31076054,31081177,del,NA19676,0,,5123
20,15289873,15298097,del,HG00464,0,,8224
20,13906648,13911274,del,HG00628,0,,4626
20,6025695,6027612,del,NA19446,0,,1917
20,43836817,43836997,del,HG00443,0,,180
20,51150793,51158815,del,NA18988,0,,8022
20,16207155,16209109,del,NA19700,0,,1954
20,45929336,45931917,del,NA18628,0,,2581
20,52647064,52658002,del,HG00275,0,,10938
20,42995106,42997734,del,NA12829,0,,2628
20,1307757,1317782,del,HG00473,0,,10025
20,34169366,34173097,del,HG00590,0,,3731
20,3476119,3485987,del,NA19449,0,,9868
20,46112259,46116751,del,HG00158,0,,4492
20,528831,537111,del,HG00698,0,,8280
20,60160740,60160879,del,NA19428,0,,139
20,60319413,60319566,del,NA19138,0,,153
20,7601033,7607569,del,NA18874,0,,6536
20,17824869,17825355,del,NA19312,0,,486
20,22267777,22269837,del,HG00672,0,,2060
20,44177338,44178045,del,HG00377,0,,707
20,2359903,2360608,del,NA19372,0,,705
20,41245287,41267698,del,NA18628,0,,22411
20,59643056,59644590,del,NA19451,0,,1534
20,2904876,2906121,del,HG01070,0,,1245
20,32046445,32047946,del,NA19462,0,,1501
20,5629044,5630386,del,HG00311,0,,1342
20,9550336,9550648,del,NA19394,0,,312
20,41791262,41791447,del,HG01174,0,,185
20,53694135,53697418,del,HG00704,0,,3283
20,30408271,30410234,del,NA18550,0,,1963
20,60759226,60760250,del,HG00542,0,,1024
20,359493,365154,del,NA18616,0,,5661
20,15782125,15784279,del,NA19247,0,,2154
20,50651768,50654443,del,NA20534,0,,2675
20,26060741,26061000,del,HG00285,0,,259
20,7077745,7078977,del,NA18519,0,,1232
20,44763527,44767944,del,HG01048,0,,4417
20,37902849,37905233,del,NA19463,0,,2384
20,52172240,52178764,del,NA19678,0,,6524
20,49749233,49757974,del,NA20541,0,,8741
20,12757249,12762139,del,NA19394,0,,4890
20,35043629,35055842,del,HG00607,0,,12213
20,55606965,55607060,del,HG00268,0,,95
20,14883970,14916235,del,NA19655,0,,32265
20,46754208,47131688,del,NA18546,0,,377480
20,31327362,31328034,del,NA18504,0,,672
20,8222298,8223593,del,NA18632,0,,1295
20,24903697,24904415,del,NA19773,0,,718
20,59793256,59793477,del,NA19347,0,,221
20,3021755,3022052,del,HG00422,0,,297
20,25679760,25681887,del,NA19469,0,,2127
20,20012659,20013103,del,NA19439,0,,444
20,24411816,24412822,del,NA19355,0,,1006
20,57289104,57290152,del,NA19332,0,,1048
20,16251495,16251932,del,NA19835,0,,437
20,58744731,58745961,del,NA19257,0,,1230
20,21808907,21809882,del,NA18909,0,,975
20,5487358,5494504,del,NA19455,0,,7146
20,47431003,47439643,del,NA20826,0,,8640
20,43789374,43790423,del,NA19332,0,,1049
20,62596448,62596815,del,NA07000,0,,367
20,43306116,43308722,del,HG01462,0,,2606
20,20343416,20351322,del,NA18975,0,,7906
20,36994266,36994572,del,HG01176,0,,306
20,35891613,35894283,del,NA19072,0,,2670
20,42924402,42925272,del,NA18977,0,,870
20,33142253,33143718,del,HG00734,0,,1465
20,32747063,32748104,del,HG00513,0,,1041
20,7398707,7403594,del,NA19372,0,,4887
20,59764116,59769222,del,NA20775,0,,5106
20,49734284,49735555,del,NA12058,0,,1271
20,56079234,56080514,del,HG00261,0,,1280
20,39906380,39907429,del,NA18912,0,,1049
20,1013810,1017336,del,HG00375,0,,3526
20,15451242,15454337,del,HG00704,0,,3095
20,19134496,19137970,del,HG01095,0,,3474
20,9997816,10001522,del,NA18950,0,,3706
20,44493374,44494815,del,NA19712,0,,1441
20,46754773,47131485,del,HG00475,0,,376712
20,59676857,59677528,del,NA19664,0,,671
20,1130583,1130707,del,HG00154,0,,124
20,22467155,22469378,del,NA18871,0,,2223
20,30040188,30050918,del,HG00345,0,,10730
20,58249448,58249915,del,NA18599,0,,467
20,42564316,42564957,del,NA20581,0,,641
20,4037596,4039359,del,HG00118,0,,1763
20,5725231,5727187,del,NA20761,0,,1956
20,31662078,31665317,del,NA19093,0,,3239
20,61721569,61721668,del,NA19385,0,,99
20,16238811,16239850,del,NA19172,0,,1039
20,53405486,53420142,del,HG01390,0,,14656
20,61191904,61193846,del,NA19129,0,,1942
20,55406251,55428275,del,HG01051,0,,22024
20,24388666,24389540,del,NA19248,0,,874
20,40337171,40340494,del,NA12342,0,,3323
20,42362415,42363588,del,NA19312,0,,1173
20,37055110,37055810,del,NA19076,0,,700
20,52285493,52291890,del,NA11843,0,,6397
20,18190679,18191222,del,NA19762,0,,543
20,32241477,32242568,del,HG00377,0,,1091
20,61182349,61182606,del,HG00708,0,,257
20,60523325,60523575,del,NA19317,0,,250
20,61623544,61625241,del,HG00157,0,,1697
20,23707534,23783348,del,NA19759,0,,75814
20,52866237,52867342,del,NA12341,0,,1105
20,49233593,49234718,del,NA18623,0,,1125
20,42107670,42110927,del,NA18486,0,,3257
20,41353539,41354589,del,HG00256,0,,1050
20,60264779,60265077,del,NA18498,0,,298
20,2077487,2079513,del,HG00740,0,,2026
20,20736960,20741180,del,NA18910,0,,4220
20,58926715,58927036,del,NA20299,0,,321
20,3894697,3896160,del,NA20765,0,,1463
20,33365802,33368963,del,HG00512,0,,3161
20,55785361,55787185,del,NA18620,0,,1824
20,20172355,20174131,del,NA19685,0,,1776
20,50651768,50654475,del,NA12414,0,,2707
20,43275100,43278306,del,NA19455,0,,3206
20,15301731,15303768,del,NA18941,0,,2037
20,60125224,60125380,del,HG00537,0,,156
20,12252349,12253032,del,HG00614,0,,683
20,16744985,16748302,del,NA18552,0,,3317
20,31652416,31663163,del,NA19010,0,,10747
20,14435565,14437530,del,NA18487,0,,1965
20,24812006,24813468,del,NA18953,0,,1462
20,50287883,50290574,del,HG00306,0,,2691
20,35535585,35539543,del,NA19834,0,,3958
20,57160655,57161612,del,NA18502,0,,957
20,25463572,25463882,del,NA19436,0,,310
20,1553216,1556622,del,NA18522,0,,3406
20,43306073,43308659,del,HG00361,0,,2586
20,3084928,3085522,del,NA19819,0,,594
20,26243915,26247928,del,NA19818,0,,4013
20,62763386,62764499,del,NA20299,0,,1113
20,45779099,45788695,del,HG00613,0,,9596
20,9029206,9030487,del,NA19198,0,,1281
20,959506,960599,del,HG01183,0,,1093
20,41255777,41278506,del,NA18516,0,,22729
20,17826028,17826157,del,NA20294,0,,129
20,62004639,62022977,del,HG01462,0,,18338
20,11647429,11648670,del,HG00334,0,,1241
20,14926203,14928465,del,HG00701,0,,2262
20,9466806,9468946,del,NA19317,0,,2140
20,1043020,1044385,del,HG01354,0,,1365
20,36625781,36626805,del,HG00319,0,,1024
20,49724940,49725224,del,NA18522,0,,284
20,40337296,40340634,del,NA12342,0,,3338
20,7398716,7403122,del,HG01519,0,,4406
20,47375232,47377649,del,NA20790,0,,2417
20,2929504,2934400,del,NA12342,0,,4896
20,60912272,60912397,del,NA20772,0,,125
20,60457181,60460207,del,HG00158,0,,3026
20,40953175,40953526,del,NA18606,0,,351
20,52086193,52086351,del,HG00619,0,,158
20,359452,365110,del,NA18616,0,,5658
20,37008415,37015148,del,HG00249,0,,6733
20,4055531,4056731,del,NA19379,0,,1200
20,19229325,19232094,del,HG00524,0,,2769
20,16240370,16240608,del,HG01516,0,,238
20,61480127,61480952,del,HG00239,0,,825
20,59985471,59985665,del,NA18486,0,,194
20,58068109,58070190,del,NA19360,0,,2081
20,16662679,16667928,del,NA20808,0,,5249
20,41208775,41233574,del,NA20517,0,,24799
20,42024594,42025792,del,NA18953,0,,1198
20,21154063,21156795,del,NA19834,0,,2732
20,47742246,47744419,del,HG00663,0,,2173
20,44075124,44075421,del,NA19403,0,,297
20,50805013,50805961,del,HG00737,0,,948
20,53292651,53292965,del,NA20775,0,,314
20,52453005,52453470,del,NA19440,0,,465
20,42481268,42483782,del,NA18873,0,,2514
20,60185952,60190434,del,NA18508,0,,4482
20,34844517,34854360,del,NA19676,0,,9843
20,30893035,30894749,del,HG00478,0,,1714
20,36714469,36716005,del,NA18597,0,,1536
20,44372836,44387455,del,HG00732,0,,14619
20,61657760,61658053,del,NA18989,0,,293
20,33477172,33477305,del,NA18550,0,,133
20,6942864,6942982,del,HG01101,0,,118
20,3359640,3359954,del,HG00353,0,,314
20,43305116,43310222,del,NA20342,0,,5106
20,17893197,17893365,del,HG00704,0,,168
20,52339279,52342223,del,NA19399,0,,2944
20,9193751,9194025,del,NA19147,0,,274
20,37030347,37032119,del,NA19063,0,,1772
20,34272278,34273728,del,NA19332,0,,1450
20,60869512,60870330,del,NA19783,0,,818
20,62392068,62392610,del,HG00554,0,,542
20,1557377,1559856,del,NA18916,0,,2479
20,61852914,61853014,del,HG00443,0,,100
20,20103398,20111986,del,NA19900,0,,8588
20,16129616,16136422,del,NA18984,0,,6806
20,62150416,62153522,del,HG00138,0,,3106
20,43905846,43906558,del,NA19077,0,,712
20,24249440,24250277,del,NA19701,0,,837
20,1553416,1593922,del,HG00176,0,,40506
20,30177762,30180560,del,NA19428,0,,2798
20,3878995,3885176,del,HG00268,0,,6181
20,24760819,24765941,del,HG00247,0,,5122
20,57723444,57723778,del,HG00367,0,,334
20,53769996,53779911,del,NA19920,0,,9915
20,60264794,60264938,del,NA18520,0,,144
20,5485964,5487484,del,NA19625,0,,1520
20,11725763,11732647,del,NA19449,0,,6884
20,52419041,52420713,del,HG00683,0,,1672
20,32174547,32185281,del,NA18636,0,,10734
20,23103192,23103632,del,NA18964,0,,440
20,3795028,3795453,del,NA18519,0,,425
20,31682040,31694782,del,NA19010,0,,12742
20,54542458,54542595,del,HG01069,0,,137
20,21849902,21850189,del,NA11893,0,,287
20,33241830,33244255,del,NA19725,0,,2425
20,23073513,23077239,del,HG00702,0,,3726
20,52419016,52420553,del,HG00683,0,,1537
20,56235552,56235885,del,NA19390,0,,333
20,11980904,11989273,del,NA19257,0,,8369
20,55794138,55794305,del,NA19359,0,,167
20,5789594,5791401,del,NA18499,0,,1807
20,57644192,57645212,del,HG01171,0,,1020
20,55605486,55605751,del,NA19914,0,,265
20,50993939,50994377,del,HG01360,0,,438
20,24456823,24457637,del,NA19067,0,,814
20,16566440,16586775,del,NA19118,0,,20335
20,59973099,59976175,del,NA18628,0,,3076
20,23168343,23176317,del,NA19257,0,,7974
20,49658877,49660084,del,NA18874,0,,1207
20,39017190,39025578,del,NA18501,0,,8388
20,481444,481870,del,NA18907,0,,426
20,29817543,29820885,del,NA19428,0,,3342
20,21251091,21251742,del,NA07347,0,,651
20,1560991,1594041,del,NA18545,0,,33050
20,1995501,1997532,del,HG00232,0,,2031
20,42347656,42359881,del,HG00190,0,,12225
20,62267524,62268029,del,NA19789,0,,505
20,7751842,7752533,del,NA18549,0,,691
20,23964175,23966903,del,NA19007,0,,2728
20,62481178,62481280,del,HG00657,0,,102
20,294042,295146,del,NA18916,0,,1104
20,39886355,39886643,del,HG00280,0,,288
20,12986208,12987218,del,NA19213,0,,1010
20,10198016,10200622,del,NA19456,0,,2606
20,61724698,61725615,del,NA20796,0,,917
20,62190851,62191082,del,HG00259,0,,231
20,23957359,23962556,del,HG00500,0,,5197
20,15711750,15712422,del,HG01183,0,,672
20,5680173,5681445,del,HG00243,0,,1272
20,13571311,13572842,del,HG01342,0,,1531
20,1095215,1095826,del,HG00284,0,,611
20,3894683,3895504,del,HG00243,0,,821
20,12638186,12639333,del,NA18545,0,,1147
20,53603481,53605106,del,NA19471,0,,1625
20,15943044,15957526,del,HG01353,0,,14482
20,504471,506209,del,NA19397,0,,1738
20,46754705,47131710,del,NA20799,0,,377005
20,11239304,11240358,del,NA20804,0,,1054
20,37544844,37545590,del,HG00608,0,,746
20,14422458,14449835,del,NA19712,0,,27377
20,6974279,6976924,del,HG00736,0,,2645
20,44763477,44767906,del,HG01048,0,,4429
20,15689249,15689400,del,HG01351,0,,151
20,52085555,52090104,del,HG00650,0,,4549
20,7150926,7152827,del,NA18558,0,,1901
20,41272145,41272581,del,NA18510,0,,436
20,8187617,8187800,del,HG00273,0,,183
20,55017061,55018614,del,NA19985,0,,1553
20,26305407,26307931,del,NA18599,0,,2524
20,3375579,3375917,del,HG00247,0,,338
20,21002708,21003056,del,NA12749,0,,348
20,60951959,60952064,del,HG00343,0,,105
20,36312369,36313012,del,NA12842,0,,643
20,7245543,7255118,del,NA18871,0,,9575
20,62141625,62142784,del,HG00537,0,,1159
20,62918175,62918506,del,HG00583,0,,331
20,31613085,31613480,del,HG00475,0,,395
20,56554551,56554643,del,NA18550,0,,92
20,15689305,15689425,del,HG00108,0,,120
20,43296479,43297891,del,NA19131,0,,1412
20,5789555,5791404,del,NA19240,0,,1849
20,2221659,2221739,del,NA19404,0,,80
20,33012488,33016904,del,NA19700,0,,4416
20,32286647,32288927,del,HG00151,0,,2280
20,53519925,53523179,del,NA19247,0,,3254
20,23671884,23674222,del,NA19395,0,,2338
20,24782051,24785161,del,NA18539,0,,3110
20,2241048,2241641,del,NA19152,0,,593
20,4996191,4996657,del,NA19397,0,,466
20,59396350,59409650,del,NA19462,0,,13300
20,930212,930291,del,NA19360,0,,79
20,39906416,39907422,del,NA18595,0,,1006
20,43306216,43310222,del,NA18613,0,,4006
20,44725616,44726041,del,NA19093,0,,425
20,32335128,32335449,del,NA19704,0,,321
20,59776942,59778661,del,NA18986,0,,1719
20,42368581,42372202,del,HG00449,0,,3621
20,50759190,50760928,del,NA19248,0,,1738
20,3486600,3492513,del,NA19920,0,,5913
20,60853563,60853842,del,HG00274,0,,279
20,26092751,26094315,del,HG00247,0,,1564
20,60800424,60801481,del,HG00692,0,,1057
20,61372623,61374771,del,HG00654,0,,2148
20,25414152,25414811,del,HG00530,0,,659
20,16238689,16239697,del,HG00323,0,,1008
20,61263564,61265781,del,NA20342,0,,2217
20,45550557,45550896,del,NA18504,0,,339
20,48692525,48695301,del,NA19445,0,,2776
20,62767051,62767321,del,HG00613,0,,270
20,22455034,22457657,del,NA18622,0,,2623
20,58249188,58249470,del,NA18522,0,,282
20,9699208,9710146,del,NA19779,0,,10938
20,47201981,47202695,del,NA19463,0,,714
20,2209174,2211912,del,NA19403,0,,2738
20,3821195,3825137,del,NA19379,0,,3942
20,2053754,2058196,del,NA18602,0,,4442
20,30409266,30411022,del,NA18602,0,,1756
20,14856654,14905949,del,HG00672,0,,49295
20,14272013,14279463,del,NA18508,0,,7450
20,348416,351092,del,NA18498,0,,2676
20,36177223,36177549,del,NA19783,0,,326
20,16040301,16040395,del,HG00331,0,,94
20,12583042,12583337,del,NA18520,0,,295
20,14477293,14478955,del,NA19678,0,,1662
20,8414040,8414456,del,NA12716,0,,416
20,433983,434752,del,NA19703,0,,769
20,51950042,51956744,del,HG00525,0,,6702
20,36115847,36116793,del,NA18523,0,,946
20,24782752,24785726,del,HG01188,0,,2974
20,60033414,60033491,del,NA19359,0,,77
20,60522513,60523010,del,NA20795,0,,497
20,50625365,50630148,del,HG00683,0,,4783
20,60440065,60441483,del,NA18545,0,,1418
20,42271864,42274588,del,HG00584,0,,2724
20,62661052,62661158,del,HG00690,0,,106
20,35522802,35524543,del,NA11995,0,,1741
20,37402543,37404201,del,NA20513,0,,1658
20,61042898,61043172,del,HG00343,0,,274
20,44348850,44379537,del,NA12275,0,,30687
20,56715805,56717551,del,NA19438,0,,1746
20,25837584,25845672,del,HG00428,0,,8088
20,24783293,24786353,del,NA19471,0,,3060
20,4807400,4808146,del,NA18990,0,,746
20,52453043,52453508,del,NA12282,0,,465
20,1389874,1390193,del,HG00251,0,,319
20,60147940,60148104,del,NA18948,0,,164
20,58663016,58663472,del,HG00336,0,,456
20,14445484,14447416,del,HG01191,0,,1932
20,5568988,5569308,del,NA19707,0,,320
20,46338956,46339444,del,NA19355,0,,488
20,15128632,15134089,del,NA12275,0,,5457
20,20161830,20163154,del,NA19652,0,,1324
20,26109118,26112963,del,NA19474,0,,3845
20,59111672,59124866,del,NA20756,0,,13194
20,50686269,50690184,del,NA19914,0,,3915
20,39602578,39603983,del,HG01055,0,,1405
20,11517265,11517588,del,HG00554,0,,323
20,34663742,34665206,del,NA19474,0,,1464
20,118471,242395,dup,HG00610,0,,123924
20,118498,242177,dup,HG04015,0,,123679
20,323514,346562,dup,HG03730,0,,23048
20,325164,346259,dup,HG03730,0,,21095
20,366657,1099826,dup,NA19454,0,,733169
20,377934,482954,dup,NA18617,0,,105020
20,379815,388084,dup,HG01085,0,,8269
20,386009,427561,dup,NA18617,0,,41552
20,826939,858611,dup,HG02085,0,,31672
20,867931,958653,dup,HG02085,0,,90722
20,1490168,1549769,dup,HG02597,0,,59601
20,1607064,1841726,dup,HG02597,0,,234662
20,2129368,2671340,dup,NA19454,0,,541972
20,2204471,2221023,dup,NA18537,0,,16552
20,2215586,2248081,dup,NA18537,0,,32495
20,2251603,2321547,dup,NA18537,0,,69944
20,2797051,2906920,dup,NA19454,0,,109869
20,2937933,3013146,dup,NA19454,0,,75213
20,3477105,3485883,dup,HG03084,0,,8778
20,3830565,3968474,dup,HG03479,0,,137909
20,4186608,5018282,dup,NA19454,0,,831674
20,5741467,5813220,dup,NA19454,0,,71753
20,6264705,6268629,dup,HG01791,0,,3924
20,7665032,7811061,dup,NA19454,0,,146029
20,7699056,7702867,dup,HG00288,0,,3811
20,8096359,8186923,dup,NA19323,0,,90564
20,8387666,8583737,dup,NA19323,0,,196071
20,8999467,9192323,dup,HG00243,0,,192856
20,10093713,10099378,dup,HG01348,0,,5665
20,10351010,10371950,dup,HG02943,0,,20940
20,11444130,11449129,dup,HG01927,0,,4999
20,11803251,11927762,dup,NA18501,0,,124511
20,11803496,11992405,dup,NA18501,0,,188909
20,12057227,12160889,dup,NA18501,0,,103662
20,12069129,12125244,dup,NA18501,0,,56115
20,12143651,12152567,dup,HG03643,0,,8916
20,12153818,12282003,dup,NA18501,0,,128185
20,12237963,12287617,dup,NA18501,0,,49654
20,12283936,12287284,dup,NA20517,0,,3348
20,12606067,12609641,dup,NA18501,0,,3574
20,12741023,12797504,dup,NA19095,0,,56481
20,12798068,12858504,dup,NA19095,0,,60436
20,12905222,12967346,dup,NA19095,0,,62124
20,13545960,13626033,dup,HG01848,0,,80073
20,13553770,13750871,dup,HG01848,0,,197101
20,13830586,13842908,dup,HG03202,0,,12322
20,13862143,13878459,dup,HG02399,0,,16316
20,14427715,14441694,dup,HG00742,0,,13979
20,14436517,14447175,dup,HG00742,0,,10658
20,14592499,14640859,dup,HG01777,0,,48360
20,14651885,14688783,dup,HG01777,0,,36898
20,14704403,14758106,dup,HG00739,0,,53703
20,14721074,14804581,dup,HG00739,0,,83507
20,14795646,14858750,dup,HG00102,0,,63104
20,14960275,15013130,dup,HG03103,0,,52855
20,15003787,15036927,dup,HG03103,0,,33140
20,15190224,15202422,dup,NA20767,0,,12198
20,15345369,15390870,dup,HG03645,0,,45501
20,15750894,15766754,dup,HG00324,0,,15860
20,16560129,16672792,dup,HG00437,0,,112663
20,16566974,16586613,dup,HG02337,0,,19639
20,16585046,16644851,dup,HG00437,0,,59805
20,16662596,16667870,dup,HG00100,0,,5274
20,17028649,17084595,dup,NA20503,0,,55946
20,17546577,17557449,dup,HG03874,0,,10872
20,18338414,18465370,dup,NA19454,0,,126956
20,18619062,18626789,dup,HG03099,0,,7727
20,18818893,18913460,dup,HG02513,0,,94567
20,18819836,18936082,dup,HG02016,0,,116246
20,19171560,19182852,dup,NA12272,0,,11292
20,19618469,19975963,dup,NA19454,0,,357494
20,19864859,19874549,dup,HG01365,0,,9690
20,19917255,19933167,dup,HG04056,0,,15912
20,20152645,20158791,dup,HG00524,0,,6146
20,20172060,20240786,dup,HG01605,0,,68726
20,20172424,20340887,dup,HG01605,0,,168463
20,20287245,20327302,dup,HG01605,0,,40057
20,20466668,21156604,dup,NA19454,0,,689936
20,21259287,21262536,dup,HG01395,0,,3249
20,23003001,23006878,dup,HG01284,0,,3877
20,23167201,23186505,dup,HG01619,0,,19304
20,23406161,23458420,dup,HG03295,0,,52259
20,23406244,23577716,dup,HG03295,0,,171472
20,23749525,23762599,dup,HG04159,0,,13074
20,23764918,23799279,dup,NA18644,0,,34361
20,23801677,23841087,dup,NA18644,0,,39410
20,23838450,23867695,dup,HG01917,0,,29245
20,24419047,24426046,dup,HG00250,0,,6999
20,24474907,25073817,dup,HG03539,0,,598910
20,24482925,24632740,dup,HG03539,0,,149815
20,24651528,24822408,dup,HG03539,0,,170880
20,24734059,24793058,dup,HG03539,0,,58999
20,24787525,24847753,dup,HG03539,0,,60228
20,24859737,24992299,dup,HG03539,0,,132562
20,24865594,24901200,dup,HG02343,0,,35606
20,24922189,24987949,dup,HG03539,0,,65760
20,25085246,25344647,dup,HG03135,0,,259401
20,25102088,25348338,dup,HG03135,0,,246250
20,25104083,25205059,dup,HG03135,0,,100976
20,25265346,25299098,dup,HG00266,0,,33752
20,25325139,25339757,dup,HG00739,0,,14618
20,25683709,25694312,dup,HG03858,0,,10603
20,25696173,25707772,dup,HG00133,0,,11599
20,25711652,25723540,dup,HG00130,0,,11888
20,25727391,25740608,dup,HG02805,0,,13217
20,25912905,25921286,dup,NA19080,0,,8381
20,26069574,26088300,dup,HG03871,0,,18726
20,26122421,26169036,dup,NA20847,0,,46615
20,26173502,26218143,dup,HG01680,0,,44641
20,26222037,26271041,dup,HG02642,0,,49004
20,29422108,29434910,dup,HG00100,0,,12802
20,29453676,29496100,dup,HG00100,0,,42424
20,29507685,29537351,dup,HG00536,0,,29666
20,29532382,29554414,dup,HG00478,0,,22032
20,29551820,29572281,dup,HG00478,0,,20461
20,29571858,29610983,dup,HG00478,0,,39125
20,29804050,29859392,dup,HG03279,0,,55342
20,29845161,30000974,dup,NA19454,0,,155813
20,29856869,29941470,dup,HG03279,0,,84601
20,29955115,29992845,dup,HG03279,0,,37730
20,30088513,30164367,dup,HG00759,0,,75854
20,30123131,30143102,dup,HG00759,0,,19971
20,30472165,30481795,dup,HG00114,0,,9630
20,31902061,31909289,dup,HG01801,0,,7228
20,33755010,33762468,dup,HG00626,0,,7458
20,34239509,34243528,dup,HG00446,0,,4019
20,34300235,34315580,dup,HG04180,0,,15345
20,35430102,35506717,dup,HG03012,0,,76615
20,35430815,35462246,dup,HG03012,0,,31431
20,35476376,35501512,dup,HG03012,0,,25136
20,35677713,35825050,dup,HG00277,0,,147337
20,35688969,35703368,dup,HG00277,0,,14399
20,35785519,35803250,dup,HG00277,0,,17731
20,36812718,36828301,dup,NA21086,0,,15583
20,36812974,36828601,dup,HG00629,0,,15627
20,36892746,37020794,dup,HG03619,0,,128048
20,37547150,37570300,dup,HG01816,0,,23150
20,37547195,37601450,dup,HG01816,0,,54255
20,37563068,37631928,dup,NA19377,0,,68860
20,37578351,37603477,dup,NA19377,0,,25126
20,37608746,37657635,dup,NA19377,0,,48889
20,37669841,37695142,dup,NA19377,0,,25301
20,37855644,37872727,dup,HG03267,0,,17083
20,37880201,37883765,dup,HG01107,0,,3564
20,38010700,38027838,dup,HG03372,0,,17138
20,40058397,40152395,dup,HG02053,0,,93998
20,40060213,40196275,dup,NA12004,0,,136062
20,40204669,40239904,dup,HG02053,0,,35235
20,40224121,40771618,dup,HG02053,0,,547497
20,40248270,40388196,dup,HG02053,0,,139926
20,40395569,40615363,dup,HG01503,0,,219794
20,40482156,40507907,dup,HG03589,0,,25751
20,40618941,40747131,dup,HG02053,0,,128190
20,40751067,40898014,dup,HG02053,0,,146947
20,41259731,41290255,dup,HG00559,0,,30524
20,41284311,41343723,dup,NA12004,0,,59412
20,42281654,42385526,dup,NA18614,0,,103872
20,42314664,42385069,dup,NA18614,0,,70405
20,42725249,42740505,dup,NA19076,0,,15256
20,42894719,42967254,dup,HG01108,0,,72535
20,42898500,42926236,dup,HG01108,0,,27736
20,43939062,43947398,dup,HG03624,0,,8336
20,44148247,44157188,dup,HG01809,0,,8941
20,44918141,44921224,dup,HG01785,0,,3083
20,45245429,45274466,dup,NA18547,0,,29037
20,45245452,45275611,dup,NA18547,0,,30159
20,45705375,45709468,dup,HG01628,0,,4093
20,46402802,46415734,dup,HG03875,0,,12932
20,46759680,46865369,dup,HG02614,0,,105689
20,46789256,46995815,dup,HG02614,0,,206559
20,46856889,47017936,dup,HG02614,0,,161047
20,47017233,47085320,dup,HG02614,0,,68087
20,47707304,47712988,dup,HG03862,0,,5684
20,47717783,47738385,dup,HG03689,0,,20602
20,48226019,48240224,dup,HG01197,0,,14205
20,48226923,48473643,dup,HG01197,0,,246720
20,48238319,48262650,dup,HG01197,0,,24331
20,48307572,48316704,dup,HG03238,0,,9132
20,48312383,48323691,dup,HG00637,0,,11308
20,48334256,48342266,dup,HG00457,0,,8010
20,48339749,48347266,dup,HG00637,0,,7517
20,48349519,48359132,dup,NA19451,0,,9613
20,48361001,48369679,dup,HG01197,0,,8678
20,48366152,48396405,dup,HG01197,0,,30253
20,48405202,48443019,dup,HG01197,0,,37817
20,48441645,48451854,dup,HG01197,0,,10209
20,48458795,48473809,dup,HG01197,0,,15014
20,49564879,49575060,dup,HG00274,0,,10181
20,49750570,49758181,dup,HG00356,0,,7611
20,50351106,50362179,dup,HG01101,0,,11073
20,50354671,50370309,dup,HG01101,0,,15638
20,50360780,50369353,dup,HG01101,0,,8573
20,50367933,50378881,dup,HG01101,0,,10948
20,50482966,50491368,dup,HG03680,0,,8402
20,50682959,50697194,dup,HG01108,0,,14235
20,50868263,50913389,dup,HG03342,0,,45126
20,50909168,50927784,dup,HG03689,0,,18616
20,51171164,51176212,dup,HG01578,0,,5048
20,51408944,51422141,dup,HG01980,0,,13197
20,52323825,52329295,dup,HG03971,0,,5470
20,52707106,52713745,dup,HG03884,0,,6639
20,54624585,54718300,dup,HG03708,0,,93715
20,55004094,55046204,dup,HG04194,0,,42110
20,55005455,55056588,dup,HG03479,0,,51133
20,55161847,55192990,dup,HG03692,0,,31143
20,55248102,55254796,dup,HG00732,0,,6694
20,56510068,56530715,dup,HG00596,0,,20647
20,56510079,56530635,dup,HG01067,0,,20556
20,58708821,58720876,dup,HG03779,0,,12055
20,58755366,58772008,dup,NA19096,0,,16642
20,59565897,59590318,dup,HG00099,0,,24421
20,60186320,60190319,dup,HG02051,0,,3999
20,60194086,60229597,dup,NA21088,0,,35511
20,60199635,60266732,dup,HG03805,0,,67097
20,60232656,60292262,dup,NA21088,0,,59606
20,60255294,60285419,dup,HG03781,0,,30125
20,60267734,60297348,dup,HG03781,0,,29614
20,60288730,60312754,dup,HG03603,0,,24024
20,61005009,61031775,dup,HG01798,0,,26766
20,62005994,62026436,dup,HG01462,0,,20442
20,62043163,62062391,dup,HG02266,0,,19228
20,62848462,62865490,dup,HG00253,0,,17028
20,62848483,62893113,dup,HG00253,0,,44630
20,62868361,62873449,dup,HG00253,0,,5088
20,62876887,62885095,dup,HG00253,0,,8208
20,62879795,62921505,dup,HG02621,0,,41710
20,62891341,62900705,dup,HG02621,0,,9364
20,62904563,62915351,dup,HG02621,0,,10788
20,62949512,62957862,dup,HG00099,0,,8350
21,36030191,36030571,del,NA18516,0,,380
21,41346400,41346606,del,NA11993,0,,206
21,15460780,15461864,del,NA19003,0,,1084
21,26359945,26364584,del,NA18873,0,,4639
21,15242050,15261608,del,NA19788,0,,19558
21,37294588,37299968,del,NA18947,0,,5380
21,25288295,25289653,del,NA19116,0,,1358
21,38697414,38706406,del,HG01354,0,,8992
21,24742232,24742546,del,NA18548,0,,314
21,10918875,10926048,del,HG00403,0,,7173
21,21999999,22004210,del,NA19451,0,,4211
21,40525400,40528546,del,NA19684,0,,3146
21,23653316,23666522,del,NA18622,0,,13206
21,31805574,31823597,del,NA18873,0,,18023
21,30525368,30526816,del,NA19722,0,,1448
21,22702973,22703899,del,NA18853,0,,926
21,21107012,21318624,del,NA19713,0,,211612
21,19959535,19959644,del,NA19129,0,,109
21,27781967,27785046,del,NA18537,0,,3079
21,21586166,21586367,del,HG00620,0,,201
21,19867950,19868262,del,HG00473,0,,312
21,44612276,44612446,del,HG00525,0,,170
21,41521192,41521833,del,NA19437,0,,641
21,19756747,19759898,del,NA18558,0,,3151
21,15428673,15429705,del,HG00108,0,,1032
21,48064904,48068079,del,HG00581,0,,3175
21,10787191,10839160,del,NA20525,0,,51969
21,25749331,25752264,del,HG00463,0,,2933
21,35024342,35025365,del,NA19445,0,,1023
21,39911593,39917079,del,NA12003,0,,5486
21,10825015,10827792,del,HG00581,0,,2777
21,46371793,46372110,del,NA19901,0,,317
21,14339197,14350898,del,HG00328,0,,11701
21,36767516,36768122,del,HG01198,0,,606
21,45681716,45684922,del,NA19397,0,,3206
21,38192847,38193720,del,NA19376,0,,873
21,43351816,43354522,del,HG01069,0,,2706
21,44805246,44805646,del,NA19138,0,,400
21,23654900,23666003,del,NA19082,0,,11103
21,20836116,20843172,del,NA20281,0,,7056
21,14849866,14858072,del,NA19455,0,,8206
21,46762950,46763046,del,NA12830,0,,96
21,24391766,24393237,del,NA19463,0,,1471
21,28299060,28302366,del,HG00339,0,,3306
21,10787825,10808631,del,HG00369,0,,20806
21,45051832,45052124,del,HG00320,0,,292
21,37696363,37697045,del,HG00346,0,,682
21,32752700,32755344,del,NA18942,0,,2644
21,46973416,46975422,del,NA19749,0,,2006
21,44007316,44010222,del,NA19664,0,,2906
21,32946193,32948765,del,HG00258,0,,2572
21,41095389,41103169,del,NA19060,0,,7780
21,43037464,43039079,del,HG00537,0,,1615
21,45994406,46021184,del,HG01356,0,,26778
21,27274751,27274949,del,HG01384,0,,198
21,37204987,37212413,del,NA19428,0,,7426
21,29725250,29725605,del,NA19382,0,,355
21,31292502,31293201,del,NA18505,0,,699
21,25452888,25453707,del,NA20801,0,,819
21,24506153,24506934,del,HG00325,0,,781
21,10808546,10815054,del,HG01259,0,,6508
21,46906165,46906372,del,NA18510,0,,207
21,10781173,10810985,del,NA20531,0,,29812
21,15244939,15264496,del,HG00701,0,,19557
21,47388021,47389724,del,HG01149,0,,1703
21,16586716,16591822,del,NA20800,0,,5106
21,37365598,37366630,del,NA19065,0,,1032
21,32432180,32434436,del,NA19679,0,,2256
21,10945339,11177587,del,HG00177,0,,232248
21,19914052,19914393,del,NA20515,0,,341
21,31735005,31738241,del,HG00479,0,,3236
21,22660372,22660981,del,NA20528,0,,609
21,46246962,46249756,del,HG00243,0,,2794
21,40344306,40344628,del,NA19225,0,,322
21,29620220,29628113,del,NA07000,0,,7893
21,21800662,21845223,del,NA19138,0,,44561
21,17378127,17378851,del,NA18498,0,,724
21,39314971,39317235,del,NA19431,0,,2264
21,33944224,33944804,del,HG00367,0,,580
21,31636703,31638594,del,NA19453,0,,1891
21,10809215,10814481,del,HG01384,0,,5266
21,15240219,15259782,del,NA19657,0,,19563
21,35695869,35696535,del,NA20760,0,,666
21,19326600,19329109,del,HG00476,0,,2509
21,24374796,24375420,del,NA18999,0,,624
21,40475530,40479640,del,NA20810,0,,4110
21,17776955,17789175,del,HG00557,0,,12220
21,46448128,46448701,del,NA18624,0,,573
21,24828945,24829264,del,NA12003,0,,319
21,23488604,23490407,del,NA20537,0,,1803
21,41521197,41521833,del,HG00258,0,,636
21,37857255,37857617,del,HG01351,0,,362
21,38961916,38961822,del,NA19762,0,,-94
21,26344478,26345763,del,HG00100,0,,1285
21,14841863,14848994,del,NA19355,0,,7131
21,28460635,28467210,del,NA19720,0,,6575
21,36451035,36453360,del,NA19087,0,,2325
21,44704816,44710322,del,NA20778,0,,5506
21,24848431,24891826,del,NA19463,0,,43395
21,23654900,23666012,del,HG00620,0,,11112
21,16427341,16429273,del,NA20538,0,,1932
21,28985248,28994545,del,NA20518,0,,9297
21,25563989,25568806,del,HG00463,0,,4817
21,10789209,10808635,del,NA18602,0,,19426
21,45159382,45160874,del,HG01353,0,,1492
21,15307137,15307285,del,HG00698,0,,148
21,46921566,46921998,del,HG01171,0,,432
21,22005618,22010668,del,NA19350,0,,5050
21,42936331,42936522,del,NA12155,0,,191
21,27034187,27034718,del,NA18486,0,,531
21,26060078,26066605,del,HG00428,0,,6527
21,14957516,15201422,del,HG00328,0,,243906
21,45631975,45632233,del,NA19147,0,,258
21,44891905,44891883,del,HG01073,0,,-22
21,28450960,28459835,del,HG01383,0,,8875
21,17669101,17670264,del,NA19452,0,,1163
21,29877994,29881251,del,HG00512,0,,3257
21,46153353,46153476,del,NA11992,0,,123
21,21354031,21356698,del,HG00254,0,,2667
21,24488758,24510089,del,NA18632,0,,21331
21,36767711,36768248,del,HG01113,0,,537
21,24175779,24211157,del,NA19916,0,,35378
21,33174110,33175048,del,NA19429,0,,938
21,34149037,34160901,del,NA18546,0,,11864
21,37405251,37407225,del,HG01080,0,,1974
21,43136923,43138564,del,HG01197,0,,1641
21,25258373,25263453,del,NA19435,0,,5080
21,18738478,18739336,del,NA19901,0,,858
21,38287957,38302300,del,NA19383,0,,14343
21,41521140,41521831,del,NA19393,0,,691
21,10780506,10785022,del,NA20805,0,,4516
21,25479710,25480587,del,NA12342,0,,877
21,19042856,19049472,del,NA19235,0,,6616
21,44035552,44887795,del,NA20502,0,,852243
21,14447416,14486022,del,NA19452,0,,38606
21,25451723,25452393,del,NA19248,0,,670
21,44209393,44209991,del,NA19201,0,,598
21,9846434,9846531,del,HG00689,0,,97
21,37014963,37015168,del,NA20512,0,,205
21,37864436,37864758,del,NA18563,0,,322
21,39863887,39863992,del,NA18960,0,,105
21,10813269,10820006,del,NA19701,0,,6737
21,21199253,21200866,del,NA18984,0,,1613
21,21902731,21906181,del,NA11994,0,,3450
21,16624191,16628932,del,NA19676,0,,4741
21,36600506,36602412,del,HG00320,0,,1906
21,46857222,46857942,del,NA18959,0,,720
21,24488706,24510018,del,NA18632,0,,21312
21,47318337,47319008,del,HG00318,0,,671
21,42403001,42412641,del,NA18638,0,,9640
21,31250073,31258535,del,NA19077,0,,8462
21,35530499,35532996,del,NA19434,0,,2497
21,24800776,24800927,del,HG00707,0,,151
21,30560391,30561538,del,NA18950,0,,1147
21,28476661,28477438,del,NA18942,0,,777
21,32667996,32670084,del,NA18596,0,,2088
21,37676110,37676344,del,NA18871,0,,234
21,10969140,10969438,del,HG01052,0,,298
21,10813572,10816991,del,NA07347,0,,3419
21,45901500,45901934,del,HG01350,0,,434
21,45619169,45620716,del,NA18543,0,,1547
21,23795751,23797364,del,HG00318,0,,1613
21,43226250,43226515,del,HG00620,0,,265
21,47609742,47610876,del,NA19439,0,,1134
21,44755922,44756271,del,NA19371,0,,349
21,20568119,20574239,del,NA12891,0,,6120
21,17943637,17944602,del,NA19712,0,,965
21,26922286,26927151,del,NA19471,0,,4865
21,18719995,18726169,del,HG00663,0,,6174
21,28193516,28203322,del,NA19108,0,,9806
21,19792705,19793232,del,NA19818,0,,527
21,30840574,30841503,del,NA18566,0,,929
21,29107318,29108557,del,HG00525,0,,1239
21,26862375,26865760,del,NA19430,0,,3385
21,25498801,25501222,del,NA19785,0,,2421
21,15266853,15273457,del,HG01137,0,,6604
21,17771020,17775353,del,HG00478,0,,4333
21,14958016,15201222,del,HG00635,0,,243206
21,41199929,41200074,del,NA18622,0,,145
21,38707461,38711855,del,NA19449,0,,4394
21,33843193,33843760,del,HG00111,0,,567
21,36893027,36896619,del,HG00463,0,,3592
21,23838761,23946789,del,NA19835,0,,108028
21,25627328,25627540,del,HG00740,0,,212
21,22122634,22140306,del,NA19789,0,,17672
21,18494783,18497219,del,NA18546,0,,2436
21,37642588,37644168,del,NA19900,0,,1580
21,24681037,24706128,del,NA19909,0,,25091
21,46370797,46371790,del,HG00326,0,,993
21,44135555,44139790,del,NA20828,0,,4235
21,24423331,24435107,del,NA19138,0,,11776
21,36072528,36073383,del,NA19461,0,,855
21,10813687,10817653,del,HG00249,0,,3966
21,43010400,43013600,del,NA18908,0,,3200
21,33943668,33947937,del,NA20768,0,,4269
21,10813779,10842813,del,NA20799,0,,29034
21,36600646,36602553,del,HG00377,0,,1907
21,29713016,29714206,del,HG00708,0,,1190
21,32894669,32898163,del,HG00556,0,,3494
21,25506887,25508029,del,NA18943,0,,1142
21,37699620,37700141,del,NA18871,0,,521
21,47555366,47555520,del,NA19313,0,,154
21,32212252,32214191,del,NA19350,0,,1939
21,31419711,31420863,del,NA19657,0,,1152
21,31136205,31139186,del,NA19780,0,,2981
21,42911938,42912387,del,NA12761,0,,449
21,23795922,23796266,del,HG00611,0,,344
21,39900346,39900670,del,NA12249,0,,324
21,45603160,45604548,del,HG01353,0,,1388
21,21635731,21653020,del,HG00578,0,,17289
21,43387241,43388202,del,HG01489,0,,961
21,40789971,40790705,del,NA18548,0,,734
21,36430109,36432952,del,NA19390,0,,2843
21,27174804,27179999,del,NA18488,0,,5195
21,36295980,36296195,del,HG00125,0,,215
21,43745883,43751125,del,NA18867,0,,5242
21,25258566,25265222,del,NA18924,0,,6656
21,41216994,41217156,del,NA18622,0,,162
21,46322393,46322542,del,NA19379,0,,149
21,18621200,18622230,del,HG01353,0,,1030
21,45684264,45686557,del,NA18486,0,,2293
21,20836930,20843326,del,NA19404,0,,6396
21,42453563,42459467,del,NA18553,0,,5904
21,23162168,23162410,del,HG00418,0,,242
21,47779118,47779654,del,NA20798,0,,536
21,43137085,43138630,del,HG01197,0,,1545
21,45789320,45789674,del,NA20581,0,,354
21,26335307,26340438,del,NA07056,0,,5131
21,31639128,31644640,del,NA19703,0,,5512
21,34375344,34376056,del,NA19452,0,,712
21,47560324,47560525,del,NA19102,0,,201
21,36560987,36565855,del,NA18908,0,,4868
21,18858197,18862476,del,NA19372,0,,4279
21,14528816,14549822,del,NA19381,0,,21006
21,25710185,25710604,del,NA12155,0,,419
21,19997044,20000453,del,NA19390,0,,3409
21,16113917,16114155,del,NA19147,0,,238
21,44501150,44501965,del,NA20516,0,,815
21,44049914,44050091,del,NA12842,0,,177
21,14994716,15023922,del,NA18908,0,,29206
21,21058086,21058227,del,NA19463,0,,141
21,46153266,46153456,del,NA18571,0,,190
21,47026075,47026252,del,HG00613,0,,177
21,15460416,15461864,del,NA19007,0,,1448
21,26212636,26214452,del,NA20530,0,,1816
21,44134875,44134988,del,HG00251,0,,113
21,21621908,21624026,del,NA19916,0,,2118
21,11085706,11085903,del,NA19380,0,,197
21,31813317,31824828,del,NA19469,0,,11511
21,23654966,23667222,del,NA19661,0,,12256
21,26825131,26825398,del,NA20753,0,,267
21,23795656,23797523,del,HG00318,0,,1867
21,30234668,30234978,del,NA19654,0,,310
21,44756573,44757408,del,NA19712,0,,835
21,10850032,10850637,del,HG00325,0,,605
21,15722842,15724432,del,NA18624,0,,1590
21,23188327,23202327,del,NA19248,0,,14000
21,21896514,21896630,del,NA19225,0,,116
21,25295980,25299697,del,HG00353,0,,3717
21,38151272,38157782,del,NA19238,0,,6510
21,21959016,21961722,del,NA20543,0,,2706
21,40734415,40737002,del,NA19312,0,,2587
21,30986797,30987693,del,NA18912,0,,896
21,31930744,31932956,del,NA19379,0,,2212
21,15232039,15270900,del,NA11994,0,,38861
21,39651087,39655080,del,NA18907,0,,3993
21,22122680,22140384,del,NA19789,0,,17704
21,40348406,40350053,del,NA19474,0,,1647
21,10789295,10794527,del,HG00247,0,,5232
21,10466482,10475738,del,NA18961,0,,9256
21,48030153,48030422,del,HG01069,0,,269
21,35368802,35377292,del,HG00650,0,,8490
21,25241944,25243536,del,NA12829,0,,1592
21,43350116,43353485,del,NA19713,0,,3369
21,10824969,10828118,del,NA20805,0,,3149
21,47004836,47009147,del,HG00663,0,,4311
21,41098756,41099026,del,HG00249,0,,270
21,45584153,45584405,del,HG00269,0,,252
21,21607896,21620792,del,NA18499,0,,12896
21,46776091,46779690,del,NA18861,0,,3599
21,45816079,45816190,del,HG00536,0,,111
21,29109556,29109632,del,NA19381,0,,76
21,14849041,14859551,del,NA19347,0,,10510
21,18449661,18450832,del,NA19473,0,,1171
21,30552224,30552578,del,HG00692,0,,354
21,24542167,24542346,del,NA20766,0,,179
21,28195290,28201845,del,NA20289,0,,6555
21,10992014,10999734,dup,HG00096,0,,7720
21,14504804,14530597,dup,HG00101,0,,25793
21,14595636,14640021,dup,HG00244,0,,44385
21,14626476,14956108,dup,HG00244,0,,329632
21,15207296,15234026,dup,HG00530,0,,26730
21,15244513,15253042,dup,HG00097,0,,8529
21,15253724,15259810,dup,HG00097,0,,6086
21,15264074,15272540,dup,HG00252,0,,8466
21,15288578,15333696,dup,HG01708,0,,45118
21,15376062,15393020,dup,NA20334,0,,16958
21,15402040,15418818,dup,HG02840,0,,16778
21,15467902,15711993,dup,HG02136,0,,244091
21,15618178,15660423,dup,HG02107,0,,42245
21,15941347,16029398,dup,HG01889,0,,88051
21,15942342,16199729,dup,HG01889,0,,257387
21,18029887,18050687,dup,HG00321,0,,20800
21,18240956,18373989,dup,HG01438,0,,133033
21,19360067,19382004,dup,HG02275,0,,21937
21,20055373,20079349,dup,HG00102,0,,23976
21,20510433,20520904,dup,HG00355,0,,10471
21,20567929,20574037,dup,HG00234,0,,6108
21,20674556,20678633,dup,HG02682,0,,4077
21,20910196,21066026,dup,HG02304,0,,155830
21,20916856,20958519,dup,HG02304,0,,41663
21,20992283,21034573,dup,HG02304,0,,42290
21,21301789,21314561,dup,HG03085,0,,12772
21,21305537,21342113,dup,HG00319,0,,36576
21,21574333,21596418,dup,NA21119,0,,22085
21,21802927,21845681,dup,HG01896,0,,42754
21,22250871,22299940,dup,HG01396,0,,49069
21,22380404,22396778,dup,HG04019,0,,16374
21,22418048,22457319,dup,HG01783,0,,39271
21,23084711,23088159,dup,HG02953,0,,3448
21,23255004,23267003,dup,HG01804,0,,11999
21,23356555,23370136,dup,NA19719,0,,13581
21,23738511,23785083,dup,HG03862,0,,46572
21,24290138,24407779,dup,NA18531,0,,117641
21,24479419,24660128,dup,HG01177,0,,180709
21,24488919,24512846,dup,NA18632,0,,23927
21,24522922,24648754,dup,HG01177,0,,125832
21,24650080,24664989,dup,HG00128,0,,14909
21,24728595,24731604,dup,NA21109,0,,3009
21,24738476,24798187,dup,HG01843,0,,59711
21,24743416,24795119,dup,HG01843,0,,51703
21,25094935,25267342,dup,HG02981,0,,172407
21,25258583,25263150,dup,HG00640,0,,4567
21,25305137,25335352,dup,HG03120,0,,30215
21,25309817,25347765,dup,HG03120,0,,37948
21,25559129,25594627,dup,HG01800,0,,35498
21,26312079,26359901,dup,NA19451,0,,47822
21,26771304,26787354,dup,NA19401,0,,16050
21,27551897,27564516,dup,HG03126,0,,12619
21,28954765,29019163,dup,HG03045,0,,64398
21,28954910,29076069,dup,HG03045,0,,121159
21,29062668,29217742,dup,HG03045,0,,155074
21,29624572,29628671,dup,NA07000,0,,4099
21,30219159,30257713,dup,NA19007,0,,38554
21,31298039,31319029,dup,HG03644,0,,20990
21,31298053,31323367,dup,HG01443,0,,25314
21,31322819,31337530,dup,NA20814,0,,14711
21,31748354,31787574,dup,HG01847,0,,39220
21,31803702,31823969,dup,NA18873,0,,20267
21,32420200,32428568,dup,NA12144,0,,8368
21,32743525,32767796,dup,HG00157,0,,24271
21,32746152,32763277,dup,HG00157,0,,17125
21,32805646,32872951,dup,HG03479,0,,67305
21,33603622,33609791,dup,HG02703,0,,6169
21,33867161,33922214,dup,HG03950,0,,55053
21,33867341,34000018,dup,HG03950,0,,132677
21,34047662,34123520,dup,NA12775,0,,75858
21,34204194,34265833,dup,HG02561,0,,61639
21,34404311,34414130,dup,NA18563,0,,9819
21,34768787,34781896,dup,HG03446,0,,13109
21,35315168,35336407,dup,HG01598,0,,21239
21,35383717,35387485,dup,HG00180,0,,3768
21,36297663,36300867,dup,NA19025,0,,3204
21,37185130,37199372,dup,HG00232,0,,14242
21,37477115,37619027,dup,HG00356,0,,141912
21,37477866,37584844,dup,HG00349,0,,106978
21,37512904,37585678,dup,HG02277,0,,72774
21,37586581,37619950,dup,HG02277,0,,33369
21,37857576,37862731,dup,HG01085,0,,5155
21,38287897,38303195,dup,HG00524,0,,15298
21,39348117,39423868,dup,HG04094,0,,75751
21,40117167,40157624,dup,HG02604,0,,40457
21,40903155,40987099,dup,NA12156,0,,83944
21,40987107,41012386,dup,HG04022,0,,25279
21,41772480,41794041,dup,HG00177,0,,21561
21,42721651,42792496,dup,HG02314,0,,70845
21,42726275,42763089,dup,HG02314,0,,36814
21,42827368,42899329,dup,HG02733,0,,71961
21,42827936,42941813,dup,HG02733,0,,113877
21,43190101,43204241,dup,HG00406,0,,14140
21,44061668,44105124,dup,NA19247,0,,43456
21,44821876,44832735,dup,HG00139,0,,10859
21,45031626,45044540,dup,HG02325,0,,12914
21,45039445,45084562,dup,HG03433,0,,45117
21,45635758,45659797,dup,HG02734,0,,24039
21,45744322,45755111,dup,HG01326,0,,10789
21,45959412,46011152,dup,NA19384,0,,51740
21,46222495,46325108,dup,HG04156,0,,102613
21,47537131,47542130,dup,HG00097,0,,4999
21,47550459,47563156,dup,HG03241,0,,12697
21,47985400,48000912,dup,HG02635,0,,15512
21,48006091,48094555,dup,NA18561,0,,88464
21,48012792,48070297,dup,NA18618,0,,57505
22,24299716,24311122,del,HG00267,0,,11406
22,44303700,44304372,del,NA19684,0,,672
22,33755613,33760104,del,HG01108,0,,4491
22,42635182,42641934,del,NA18989,0,,6752
22,51054916,51057493,del,NA19383,0,,2577
22,19713060,19714074,del,NA20340,0,,1014
22,31800777,31801841,del,NA19072,0,,1064
22,24313116,24328022,del,NA19066,0,,14906
22,36612999,36614318,del,NA19471,0,,1319
22,48716075,48716167,del,HG00237,0,,92
22,44658357,44661863,del,NA18612,0,,3506
22,29383768,29387200,del,NA18502,0,,3432
22,49878410,49878547,del,NA20530,0,,137
22,23900768,23903230,del,NA19717,0,,2462
22,21875816,21908822,del,NA18559,0,,33006
22,21712416,21741522,del,NA19444,0,,29106
22,18066587,18069268,del,HG00625,0,,2681
22,46924643,46925408,del,HG00323,0,,765
22,45113741,45114226,del,NA18612,0,,485
22,25466556,25466742,del,NA19240,0,,186
22,36476886,36481279,del,NA19679,0,,4393
22,24274216,24296122,del,NA18912,0,,21906
22,16867406,16867570,del,NA20314,0,,164
22,43866075,43866200,del,HG00139,0,,125
22,24343516,24398422,del,HG01167,0,,54906
22,46389663,46389833,del,HG00557,0,,170
22,46962665,46962908,del,HG01080,0,,243
22,44930926,44931899,del,NA19236,0,,973
22,45252443,45253112,del,NA19313,0,,669
22,50038634,50038961,del,HG00281,0,,327
22,22906059,22909454,del,NA19238,0,,3395
22,42873754,42876010,del,HG00262,0,,2256
22,23477516,23478922,del,HG00331,0,,1406
22,50467158,50467710,del,HG01060,0,,552
22,17879417,17882722,del,NA18597,0,,3305
22,47336674,47336898,del,HG00614,0,,224
22,18997237,19009723,del,HG00671,0,,12486
22,44031489,44039787,del,NA19076,0,,8298
22,38342245,38344607,del,NA19257,0,,2362
22,18535754,18535914,del,NA18547,0,,160
22,25195244,25197332,del,NA18874,0,,2088
22,22268399,22268675,del,NA19213,0,,276
22,20031129,20032671,del,NA18610,0,,1542
22,42940373,42963409,del,HG00656,0,,23036
22,49716866,49717272,del,NA19679,0,,406
22,41455297,41456013,del,NA19429,0,,716
22,39360536,39362143,del,NA18637,0,,1607
22,32824723,32828882,del,NA18557,0,,4159
22,48492540,48492765,del,NA19625,0,,225
22,23197316,23241622,del,NA11995,0,,44306
22,45015467,45015897,del,NA18582,0,,430
22,49840022,49908298,del,HG00313,0,,68276
22,25660786,25917807,del,HG00158,0,,257021
22,38126903,38128429,del,NA18633,0,,1526
22,22709677,22733146,del,HG01384,0,,23469
22,22928313,22928429,del,HG01441,0,,116
22,34076363,34076496,del,HG00513,0,,133
22,17770616,17777572,del,NA20542,0,,6956
22,38655872,38663501,del,HG00620,0,,7629
22,25033061,25033838,del,NA19917,0,,777
22,20950623,20953860,del,NA07000,0,,3237
22,36947137,36948252,del,NA20540,0,,1115
22,19528631,19558429,del,NA19066,0,,29798
22,47696463,47696859,del,NA18508,0,,396
22,49483118,49483936,del,HG00285,0,,818
22,48876906,48878078,del,NA19462,0,,1172
22,18876907,18878612,del,NA18613,0,,1705
22,48652661,48652788,del,NA18489,0,,127
22,42905477,42964150,del,NA18541,0,,58673
22,20263786,20272512,del,NA19716,0,,8726
22,17241916,17278122,del,HG00263,0,,36206
22,24314616,24333622,del,NA12777,0,,19006
22,43472271,43474840,del,HG00614,0,,2569
22,34847598,34851463,del,NA19445,0,,3865
22,23049518,23107677,del,NA19150,0,,58159
22,37643290,37648072,del,HG00327,0,,4782
22,33662209,33664415,del,NA19318,0,,2206
22,38132688,38137338,del,NA19704,0,,4650
22,17770350,17779108,del,NA07051,0,,8758
22,39357316,39387922,del,HG01187,0,,30606
22,39294316,39296772,del,NA20544,0,,2456
22,17718962,17719270,del,NA18562,0,,308
22,18141696,18144628,del,HG01080,0,,2932
22,18589583,18589738,del,NA18536,0,,155
22,21771316,21789122,del,HG01365,0,,17806
22,31419915,31420850,del,HG00111,0,,935
22,43601840,43602022,del,HG00261,0,,182
22,30170960,30171232,del,NA20296,0,,272
22,24104071,24104561,del,NA20346,0,,490
22,50808773,50810125,del,NA19350,0,,1352
22,49352958,49360146,del,NA19439,0,,7188
22,44564941,44566023,del,NA18486,0,,1082
22,47585995,47588478,del,NA20542,0,,2483
22,38736741,38737930,del,NA19398,0,,1189
22,34968084,34968750,del,NA19213,0,,666
22,51119916,51121208,del,HG00178,0,,1292
22,49084476,49086236,del,NA19138,0,,1760
22,39358566,39388922,del,NA19072,0,,30356
22,45280235,45280348,del,HG00533,0,,113
22,37415328,37420660,del,HG00252,0,,5332
22,50348482,50353745,del,NA18616,0,,5263
22,35460785,35567572,del,NA18612,0,,106787
22,24195266,24200072,del,NA18534,0,,4806
22,24314616,24334422,del,HG00127,0,,19806
22,48710004,48711426,del,NA18606,0,,1422
22,23049428,23107268,del,HG00525,0,,57840
22,38551221,38558199,del,NA20760,0,,6978
22,38262790,38278076,del,HG00590,0,,15286
22,29092558,29097953,del,HG00343,0,,5395
22,49974145,49974837,del,NA19909,0,,692
22,21712416,21772022,del,NA12761,0,,59606
22,43098650,43099018,del,NA20813,0,,368
22,24025617,24027538,del,HG01051,0,,1921
22,22416916,22419015,del,NA19114,0,,2099
22,46491201,46491843,del,HG01079,0,,642
22,44026734,44027845,del,NA19371,0,,1111
22,46286362,46286621,del,HG00708,0,,259
22,16533080,16536096,del,NA19835,0,,3016
22,18218503,18219331,del,HG00590,0,,828
22,27654850,27658000,del,NA19723,0,,3150
22,46991771,46995843,del,NA20510,0,,4072
22,22982916,23241722,del,HG01515,0,,258806
22,47883969,47890596,del,NA18570,0,,6627
22,37438367,37438877,del,NA19311,0,,510
22,35459001,35459421,del,NA18593,0,,420
22,25692078,25988592,del,NA12717,0,,296514
22,19818957,19819595,del,NA12763,0,,638
22,17825803,17827326,del,HG00635,0,,1523
22,38069816,38075222,del,NA19311,0,,5406
22,49491728,49491868,del,NA11919,0,,140
22,25400024,25402213,del,NA19676,0,,2189
22,34457203,34463152,del,HG00478,0,,5949
22,47738668,47738955,del,HG01383,0,,287
22,45427688,45427870,del,NA19359,0,,182
22,47570284,47570510,del,HG00154,0,,226
22,30565831,30566035,del,NA19093,0,,204
22,34900193,34901294,del,NA19372,0,,1101
22,36867679,36868972,del,HG01168,0,,1293
22,43475921,43476563,del,NA19463,0,,642
22,32905689,32906359,del,HG00442,0,,670
22,49077626,49077902,del,NA10847,0,,276
22,18003690,18004347,del,NA20786,0,,657
22,44824387,44828404,del,HG01137,0,,4017
22,43839011,43839300,del,HG00472,0,,289
22,24274416,24291722,del,NA19383,0,,17306
22,45211239,45211799,del,NA18486,0,,560
22,31895460,31911026,del,NA19700,0,,15566
22,50295943,50296189,del,HG00267,0,,246
22,39357316,39388922,del,HG01375,0,,31606
22,36283173,36287551,del,NA19396,0,,4378
22,50464724,50464944,del,HG00657,0,,220
22,34717466,34725210,del,HG00136,0,,7744
22,41420009,41423383,del,NA18510,0,,3374
22,38090012,38091046,del,NA20813,0,,1034
22,48645210,48645528,del,NA19102,0,,318
22,27564183,27564363,del,NA20515,0,,180
22,42934816,42935822,del,NA19788,0,,1006
22,49863269,49863484,del,NA20766,0,,215
22,32683454,32683836,del,HG00372,0,,382
22,24329616,24398222,del,NA20513,0,,68606
22,19258063,19285403,del,NA18999,0,,27340
22,48439853,48440182,del,NA19712,0,,329
22,22758934,22764495,del,NA18987,0,,5561
22,40460804,40465446,del,NA19399,0,,4642
22,48740253,48740655,del,HG00530,0,,402
22,45433387,45433942,del,NA19346,0,,555
22,29972118,29975396,del,NA19439,0,,3278
22,31045466,31046233,del,NA19152,0,,767
22,47336416,47338322,del,HG00449,0,,1906
22,47616792,47617048,del,NA18989,0,,256
22,17770350,17779109,del,HG00133,0,,8759
22,32037528,32038814,del,HG00553,0,,1286
22,23054616,23241622,del,NA18945,0,,187006
22,50836073,50836327,del,HG01462,0,,254
22,25056217,25057089,del,HG00553,0,,872
22,49300812,49300942,del,HG00108,0,,130
22,17241216,17277522,del,HG01108,0,,36306
22,35182224,35182460,del,NA19703,0,,236
22,23731167,23731338,del,HG00249,0,,171
22,36773605,36776432,del,NA20521,0,,2827
22,18620374,18629810,del,NA20797,0,,9436
22,39294104,39298684,del,HG00257,0,,4580
22,47558267,47558378,del,HG00140,0,,111
22,18124843,18126439,del,HG01070,0,,1596
22,17333036,17333646,del,NA19236,0,,610
22,23576856,23577812,del,NA19648,0,,956
22,43694504,43695806,del,HG00421,0,,1302
22,46416633,46421129,del,HG00244,0,,4496
22,20973310,20974967,del,NA18520,0,,1657
22,23477566,23480022,del,HG00464,0,,2456
22,38235642,38243108,del,NA19360,0,,7466
22,27410292,27415290,del,NA19901,0,,4998
22,41140113,41142634,del,NA18516,0,,2521
22,22687540,22689379,del,HG00336,0,,1839
22,16364977,16370664,del,NA18611,0,,5687
22,49003062,49003428,del,HG00271,0,,366
22,39358280,39388216,del,HG00188,0,,29936
22,49247196,49247407,del,HG01350,0,,211
22,32994495,32995312,del,NA19818,0,,817
22,20424216,20488422,del,NA19648,0,,64206
22,42717463,42719791,del,HG01108,0,,2328
22,49599134,49608796,del,HG01359,0,,9662
22,45135251,45137530,del,HG00671,0,,2279
22,45196757,45196989,del,NA19108,0,,232
22,30336310,30337194,del,NA19904,0,,884
22,34403768,34406963,del,HG00108,0,,3195
22,23040866,23242072,del,NA19776,0,,201206
22,50949780,50950136,del,NA19377,0,,356
22,38342254,38344598,del,NA19462,0,,2344
22,49544341,49544348,del,HG01440,0,,7
22,47841067,47841181,del,NA19467,0,,114
22,28027302,28027570,del,HG00698,0,,268
22,47685616,47686682,del,NA19376,0,,1066
22,34865194,34865365,del,HG00276,0,,171
22,41294223,41294556,del,NA19381,0,,333
22,35301393,35314704,del,NA18534,0,,13311
22,18003474,18004131,del,HG00331,0,,657
22,24315016,24334822,del,HG01148,0,,19806
22,37983487,37984458,del,NA18487,0,,971
22,39864643,39865196,del,NA19210,0,,553
22,21807838,21813440,del,HG00335,0,,5602
22,21175626,21175999,del,HG01191,0,,373
22,39607667,39607993,del,HG01356,0,,326
22,46563985,46566794,del,NA12348,0,,2809
22,18079152,18080597,del,HG01190,0,,1445
22,38738183,38739337,del,NA19446,0,,1154
22,24274142,24311297,del,NA12348,0,,37155
22,25065840,25110121,del,HG00258,0,,44281
22,44133356,44133670,del,HG00701,0,,314
22,25683671,25980216,del,HG00525,0,,296545
22,45015206,45015549,del,NA20344,0,,343
22,23795372,23796541,del,HG00731,0,,1169
22,36133507,36134273,del,NA12751,0,,766
22,28130765,28132229,del,NA18626,0,,1464
22,22923716,22929822,del,NA19470,0,,6106
22,24875766,24876872,del,NA19379,0,,1106
22,44819601,44821149,del,HG00653,0,,1548
22,31447636,31448588,del,NA12340,0,,952
22,36943236,36949761,del,NA19446,0,,6525
22,23478428,23479559,del,HG01124,0,,1131
22,28480652,28484583,del,HG00737,0,,3931
22,50302006,50302430,del,NA19355,0,,424
22,46303136,46311498,del,NA19436,0,,8362
22,18126653,18129499,del,NA19338,0,,2846
22,30826824,30837787,del,NA18553,0,,10963
22,45258895,45260860,del,NA19060,0,,1965
22,17362814,17363535,del,NA18987,0,,721
22,18359921,18360262,del,NA18599,0,,341
22,24195933,24198505,del,HG01148,0,,2572
22,24343050,24397301,del,NA19063,0,,54251
22,20950623,20953850,del,NA18547,0,,3227
22,27109456,27111136,del,HG00189,0,,1680
22,29679408,29681890,del,NA19374,0,,2482
22,30443497,30447862,del,NA19189,0,,4365
22,29987752,29998191,del,HG00261,0,,10439
22,48215411,48216346,del,HG00249,0,,935
22,47400536,47400656,del,HG01173,0,,120
22,49387216,49394022,del,NA20340,0,,6806
22,50495523,50495801,del,HG00464,0,,278
22,48290116,48294847,del,NA18557,0,,4731
22,38625615,38626128,del,NA18546,0,,513
22,35106502,35117281,del,NA19470,0,,10779
22,49709610,49713167,del,NA19225,0,,3557
22,32701287,32701731,del,NA19374,0,,444
22,43892030,43892906,del,HG00331,0,,876
22,19912530,19913412,del,HG01070,0,,882
22,25638341,25638854,del,NA19257,0,,513
22,45653849,45656810,del,NA18522,0,,2961
22,23378900,23382294,del,HG01125,0,,3394
22,45113223,45114226,del,NA20795,0,,1003
22,43910983,43911102,del,HG00578,0,,119
22,25277114,25277487,del,NA19774,0,,373
22,39356916,39388922,del,HG00671,0,,32006
22,45554718,45557123,del,NA19371,0,,2405
22,47570998,47571439,del,HG00641,0,,441
22,44490420,44490994,del,NA19982,0,,574
22,22569659,22599122,del,HG01489,0,,29463
22,18359905,18360178,del,NA18486,0,,273
22,22517074,22599623,del,NA18634,0,,82549
22,24276434,24279225,del,NA19675,0,,2791
22,18880026,18881420,del,NA20778,0,,1394
22,38816474,38817170,del,NA19446,0,,696
22,46690148,46690480,del,NA19093,0,,332
22,18057750,18060457,del,HG00236,0,,2707
22,32208521,32208837,del,NA18941,0,,316
22,32726166,32726622,del,NA18610,0,,456
22,39374120,39375730,del,HG01198,0,,1610
22,47922489,47924059,del,NA19360,0,,1570
22,25681501,25692600,del,NA18989,0,,11099
22,46349048,46349224,del,NA19749,0,,176
22,28737124,28741372,del,NA19654,0,,4248
22,38736639,38737955,del,NA19144,0,,1316
22,33662104,33665353,del,NA12489,0,,3249
22,17107190,17108407,del,NA18504,0,,1217
22,21712416,21733622,del,NA20787,0,,21206
22,25614203,25614793,del,HG00281,0,,590
22,39469403,39469715,del,HG01173,0,,312
22,43548916,43553522,del,HG00160,0,,4606
22,43895143,43895234,del,HG00556,0,,91
22,42062300,42062788,del,NA20287,0,,488
22,17040875,17041008,del,HG00334,0,,133
22,40873234,40880824,del,NA19430,0,,7590
22,32630868,32631733,del,NA19466,0,,865
22,49764589,49769013,del,NA18870,0,,4424
22,37143169,37147895,del,HG01383,0,,4726
22,45698285,45700160,del,NA19470,0,,1875
22,24343616,24399522,del,HG00583,0,,55906
22,39469479,39469789,del,HG00338,0,,310
22,39211579,39212988,del,NA20785,0,,1409
22,51082251,51082487,del,NA18956,0,,236
22,44192127,44193620,del,NA12751,0,,1493
22,43102680,43104452,del,NA20521,0,,1772
22,35862982,35864909,del,HG00146,0,,1927
22,24343116,24397322,del,NA19921,0,,54206
22,25659128,25916175,del,NA20771,0,,257047
22,44564716,44565922,del,NA18861,0,,1206
22,23094016,23242122,del,HG00324,0,,148106
22,33751617,33751778,del,NA20752,0,,161
22,49381816,49394022,del,NA19099,0,,12206
22,33662619,33664853,del,NA18508,0,,2234
22,17026619,17027821,del,HG01390,0,,1202
22,24274316,24292922,del,HG00327,0,,18606
22,24060756,24070582,del,NA19401,0,,9826
22,42937801,42943179,del,NA19377,0,,5378
22,50354116,50356222,del,HG01140,0,,2106
22,45104649,45105534,del,NA19788,0,,885
22,19247915,19248102,del,NA19394,0,,187
22,18054612,18054947,del,NA20334,0,,335
22,41153059,41156103,del,HG00513,0,,3044
22,27939815,27940007,del,NA20518,0,,192
22,50443038,50446417,del,NA19732,0,,3379
22,45133859,45134917,del,NA18948,0,,1058
22,35007829,35010848,del,HG00559,0,,3019
22,44073880,44080859,del,NA19350,0,,6979
22,49974139,49974249,del,NA18622,0,,110
22,47119328,47120727,del,NA19074,0,,1399
22,49114283,49115662,del,NA18632,0,,1379
22,49715778,49717443,del,HG00740,0,,1665
22,47573849,47575368,del,NA19068,0,,1519
22,45015628,45015735,del,HG00662,0,,107
22,36024145,36026945,del,HG00328,0,,2800
22,50348362,50353762,del,NA18616,0,,5400
22,17668822,17669597,del,NA19398,0,,775
22,38641363,38641485,del,HG01082,0,,122
22,18140466,18144472,del,HG01251,0,,4006
22,39432459,39460057,del,NA18986,0,,27598
22,40592248,40599715,del,NA19789,0,,7467
22,29633086,29635390,del,HG01461,0,,2304
22,36851690,36852912,del,NA19453,0,,1222
22,21999210,22000373,del,NA19703,0,,1163
22,47314894,47356451,del,NA18548,0,,41557
22,45144076,45167671,del,HG00232,0,,23595
22,30243350,30243486,del,NA18637,0,,136
22,43472229,43474816,del,HG00614,0,,2587
22,22922732,22928712,del,NA19704,0,,5980
22,23262723,23267307,del,NA19444,0,,4584
22,49803916,49806422,del,HG00662,0,,2506
22,42513846,42516693,del,HG01342,0,,2847
22,45252606,45252977,del,HG01101,0,,371
22,45427662,45428039,del,HG01051,0,,377
22,33735994,33737056,del,NA19138,0,,1062
22,49800984,49801473,del,HG00684,0,,489
22,48733757,48747557,del,HG00136,0,,13800
22,43141003,43141907,del,NA18592,0,,904
22,21710616,21741522,del,NA19982,0,,30906
22,23900166,23903022,del,HG00607,0,,2856
22,25097647,25097860,del,NA19385,0,,213
22,48931370,48931606,del,HG00310,0,,236
22,22136849,22139967,del,HG00131,0,,3118
22,34210447,34212641,del,NA18548,0,,2194
22,22734364,22785460,del,NA19332,0,,51096
22,28186616,28200022,del,NA19443,0,,13406
22,39357612,39387558,del,HG00701,0,,29946
22,31038794,31040527,del,NA19704,0,,1733
22,37437407,37443515,del,NA20760,0,,6108
22,50499174,50499260,del,HG01173,0,,86
22,36820567,36821273,del,HG01083,0,,706
22,20149734,20150492,del,HG01378,0,,758
22,33787060,33787974,del,HG01047,0,,914
22,42934859,42935946,del,HG01055,0,,1087
22,31776416,31780625,del,HG00653,0,,4209
22,37744388,37750028,del,NA11918,0,,5640
22,17770616,17779622,del,HG01516,0,,9006
22,41637832,41639747,del,NA19452,0,,1915
22,39426436,39446528,del,NA19678,0,,20092
22,44412804,44414816,del,NA19379,0,,2012
22,45865465,45868972,del,NA18621,0,,3507
22,50975828,50976604,del,NA12154,0,,776
22,20426816,20488422,del,NA20348,0,,61606
22,30684275,30684600,del,NA19238,0,,325
22,23053716,23242072,del,HG00683,0,,188356
22,45135251,45137536,del,NA18505,0,,2285
22,39722259,39723438,del,NA19788,0,,1179
22,40393540,40397279,del,HG00736,0,,3739
22,32798548,32798688,del,NA19393,0,,140
22,42745313,42746255,del,NA19439,0,,942
22,24343416,24397872,del,NA11918,0,,54456
22,24274216,24292522,del,HG00114,0,,18306
22,19173129,19174373,del,HG00662,0,,1244
22,43601477,43601805,del,HG00343,0,,328
22,45453726,45454924,del,NA19072,0,,1198
22,42934794,42935918,del,NA19720,0,,1124
22,43676409,43676508,del,HG01083,0,,99
22,18880725,18882127,del,NA20508,0,,1402
22,40935367,40935558,del,HG00344,0,,191
22,22440288,22440448,del,NA19318,0,,160
22,47383090,47384885,del,HG00475,0,,1795
22,17940027,17944693,del,NA18940,0,,4666
22,29892198,29895732,del,HG00143,0,,3534
22,41090940,41095418,del,NA19082,0,,4478
22,48627388,48629964,del,NA19004,0,,2576
22,36571864,36575258,del,NA19375,0,,3394
22,45624557,45624890,del,HG00276,0,,333
22,49218179,49218280,del,NA12154,0,,101
22,43595120,43595744,del,HG00366,0,,624
22,44702220,44702506,del,NA18959,0,,286
22,47689106,47689575,del,NA18986,0,,469
22,23478353,23479484,del,HG01465,0,,1131
22,48656907,48656968,del,HG00159,0,,61
22,19571618,19573101,del,NA19908,0,,1483
22,35834164,35834660,del,NA18613,0,,496
22,16942666,16945822,del,NA19398,0,,3156
22,23878654,23880331,del,NA19430,0,,1677
22,33780447,33783338,del,NA12749,0,,2891
22,23016675,23082209,del,NA18543,0,,65534
22,21045917,21638769,del,HG00690,0,,592852
22,21867216,21908922,del,HG01351,0,,41706
22,20965262,20966021,del,NA19332,0,,759
22,21812716,21906022,del,NA20775,0,,93306
22,20212568,20212772,del,NA19383,0,,204
22,47781989,47782204,del,NA18952,0,,215
22,33767864,33769717,del,HG00268,0,,1853
22,44380711,44382121,del,NA19377,0,,1410
22,45443353,45445200,del,NA19107,0,,1847
22,39044362,39044727,del,NA12777,0,,365
22,49401387,49401484,del,HG00613,0,,97
22,22069948,22070130,del,NA18576,0,,182
22,23051091,23109280,del,HG00452,0,,58189
22,19099930,19100625,del,HG00143,0,,695
22,24314616,24335522,del,NA19717,0,,20906
22,43895428,43896241,del,HG00557,0,,813
22,17332943,17336780,del,NA19452,0,,3837
22,24876427,24877004,del,NA19462,0,,577
22,40794223,40795242,del,NA18576,0,,1019
22,32403871,32405128,del,NA19350,0,,1257
22,16050654,16063474,dup,HG02505,0,,12820
22,16877183,16965103,dup,HG00099,0,,87920
22,17006397,17022734,dup,HG00244,0,,16337
22,17034911,17076240,dup,HG00099,0,,41329
22,17071709,17306387,dup,HG00099,0,,234678
22,17276394,17348278,dup,HG01679,0,,71884
22,17377832,17395846,dup,NA18516,0,,18014
22,17387545,17417391,dup,HG01857,0,,29846
22,17420222,17604595,dup,HG02728,0,,184373
22,17550215,17623651,dup,HG02728,0,,73436
22,17632719,17745882,dup,HG01277,0,,113163
22,17655140,17688684,dup,HG03777,0,,33544
22,17709097,17724432,dup,HG03777,0,,15335
22,17737812,17742002,dup,HG01097,0,,4190
22,18585621,18591936,dup,HG01167,0,,6315
22,18621084,18625698,dup,HG00323,0,,4614
22,18912157,18998999,dup,HG00121,0,,86842
22,19015177,19088691,dup,NA20519,0,,73514
22,19030334,19103057,dup,HG00141,0,,72723
22,19323132,19355759,dup,HG01808,0,,32627
22,19531786,19559055,dup,NA19066,0,,27269
22,19531786,19666087,dup,HG00141,0,,134301
22,19707371,19866503,dup,HG00141,0,,159132
22,19889064,19950337,dup,HG00141,0,,61273
22,19973106,20124645,dup,HG00141,0,,151539
22,20262390,20299762,dup,HG00629,0,,37372
22,20746552,20846353,dup,HG00141,0,,99801
22,20747116,20782223,dup,NA12286,0,,35107
22,21078735,21159481,dup,HG02013,0,,80746
22,21256865,21435776,dup,HG02013,0,,178911
22,21444160,21457208,dup,HG01204,0,,13048
22,21455959,21464881,dup,HG02013,0,,8922
22,21808907,21812425,dup,HG00138,0,,3518
22,21922213,21966122,dup,HG02230,0,,43909
22,22310331,22469324,dup,HG00557,0,,158993
22,22315316,22360270,dup,HG00158,0,,44954
22,22358231,22402268,dup,HG00158,0,,44037
22,22411640,22442279,dup,HG00158,0,,30639
22,22456175,22522735,dup,HG00158,0,,66560
22,22509675,22558469,dup,HG00158,0,,48794
22,22550526,22581385,dup,HG00158,0,,30859
22,22582636,22686278,dup,HG00177,0,,103642
22,22677670,22707105,dup,HG00177,0,,29435
22,22716056,22738454,dup,HG00326,0,,22398
22,23250546,23262513,dup,HG00596,0,,11967
22,23263373,23427317,dup,HG01486,0,,163944
22,23440148,23657220,dup,HG01486,0,,217072
22,23521496,23650848,dup,HG01486,0,,129352
22,23821657,23867303,dup,HG03228,0,,45646
22,23854830,23897278,dup,HG03681,0,,42448
22,23920376,23979957,dup,HG00326,0,,59581
22,24326713,24333476,dup,HG00096,0,,6763
22,24335181,24340851,dup,HG01312,0,,5670
22,24345244,24391524,dup,HG00099,0,,46280
22,24606823,24612931,dup,NA19360,0,,6108
22,24923840,24932780,dup,HG00117,0,,8940
22,25318690,25381553,dup,HG01134,0,,62863
22,25635334,25647653,dup,HG02694,0,,12319
22,25659945,25710725,dup,HG00160,0,,50780
22,25703077,25784925,dup,HG00160,0,,81848
22,25719881,25917653,dup,HG00160,0,,197772
22,25805053,25834695,dup,HG00160,0,,29642
22,25825377,25844076,dup,HG00160,0,,18699
22,25846677,25921876,dup,HG00160,0,,75199
22,25928083,25977455,dup,HG01281,0,,49372
22,25994364,26098938,dup,HG04090,0,,104574
22,27408610,27415111,dup,HG02230,0,,6501
22,28565661,28600336,dup,HG03742,0,,34675
22,29114293,29125290,dup,HG01872,0,,10997
22,29761399,29817394,dup,HG01889,0,,55995
22,29765907,29797263,dup,HG01889,0,,31356
22,29769794,29818604,dup,HG01889,0,,48810
22,29873597,29939941,dup,HG03575,0,,66344
22,29902388,29921746,dup,HG03575,0,,19358
22,29941011,29967552,dup,NA18549,0,,26541
22,30456542,30462376,dup,HG02654,0,,5834
22,31095016,31101737,dup,HG01305,0,,6721
22,31233424,31321640,dup,HG03777,0,,88216
22,31251300,31280203,dup,NA18640,0,,28903
22,31274552,31286178,dup,HG03777,0,,11626
22,31414715,31429344,dup,HG01414,0,,14629
22,31776449,31780070,dup,HG00096,0,,3621
22,32365881,32547330,dup,HG02660,0,,181449
22,32400579,32449506,dup,HG02660,0,,48927
22,33464604,33477017,dup,HG03716,0,,12413
22,33717492,33729559,dup,HG03352,0,,12067
22,35753538,35762497,dup,HG02012,0,,8959
22,36073315,36077871,dup,NA18924,0,,4556
22,36455241,36467161,dup,HG02139,0,,11920
22,36620597,36704301,dup,HG02284,0,,83704
22,37256225,37262844,dup,HG02401,0,,6619
22,38415477,38430349,dup,HG02429,0,,14872
22,38846291,38870769,dup,HG01971,0,,24478
22,39038804,39050019,dup,HG00282,0,,11215
22,39359355,39379392,dup,HG00101,0,,20037
22,39393528,39446435,dup,HG02343,0,,52907
22,39400682,39425345,dup,HG02343,0,,24663
22,39427595,39450999,dup,NA19655,0,,23404
22,39600248,39682747,dup,NA20809,0,,82499
22,41596794,41602796,dup,HG02549,0,,6002
22,41907658,41939258,dup,NA19984,0,,31600
22,41970231,41989229,dup,NA07357,0,,18998
22,42523949,42533891,dup,HG00099,0,,9942
22,42781186,42902416,dup,HG01374,0,,121230
22,42791480,42809700,dup,HG01374,0,,18220
22,42854962,42871597,dup,HG01374,0,,16635
22,42878561,42892550,dup,NA18537,0,,13989
22,42906659,42934146,dup,HG01142,0,,27487
22,42955531,42973821,dup,HG00146,0,,18290
22,43298399,43426911,dup,HG02013,0,,128512
22,43298418,43357059,dup,HG02013,0,,58641
22,43394626,43414302,dup,HG02013,0,,19676
22,43421662,43424872,dup,HG00112,0,,3210
22,43581471,43691594,dup,HG02013,0,,110123
22,43581981,43691098,dup,HG02013,0,,109117
22,44075282,44080531,dup,HG00137,0,,5249
22,44649781,44653331,dup,NA19074,0,,3550
22,45643462,45913042,dup,NA18980,0,,269580
22,45649045,45692446,dup,NA18980,0,,43401
22,45696886,45726460,dup,NA12005,0,,29574
22,45701149,45721711,dup,NA12005,0,,20562
22,45778231,45913481,dup,NA18980,0,,135250
22,45813915,45880344,dup,NA18980,0,,66429
22,47898974,47923380,dup,HG01802,0,,24406
22,48221179,48236113,dup,HG02284,0,,14934
22,48625042,48628049,dup,HG01705,0,,3007
22,48830541,48877617,dup,NA21130,0,,47076
22,49352882,49360215,dup,HG02012,0,,7333
22,49357118,49389483,dup,HG03953,0,,32365
22,49389850,50002818,dup,NA20544,0,,612968
22,49393217,49410046,dup,HG03953,0,,16829
22,49401061,49500765,dup,HG00120,0,,99704
22,49417900,49571131,dup,NA20544,0,,153231
22,49508626,49909251,dup,NA20544,0,,400625
22,49584402,49590787,dup,HG03736,0,,6385
22,49589927,49627592,dup,NA20544,0,,37665
22,49816213,49861982,dup,HG03378,0,,45769
22,49826428,49877915,dup,HG00313,0,,51487
22,49864651,49908464,dup,HG00313,0,,43813
22,49910965,49955441,dup,NA20544,0,,44476
22,49916048,50006932,dup,NA20544,0,,90884
22,49958358,50000624,dup,NA20544,0,,42266
22,50001875,50035031,dup,NA18531,0,,33156
22,50451910,50462960,dup,HG00099,0,,11050
22,50502466,50507020,dup,HG01918,0,,4554
22,51066406,51078951,dup,HG00536,0,,12545
X,91678133,91680093,del,HG00190,0,,1960
X,3687475,3703345,del,NA19474,0,,15870
X,117376113,117378670,del,NA19247,0,,2557
X,69731916,69735272,del,NA20278,0,,3356
X,91013316,91074922,del,HG00683,0,,61606
X,544902,545075,del,NA18562,0,,173
X,73166062,73169812,del,NA19982,0,,3750
X,30819799,30823722,del,HG00448,0,,3923
X,907907,908005,del,HG00463,0,,98
X,79316082,79324595,del,NA12058,0,,8513
X,120975081,120978889,del,HG01108,0,,3808
X,118495846,118495923,del,NA19404,0,,77
X,128661068,128665603,del,HG01171,0,,4535
X,142605362,142803905,del,NA19455,0,,198543
X,3703491,3718675,del,NA18501,0,,15184
X,151079816,151089022,del,HG01378,0,,9206
X,1475494,1476383,del,NA18638,0,,889
X,73172802,73176731,del,NA19789,0,,3929
X,64005085,64062216,del,NA18526,0,,57131
X,1406551,1406850,del,HG00614,0,,299
X,124678024,124689473,del,NA19834,0,,11449
X,35901519,35903408,del,HG00683,0,,1889
X,152105360,152107482,del,HG00177,0,,2122
X,39635868,39636080,del,HG00325,0,,212
X,81395629,81415632,del,NA19712,0,,20003
X,29600454,29601929,del,NA19469,0,,1475
X,99810509,99811068,del,NA19773,0,,559
X,7167708,7168924,del,HG00284,0,,1216
X,142181980,142182080,del,NA11830,0,,100
X,154871356,155188099,del,NA19078,0,,316743
X,131939431,131941542,del,NA10847,0,,2111
X,2608685,2608878,del,NA19102,0,,193
X,19465894,19469295,del,HG00338,0,,3401
X,5159472,5164205,del,NA20521,0,,4733
X,53478159,53491616,del,NA19700,0,,13457
X,155040811,155047717,del,NA18618,0,,6906
X,562494,562758,del,HG01522,0,,264
X,52128316,52185322,del,NA20525,0,,57006
X,46687651,46688877,del,NA20521,0,,1226
X,67080355,67081959,del,HG00614,0,,1604
X,1715343,1715785,del,NA19455,0,,442
X,124115707,124116136,del,NA19082,0,,429
X,90410923,90435967,del,NA12830,0,,25044
X,484814,485317,del,NA19235,0,,503
X,43017620,43017782,del,NA18557,0,,162
X,154918460,154921725,del,NA19247,0,,3265
X,97167898,97168303,del,NA19438,0,,405
X,69007271,69046679,del,HG01455,0,,39408
X,143656976,143659478,del,NA19430,0,,2502
X,118870655,118870910,del,HG00512,0,,255
X,61841972,61906201,del,HG00109,0,,64229
X,148686978,148687238,del,HG01204,0,,260
X,55702379,55709806,del,HG00247,0,,7427
X,130377774,130378654,del,NA18963,0,,880
X,2458456,2459476,del,HG00611,0,,1020
X,82484832,82487030,del,HG00345,0,,2198
X,207441,207627,del,NA19114,0,,186
X,56668616,56672622,del,NA19257,0,,4006
X,1759442,1761306,del,NA19682,0,,1864
X,26363158,26366299,del,NA19921,0,,3141
X,115182240,115183330,del,HG00346,0,,1090
X,37031516,37034672,del,NA19223,0,,3156
X,138420673,138435945,del,NA19657,0,,15272
X,21357602,21361239,del,NA19391,0,,3637
X,27714812,27716193,del,NA19114,0,,1381
X,41343735,41345818,del,HG00173,0,,2083
X,2183988,2184469,del,HG01082,0,,481
X,48091695,48093073,del,NA19704,0,,1378
X,2917567,2921522,del,NA18559,0,,3955
X,108573603,108575292,del,NA19439,0,,1689
X,56660987,56672834,del,NA19443,0,,11847
X,148803869,148831820,del,NA19700,0,,27951
X,154790189,154803312,del,NA19682,0,,13123
X,150342716,150347822,del,HG00626,0,,5106
X,119597586,119597812,del,NA19172,0,,226
X,1376573,1381108,del,NA19707,0,,4535
X,53866095,53872780,del,HG00119,0,,6685
X,70141052,70141314,del,NA12751,0,,262
X,80023642,80027790,del,NA18635,0,,4148
X,81944174,81946350,del,NA12154,0,,2176
X,938098,939044,del,HG00628,0,,946
X,2292512,2294769,del,NA18520,0,,2257
X,85605171,85609863,del,NA19722,0,,4692
X,398366,399722,del,HG00377,0,,1356
X,146169503,146169738,del,NA19779,0,,235
X,2003467,2003806,del,NA19197,0,,339
X,64842922,64844504,del,NA19428,0,,1582
X,111619968,111621779,del,NA19003,0,,1811
X,38584363,38588493,del,HG00590,0,,4130
X,92309533,92359059,del,NA19247,0,,49526
X,128320552,128327497,del,HG00171,0,,6945
X,575814,576862,del,HG00651,0,,1048
X,152104031,152107443,del,NA19312,0,,3412
X,65113961,65114415,del,NA19900,0,,454
X,543035,544414,del,NA19456,0,,1379
X,61806074,61909173,del,NA06986,0,,103099
X,864400,865149,del,NA19774,0,,749
X,124234144,124236300,del,NA19346,0,,2156
X,37002823,37003034,del,NA19434,0,,211
X,105191156,105191459,del,HG00253,0,,303
X,30347765,30348598,del,HG00619,0,,833
X,351614,353260,del,HG00250,0,,1646
X,2277547,2278452,del,HG00657,0,,905
X,154387129,154409528,del,HG00337,0,,22399
X,114052783,114056657,del,NA19376,0,,3874
X,88240736,88242657,del,NA20806,0,,1921
X,102277915,102283658,del,HG01465,0,,5743
X,24254920,24256689,del,HG00448,0,,1769
X,8171207,8179570,del,NA19190,0,,8363
X,126901453,126909590,del,NA19652,0,,8137
X,122195025,122195454,del,HG00525,0,,429
X,1612113,1622720,del,HG01377,0,,10607
X,29003032,29009488,del,HG00607,0,,6456
X,102856693,102858705,del,HG01170,0,,2012
X,19127108,19135856,del,HG00244,0,,8748
X,24016166,24021872,del,HG00524,0,,5706
X,145840655,145840769,del,NA19129,0,,114
X,91610716,91620422,del,NA18908,0,,9706
X,66456730,66457691,del,HG00268,0,,961
X,95050847,95051480,del,NA20766,0,,633
X,92866395,92874808,del,HG00427,0,,8413
X,113174380,113174460,del,NA19257,0,,80
X,83907487,83908904,del,HG00243,0,,1417
X,1256073,1256488,del,HG01359,0,,415
X,31823805,31827991,del,HG00637,0,,4186
X,6920112,6936607,del,NA19921,0,,16495
X,154778122,154782570,del,NA19467,0,,4448
X,3185861,3187978,del,HG01173,0,,2117
X,58165657,58200352,del,HG00607,0,,34695
X,146843673,146849144,del,NA18520,0,,5471
X,63044086,63051015,del,HG01188,0,,6929
X,132658157,132663232,del,NA20812,0,,5075
X,377387,378793,del,NA19461,0,,1406
X,28299164,28300549,del,HG00267,0,,1385
X,1735094,1735736,del,HG00176,0,,642
X,16412274,16420717,del,HG01197,0,,8443
X,62116727,62137690,del,NA18595,0,,20963
X,136507016,136511422,del,NA19466,0,,4406
X,77121385,77123866,del,HG00151,0,,2481
X,780549,828092,del,HG01070,0,,47543
X,31155797,31157805,del,NA18874,0,,2008
X,89893314,89911715,del,NA12775,0,,18401
X,119643311,119643624,del,NA11931,0,,313
X,1472137,1472788,del,NA19818,0,,651
X,44300666,44305522,del,HG00404,0,,4856
X,77696852,77697450,del,HG01183,0,,598
X,139495069,139512383,del,NA19070,0,,17314
X,129025772,129027926,del,HG01390,0,,2154
X,33709835,33710035,del,HG00239,0,,200
X,31577450,31577914,del,HG00153,0,,464
X,18118516,18120975,del,NA18544,0,,2459
X,87610573,87611893,del,NA19904,0,,1320
X,493721,495220,del,NA20795,0,,1499
X,134532211,134535437,del,HG00578,0,,3226
X,20886934,20887286,del,HG00250,0,,352
X,91750748,91751772,del,NA19835,0,,1024
X,13857195,13863363,del,NA19917,0,,6168
X,81173732,81175918,del,NA18511,0,,2186
X,105807021,105807807,del,NA18908,0,,786
X,149938147,149938260,del,HG00501,0,,113
X,53135086,53137118,del,HG01366,0,,2032
X,66993475,66994019,del,HG00436,0,,544
X,691135,691380,del,HG00373,0,,245
X,44611738,44613686,del,NA20291,0,,1948
X,1385764,1385916,del,HG00271,0,,152
X,14797763,14799408,del,NA19172,0,,1645
X,1726710,1727855,del,NA18612,0,,1145
X,2694429,2808824,del,HG01136,0,,114395
X,33712819,33713227,del,NA18609,0,,408
X,97811557,97812870,del,NA19376,0,,1313
X,114670492,114670787,del,NA18498,0,,295
X,125850348,125852889,del,NA18486,0,,2541
X,87743057,87743353,del,HG00536,0,,296
X,154876452,154880898,del,HG01140,0,,4446
X,1521499,1521608,del,NA18534,0,,109
X,122372559,122373412,del,HG01188,0,,853
X,64085335,64097513,del,NA19722,0,,12178
X,56945448,56956847,del,NA19701,0,,11399
X,1757534,1761277,del,HG00638,0,,3743
X,143406976,143409978,del,NA20787,0,,3002
X,5361807,5363095,del,NA19704,0,,1288
X,67123829,67130298,del,HG00174,0,,6469
X,154917866,154922072,del,HG00239,0,,4206
X,118873967,118876560,del,HG00684,0,,2593
X,123787786,123789058,del,HG00589,0,,1272
X,981953,982464,del,NA19375,0,,511
X,42204464,42207960,del,NA19440,0,,3496
X,99510818,99512781,del,HG00177,0,,1963
X,35714098,35716003,del,NA12155,0,,1905
X,6032494,6035532,del,HG01108,0,,3038
X,133394232,133397201,del,NA19383,0,,2969
X,3034381,3034582,del,NA18553,0,,201
X,86089567,86090434,del,HG00662,0,,867
X,1592455,1593344,del,HG00663,0,,889
X,130269666,130272522,del,NA18856,0,,2856
X,743690,746402,del,NA20533,0,,2712
X,116954964,116955287,del,HG00736,0,,323
X,145943159,145943949,del,NA18532,0,,790
X,18278801,18280888,del,HG01052,0,,2087
X,2372072,2377653,del,HG01461,0,,5581
X,71809393,71890901,del,NA18615,0,,81508
X,1722576,1722965,del,HG01124,0,,389
X,103608573,103610563,del,NA19379,0,,1990
X,120976066,120977922,del,NA19834,0,,1856
X,908405,908572,del,NA18561,0,,167
X,462682,463269,del,NA19404,0,,587
X,142602573,142801113,del,NA19360,0,,198540
X,3606224,3606641,del,NA18571,0,,417
X,46355276,46356710,del,NA19083,0,,1434
X,562416,562708,del,HG01055,0,,292
X,2515304,2516419,del,HG00593,0,,1115
X,2300653,2300751,del,NA18550,0,,98
X,1465504,1466339,del,NA19316,0,,835
X,90660183,90661716,del,NA19438,0,,1533
X,108455810,108455932,del,HG00111,0,,122
X,100566256,100567593,del,HG00319,0,,1337
X,195240,198344,del,NA18634,0,,3104
X,43122178,43125657,del,HG00150,0,,3479
X,2190014,2191166,del,NA19712,0,,1152
X,64166277,64166630,del,NA19385,0,,353
X,69303061,69303273,del,HG01384,0,,212
X,399278,399896,del,NA18559,0,,618
X,65020883,65044068,del,HG00369,0,,23185
X,79222117,79222290,del,HG01067,0,,173
X,30811277,30817978,del,HG00273,0,,6701
X,115137998,115152944,del,NA18628,0,,14946
X,128375484,128378777,del,NA19704,0,,3293
X,604213,604624,del,NA19716,0,,411
X,61736268,61914770,del,NA18557,0,,178502
X,51551885,51553362,del,NA18635,0,,1477
X,40092207,40094833,del,NA18566,0,,2626
X,47329149,47335632,del,HG00312,0,,6483
X,34042990,34072850,del,HG01069,0,,29860
X,1447518,1447634,del,HG01350,0,,116
X,151087521,151088185,del,NA18605,0,,664
X,34476844,34964400,del,NA18577,0,,487556
X,32839087,32839570,del,NA18615,0,,483
X,141476514,142440592,del,HG01140,0,,964078
X,47829456,47834248,del,HG01357,0,,4792
X,81061416,81067322,del,HG01365,0,,5906
X,1722576,1722961,del,NA18534,0,,385
X,137364742,137365191,del,NA19700,0,,449
X,154632071,154645943,del,NA18983,0,,13872
X,1666859,1667462,del,NA18868,0,,603
X,865047,865452,del,NA18579,0,,405
X,155034296,155212797,del,NA19648,0,,178501
X,131744897,131745326,del,NA19761,0,,429
X,2382452,2382552,del,HG00473,0,,100
X,97096366,97104372,del,HG00626,0,,8006
X,120798257,120814236,del,NA19703,0,,15979
X,66333799,66333972,del,HG01359,0,,173
X,24101440,24101811,del,NA18557,0,,371
X,126330224,126331256,del,HG01137,0,,1032
X,153635087,153636305,del,NA18988,0,,1218
X,80810631,80810792,del,HG00443,0,,161
X,12434250,12436813,del,NA18960,0,,2563
X,32701679,32702581,del,NA18984,0,,902
X,1614350,1614820,del,NA12750,0,,470
X,98617523,98620591,del,NA18867,0,,3068
X,652896,653218,del,HG01437,0,,322
X,145052106,145055135,del,HG01177,0,,3029
X,44336405,44341667,del,HG00464,0,,5262
X,86286771,86287224,del,NA19153,0,,453
X,3258079,3258154,del,NA18858,0,,75
X,112443810,112444463,del,NA12383,0,,653
X,154781180,154785913,del,NA19371,0,,4733
X,28520776,28526020,del,NA19060,0,,5244
X,1922932,1926679,del,NA18505,0,,3747
X,377642,378700,del,NA18873,0,,1058
X,146523840,146524384,del,NA19312,0,,544
X,36743043,36743359,del,NA12890,0,,316
X,120588419,120589318,del,NA18624,0,,899
X,133347721,133352260,del,NA12778,0,,4539
X,30021262,30023167,del,HG00150,0,,1905
X,45231335,45231553,del,NA18564,0,,218
X,27923211,27923534,del,NA19373,0,,323
X,62225354,62256435,del,HG01491,0,,31081
X,1728608,1729405,del,NA19467,0,,797
X,40932118,40932788,del,HG00734,0,,670
X,538569,538869,del,NA18861,0,,300
X,1793127,1796181,del,HG01356,0,,3054
X,88300590,88308135,del,HG00328,0,,7545
X,70137366,70139923,del,HG00261,0,,2557
X,114286666,114288925,del,NA18535,0,,2259
X,113227852,113232258,del,NA19197,0,,4406
X,1257175,1257803,del,HG00375,0,,628
X,136719388,136722925,del,NA19383,0,,3537
X,152907416,152909722,del,NA19786,0,,2306
X,127142224,127241736,del,NA18615,0,,99512
X,79448616,79450722,del,NA18637,0,,2106
X,116720718,116722795,del,NA18599,0,,2077
X,150343316,150347822,del,HG01197,0,,4506
X,95099750,95100085,del,NA18536,0,,335
X,93400914,93404721,del,NA18870,0,,3807
X,666096,666385,del,NA19102,0,,289
X,1487668,1545113,del,HG01441,0,,57445
X,1730462,1730864,del,HG01072,0,,402
X,84096000,84097901,del,HG00436,0,,1901
X,114828565,114829175,del,HG01073,0,,610
X,13122201,13125915,del,NA19385,0,,3714
X,1243069,1244113,del,NA19213,0,,1044
X,83856936,83864196,del,NA19375,0,,7260
X,94632507,94632836,del,NA19190,0,,329
X,56981600,56982173,del,NA18988,0,,573
X,7579210,7601962,del,NA19471,0,,22752
X,120625192,120654104,del,NA20771,0,,28912
X,114542016,114544322,del,NA20766,0,,2306
X,25614996,25616926,del,HG00366,0,,1930
X,820704,824551,del,HG01461,0,,3847
X,114765012,114765207,del,HG01187,0,,195
X,109938601,109942139,del,NA19147,0,,3538
X,16472177,16479250,del,NA19093,0,,7073
X,286989,287549,del,NA18519,0,,560
X,83796714,83796959,del,NA19660,0,,245
X,2136999,2138601,del,NA20533,0,,1602
X,1570045,1570686,del,NA19776,0,,641
X,37066416,37067622,del,NA18908,0,,1206
X,1698676,1699048,del,NA19834,0,,372
X,42512288,42513870,del,NA19085,0,,1582
X,77516010,77524088,del,NA19818,0,,8078
X,3677296,3677423,del,HG01073,0,,127
X,90074116,90089022,del,NA19198,0,,14906
X,130778582,130793458,del,NA18951,0,,14876
X,105204387,105208424,del,NA19916,0,,4037
X,89019116,89065822,del,NA18917,0,,46706
X,33209496,33216252,del,NA19130,0,,6756
X,100420029,100421558,del,HG00584,0,,1529
X,61988569,62000084,del,HG00256,0,,11515
X,45289031,45292827,del,NA19083,0,,3796
X,145221982,145237531,del,HG00310,0,,15549
X,48500504,48502929,del,NA19373,0,,2425
X,1593197,1593389,del,HG00654,0,,192
X,146849495,146849811,del,NA19332,0,,316
X,105938330,105949852,del,NA19428,0,,11522
X,22947842,22996982,del,NA18988,0,,49140
X,31081414,31085088,del,NA19908,0,,3674
X,400466,400582,del,HG00699,0,,116
X,463037,463382,del,NA18504,0,,345
X,32987322,32989079,del,NA20332,0,,1757
X,155090043,155092216,del,NA18870,0,,2173
X,3083395,3083485,del,NA18489,0,,90
X,109981864,109984464,del,NA19009,0,,2600
X,1525543,1526084,del,NA19818,0,,541
X,2549151,2550446,del,HG00650,0,,1295
X,137990190,137990305,del,NA06986,0,,115
X,70122989,70123930,del,HG00473,0,,941
X,97063520,97064190,del,HG00239,0,,670
X,122316014,122316576,del,HG00160,0,,562
X,1439035,1439984,del,NA20518,0,,949
X,1858513,1858845,del,NA20758,0,,332
X,108353215,108357410,del,NA19474,0,,4195
X,422341,423030,del,HG00551,0,,689
X,58554308,58554628,del,NA19383,0,,320
X,442350,442476,del,NA18934,0,,126
X,113319218,113323146,del,NA19446,0,,3928
X,16800316,16805722,del,HG00500,0,,5406
X,87796120,87798097,del,NA18989,0,,1977
X,19374800,19374936,del,NA19209,0,,136
X,35627442,35634396,del,NA18873,0,,6954
X,81042499,81043079,del,HG00155,0,,580
X,139494682,139503038,del,NA12889,0,,8356
X,47656620,47656856,del,HG00628,0,,236
X,130546262,130547815,del,HG01461,0,,1553
X,371093,375226,del,HG01061,0,,4133
X,30249316,30252272,del,NA19328,0,,2956
X,120774098,120776497,del,HG00268,0,,2399
X,78590426,78590497,del,NA12891,0,,71
X,1210511,1211232,del,NA20792,0,,721
X,3294916,3295541,del,HG00150,0,,625
X,135299196,135302137,del,HG00367,0,,2941
X,44475697,44479904,del,NA18635,0,,4207
X,30810083,30819152,del,HG01149,0,,9069
X,78979150,78988896,del,NA18949,0,,9746
X,101304530,101307043,del,NA19067,0,,2513
X,80748601,80780555,del,NA19908,0,,31954
X,151141009,151141400,del,NA19444,0,,391
X,125998650,126118683,del,HG00278,0,,120033
X,32721084,32810360,del,NA19700,0,,89276
X,1910862,1914719,del,NA18634,0,,3857
X,27037894,27038847,del,NA19376,0,,953
X,33838815,33843252,del,NA19474,0,,4437
X,92721976,92723847,del,NA19384,0,,1871
X,5653348,5654453,del,NA18635,0,,1105
X,67823825,67957816,del,NA19397,0,,133991
X,367479,368657,del,HG00589,0,,1178
X,2365697,2388064,del,NA19434,0,,22367
X,89337507,89338712,del,HG01377,0,,1205
X,90283359,90284088,del,NA18563,0,,729
X,94642315,94651587,del,NA19434,0,,9272
X,95312866,95318722,del,HG00734,0,,5856
X,1749130,1752635,del,HG00553,0,,3505
X,2434777,2435590,del,HG00651,0,,813
X,32644436,32645660,del,NA19324,0,,1224
X,4233775,4234934,del,NA18943,0,,1159
X,640680,641050,del,HG00278,0,,370
X,150268163,150270788,del,NA18557,0,,2625
X,15430608,15430810,del,NA18557,0,,202
X,43944831,43947161,del,NA19835,0,,2330
X,110807779,110808193,del,NA19213,0,,414
X,117473411,117473947,del,HG00418,0,,536
X,38752398,38755003,del,NA19383,0,,2605
X,81982363,81988115,del,HG00233,0,,5752
X,6744792,6828790,del,HG00274,0,,83998
X,86279051,86280136,del,NA19172,0,,1085
X,112788553,112788681,del,NA18517,0,,128
X,146425312,146426878,del,NA19376,0,,1566
X,154781815,154787621,del,NA20754,0,,5806
X,1526961,1529166,del,NA18624,0,,2205
X,378319,384621,del,NA19657,0,,6302
X,44379867,44381396,del,HG00151,0,,1529
X,122972809,122973684,del,HG00565,0,,875
X,93245050,93248285,del,HG00274,0,,3235
X,130005238,130016968,del,NA18550,0,,11730
X,10528860,10531081,del,NA19704,0,,2221
X,46794579,46795664,del,NA19247,0,,1085
X,40271018,40273901,del,NA18535,0,,2883
X,155033270,155213795,del,HG00271,0,,180525
X,1463949,1467064,del,NA18908,0,,3115
X,768948,772429,del,HG01350,0,,3481
X,445916,445822,del,NA18511,0,,-94
X,2037188,2037529,del,HG00143,0,,341
X,1397304,1397657,del,NA07347,0,,353
X,826621,826761,del,NA18633,0,,140
X,104070829,104084776,del,HG00736,0,,13947
X,2694823,2801980,del,NA18487,0,,107157
X,1787740,1788036,del,NA18557,0,,296
X,28219374,28221723,del,HG01048,0,,2349
X,49945278,49946365,del,NA19383,0,,1087
X,28697850,28698600,del,NA19448,0,,750
X,16596947,16602244,del,NA12154,0,,5297
X,24111255,24116694,del,NA20533,0,,5439
X,154762316,154778210,del,NA19661,0,,15894
X,93487046,93488007,del,NA19776,0,,961
X,130825416,130830022,del,NA20514,0,,4606
X,131913706,131914328,del,HG01366,0,,622
X,105581906,105582735,del,HG00403,0,,829
X,721858,721948,del,NA18620,0,,90
X,56456120,56463075,del,NA19318,0,,6955
X,154790160,154790429,del,NA11931,0,,269
X,111866450,111867147,del,HG00707,0,,697
X,146179860,146185796,del,NA20528,0,,5936
X,1944383,1945700,del,NA19057,0,,1317
X,83864379,83864733,del,NA19436,0,,354
X,105477497,105478121,del,NA18633,0,,624
X,154957348,154965499,del,HG01389,0,,8151
X,38386504,38387331,del,NA18574,0,,827
X,1450617,1453624,del,NA20291,0,,3007
X,41214261,41215587,del,HG01190,0,,1326
X,154285430,154285731,del,HG00250,0,,301
X,145399414,145400854,del,NA19914,0,,1440
X,150711380,150712582,del,NA18499,0,,1202
X,1412780,1412966,del,HG00513,0,,186
X,44300466,44305922,del,NA20291,0,,5456
X,47353204,47353738,del,NA19916,0,,534
X,18095024,18096240,del,NA18965,0,,1216
X,87658699,87660934,del,NA19093,0,,2235
X,92394538,92395870,del,NA19720,0,,1332
X,1361683,1362411,del,HG00277,0,,728
X,58301547,58302459,del,NA19347,0,,912
X,134519687,134522292,del,NA19384,0,,2605
X,131089378,131089604,del,NA20765,0,,226
X,69446369,69446731,del,NA19401,0,,362
X,1800415,1801154,del,NA18940,0,,739
X,120788163,120788442,del,NA19436,0,,279
X,143628682,143637761,del,HG01070,0,,9079
X,118343145,118343276,del,HG00683,0,,131
X,35323530,35324104,del,NA19235,0,,574
X,67232282,67246220,del,NA19835,0,,13938
X,80416492,80417431,del,NA18501,0,,939
X,98785813,98787895,del,HG00654,0,,2082
X,44411744,44411881,del,HG00320,0,,137
X,37032866,37034122,del,HG01075,0,,1256
X,48051091,48266899,del,NA20532,0,,215808
X,24877315,24878422,del,HG00336,0,,1107
X,42332630,42334330,del,NA19436,0,,1700
X,626677,627384,del,NA20291,0,,707
X,66531919,66537757,del,HG00531,0,,5838
X,144322629,144323230,del,NA19107,0,,601
X,117976638,117979435,del,HG01108,0,,2797
X,7619464,7679412,del,NA19012,0,,59948
X,69731340,69734182,del,NA20527,0,,2842
X,49381969,49385617,del,HG01497,0,,3648
X,93742968,93743270,del,NA19704,0,,302
X,424375,424540,del,HG00437,0,,165
X,146038210,146041729,del,NA20299,0,,3519
X,9698247,9698417,del,NA19654,0,,170
X,75025963,75142730,del,NA19380,0,,116767
X,84096116,84099272,del,HG00611,0,,3156
X,8964867,8967286,del,HG00559,0,,2419
X,691234,691657,del,HG01134,0,,423
X,102778956,102809126,del,NA11843,0,,30170
X,92796296,92801504,del,NA18505,0,,5208
X,39955616,39960422,del,HG00589,0,,4806
X,493007,495078,del,NA20786,0,,2071
X,98013267,98017809,del,NA18631,0,,4542
X,931751,932107,del,HG00672,0,,356
X,109767452,109767762,del,NA18856,0,,310
X,3629616,3633372,del,NA12489,0,,3756
X,20234557,20234918,del,NA18487,0,,361
X,124991809,124994651,del,HG00339,0,,2842
X,1702809,1704283,del,NA19380,0,,1474
X,153263652,153263877,del,NA19114,0,,225
X,826570,826957,del,NA19455,0,,387
X,129079845,129085348,del,HG00324,0,,5503
X,139045796,139045929,del,NA18633,0,,133
X,79332460,79336694,del,HG00584,0,,4234
X,118411441,118468949,del,NA18638,0,,57508
X,2281521,2281715,del,NA19138,0,,194
X,42995309,43000082,del,NA11933,0,,4773
X,98262789,98266907,del,NA19449,0,,4118
X,19466045,19469515,del,HG00330,0,,3470
X,69731516,69735122,del,NA19439,0,,3606
X,108264721,108265104,del,NA19440,0,,383
X,113348326,113355361,del,HG00262,0,,7035
X,93499055,93500387,del,NA18606,0,,1332
X,100342250,100348586,del,NA18986,0,,6336
X,37031327,37034422,del,NA18499,0,,3095
X,35441715,35445287,del,NA19311,0,,3572
X,120805182,120805692,del,HG00650,0,,510
X,91605710,91607835,del,NA19428,0,,2125
X,71374961,71375516,del,NA18535,0,,555
X,49731187,49733575,del,NA20127,0,,2388
X,91853716,91909622,del,NA19190,0,,55906
X,121780159,121787535,del,NA20322,0,,7376
X,1483264,1487032,del,HG00537,0,,3768
X,78946448,78948836,del,NA19063,0,,2388
X,73194133,73196649,del,NA18964,0,,2516
X,71408896,71416265,del,NA19213,0,,7369
X,127432044,127432524,del,NA18502,0,,480
X,120801690,120932555,del,HG00369,0,,130865
X,111802225,111802357,del,NA18505,0,,132
X,5481796,5496558,del,NA20515,0,,14762
X,122951241,122952850,del,HG00377,0,,1609
X,105353706,105354075,del,NA19462,0,,369
X,222966,223646,del,NA19087,0,,680
X,83857157,83864544,del,NA19436,0,,7387
X,108896833,108902222,del,HG01060,0,,5389
X,22388084,22390197,del,NA19700,0,,2113
X,2901761,2930008,del,HG00369,0,,28247
X,770548,770689,del,NA18530,0,,141
X,449788,450354,del,NA19469,0,,566
X,3606334,3606641,del,HG00626,0,,307
X,2365760,2371100,del,HG00662,0,,5340
X,63329,67312,del,HG00531,0,,3983
X,76030109,76030285,del,NA20505,0,,176
X,1614574,1614820,del,HG01101,0,,246
X,154882104,154893485,del,NA19072,0,,11381
X,8786521,8788882,del,HG00237,0,,2361
X,550665,551221,del,NA19373,0,,556
X,91367535,91368795,del,NA19469,0,,1260
X,63229087,63244159,del,HG00501,0,,15072
X,24184320,24184944,del,NA19375,0,,624
X,33027263,33027468,del,HG00281,0,,205
X,80463067,80464020,del,NA18632,0,,953
X,44299016,44304722,del,NA19750,0,,5706
X,97145661,97151173,del,HG01137,0,,5512
X,4382180,4392028,del,NA19116,0,,9848
X,2382260,2383152,del,NA19087,0,,892
X,650677,650810,del,NA20504,0,,133
X,102808963,102826379,del,NA11892,0,,17416
X,54590985,54592398,del,NA20507,0,,1413
X,150876899,150878498,del,NA19207,0,,1599
X,48127600,48127762,del,NA12546,0,,162
X,129667609,129668883,del,NA11919,0,,1274
X,82484951,82487047,del,HG00345,0,,2096
X,143628516,143637622,del,NA19720,0,,9106
X,150293939,150295715,del,NA10847,0,,1776
X,94698235,94701973,del,NA19114,0,,3738
X,93186811,93187987,del,NA18508,0,,1176
X,131005307,131008705,del,NA19068,0,,3398
X,22672564,22672879,del,NA18579,0,,315
X,122315608,122316146,del,NA19213,0,,538
X,111187108,111189212,del,NA18576,0,,2104
X,96556041,96557266,del,NA18873,0,,1225
X,1260277,1260998,del,HG00698,0,,721
X,69023038,69026246,del,NA19085,0,,3208
X,64240919,64241646,del,NA19379,0,,727
X,88352771,88352871,del,HG01374,0,,100
X,1258111,1258871,del,NA20809,0,,760
X,53996015,53998320,del,NA18560,0,,2305
X,40958146,40958423,del,NA19461,0,,277
X,36475652,36476542,del,NA18858,0,,890
X,24756029,24756359,del,NA19144,0,,330
X,37850770,37854365,del,NA18873,0,,3595
X,61727182,61733806,del,HG00524,0,,6624
X,140476729,140479226,del,HG01191,0,,2497
X,124553818,124554423,del,NA19469,0,,605
X,100678175,100680632,del,HG00436,0,,2457
X,125941754,125943164,del,NA19383,0,,1410
X,91639416,91753922,del,NA18486,0,,114506
X,138122585,138130730,del,NA19463,0,,8145
X,40461258,40461771,del,NA19664,0,,513
X,154798755,154803966,del,NA19235,0,,5211
X,106341711,106342711,del,NA18559,0,,1000
X,503059,503182,del,HG00285,0,,123
X,12491014,12492318,del,NA19457,0,,1304
X,81793016,81801772,del,NA18563,0,,8756
X,82199263,82208287,del,HG01187,0,,9024
X,119375237,119375583,del,NA19012,0,,346
X,129113816,129118322,del,NA19375,0,,4506
X,2253278,2260584,del,HG01491,0,,7306
X,67545616,67547422,del,NA19093,0,,1806
X,62577905,62587853,del,NA18908,0,,9948
X,604346,604652,del,NA19462,0,,306
X,1643430,1643719,del,HG01492,0,,289
X,98810934,98812681,del,NA19056,0,,1747
X,8785935,8788333,del,NA19129,0,,2398
X,105110254,105110464,del,HG00699,0,,210
X,89448582,89496586,del,NA20766,0,,48004
X,1942840,1942998,del,HG00336,0,,158
X,575746,576408,del,NA19256,0,,662
X,90969480,90979029,del,NA19704,0,,9549
X,5736387,5737527,del,NA18574,0,,1140
X,61443,61911,del,NA19661,0,,468
X,45695712,45696017,del,NA18507,0,,305
X,15246407,15247938,del,NA18592,0,,1531
X,29600095,29609040,del,NA18952,0,,8945
X,39440126,39440260,del,NA18605,0,,134
X,23077066,23082845,del,NA18606,0,,5779
X,61709509,61723887,del,HG00113,0,,14378
X,87846316,87846672,del,NA19098,0,,356
X,104389063,104394631,del,NA18487,0,,5568
X,96970327,96986928,del,NA18611,0,,16601
X,724370,725391,del,HG00325,0,,1021
X,32550323,32553819,del,NA19707,0,,3496
X,139493756,139502986,del,HG01191,0,,9230
X,81096640,81102692,del,NA19190,0,,6052
X,30242851,30243073,del,NA18916,0,,222
X,153630779,153630975,del,NA12717,0,,196
X,9958110,9963211,del,NA19438,0,,5101
X,33836666,33841972,del,NA19466,0,,5306
X,367469,367706,del,HG01060,0,,237
X,128500437,128502439,del,HG01366,0,,2002
X,52827916,52833622,del,NA20800,0,,5706
X,47376354,47376980,del,NA18621,0,,626
X,48145247,48145575,del,NA18868,0,,328
X,63819132,63820410,del,NA19469,0,,1278
X,371579,372407,del,HG00108,0,,828
X,401139,401432,del,NA19130,0,,293
X,116454345,116454664,del,NA11993,0,,319
X,99285586,99287078,del,NA19076,0,,1492
X,61867036,61903263,del,NA19471,0,,36227
X,34377189,34377371,del,NA18610,0,,182
X,22492031,22497712,del,NA19338,0,,5681
X,1726647,1732483,del,HG01375,0,,5836
X,1437892,1438934,del,HG00111,0,,1042
X,17637431,17638164,del,NA19207,0,,733
X,110558096,110559334,del,NA19917,0,,1238
X,88557161,88559886,del,NA19240,0,,2725
X,26212268,26212367,del,HG01353,0,,99
X,151759267,151763061,del,NA18985,0,,3794
X,1813304,1813511,del,HG01351,0,,207
X,66103777,66103901,del,HG00464,0,,124
X,61726941,61729833,del,NA19818,0,,2892
X,150707033,150712299,del,NA19446,0,,5266
X,149927930,149928848,del,HG00133,0,,918
X,122950566,122953822,del,NA20278,0,,3256
X,12466544,12483882,del,HG00179,0,,17338
X,81820321,81821003,del,HG00542,0,,682
X,4763162,4776576,del,NA19377,0,,13414
X,2280596,2304379,del,NA18566,0,,23783
X,1911076,1911675,del,NA19780,0,,599
X,1530911,1531457,del,NA18873,0,,546
X,134161502,134162053,del,NA19723,0,,551
X,111994372,111997232,del,NA19467,0,,2860
X,152110324,152201176,del,NA18948,0,,90852
X,44519510,44526670,del,HG00672,0,,7160
X,147509696,147511235,del,HG00436,0,,1539
X,7260179,7260422,del,HG01204,0,,243
X,130529221,130530811,del,HG00449,0,,1590
X,84972814,84973077,del,NA19473,0,,263
X,93167759,93168395,del,NA18907,0,,636
X,89578366,89580380,del,NA20340,0,,2014
X,2450212,2450664,del,HG00123,0,,452
X,53772357,53778316,del,NA19332,0,,5959
X,478080,478348,del,HG00369,0,,268
X,73516927,73518399,del,NA19375,0,,1472
X,80215882,80219424,del,HG01440,0,,3542
X,30559712,30560013,del,NA12045,0,,301
X,53782064,53808307,del,NA19088,0,,26243
X,32919527,32921434,del,NA19404,0,,1907
X,114542483,114544513,del,HG00111,0,,2030
X,1387166,1387355,del,NA18961,0,,189
X,828959,829539,del,NA19679,0,,580
X,27645734,27645867,del,HG00475,0,,133
X,66483146,66484328,del,NA19002,0,,1182
X,31346362,31346890,del,NA19920,0,,528
X,28969266,28973472,del,NA18544,0,,4206
X,142197943,142198062,del,HG00253,0,,119
X,87742017,87742017,dup,HG03058,0,,0
X,119036694,119036694,dup,HG01883,0,,0
X,44365819,44365819,dup,NA19024,0,,0
X,429600,429600,dup,HG00524,0,,0
X,98617505,98617505,dup,HG02256,0,,0
X,75328210,75328210,dup,NA20803,0,,0
X,111133909,111133909,dup,HG01997,0,,0
X,65772935,65772935,dup,HG00233,0,,0
X,19466074,19466074,dup,HG00111,0,,0
X,74457229,74457229,dup,NA12828,0,,0
X,67165589,67165589,dup,HG02274,0,,0
X,71022532,71022532,dup,HG03061,0,,0
X,102256681,102256681,dup,HG01807,0,,0
X,36763991,36763991,dup,HG04200,0,,0
X,848585,848585,dup,HG00689,0,,0
X,121054411,121054411,dup,NA18864,0,,0
X,44058433,44058433,dup,HG01504,0,,0
X,56079069,56079069,dup,HG01768,0,,0
X,66412590,66412590,dup,HG02142,0,,0
X,187604,187604,dup,HG02660,0,,0
X,130760146,130760146,dup,HG00629,0,,0
X,33653319,33653319,dup,HG03882,0,,0
X,140792830,140792830,dup,HG02286,0,,0
X,64905469,64905469,dup,HG04029,0,,0
X,22492009,22492009,dup,NA18489,0,,0
X,134390717,134390717,dup,NA18523,0,,0
X,15664365,15664365,dup,NA18537,0,,0
X,138934761,138934761,dup,HG01798,0,,0
X,134994786,134994786,dup,HG04183,0,,0
X,2238196,2238196,dup,NA18560,0,,0
X,94092792,94092792,dup,NA18617,0,,0
X,120612508,120612508,dup,HG04070,0,,0
X,30501131,30501131,dup,NA20317,0,,0
X,375734,375734,dup,HG04239,0,,0
X,1722626,1722626,dup,HG02053,0,,0
X,138792013,138792013,dup,HG01798,0,,0
X,65806480,65806480,dup,HG00233,0,,0
X,101833724,101833724,dup,HG03894,0,,0
X,134234489,134234489,dup,HG00309,0,,0
X,17246632,17246632,dup,NA18531,0,,0
X,154766103,154766103,dup,HG00378,0,,0
X,93412420,93412420,dup,HG01077,0,,0
X,80213833,80213833,dup,HG01880,0,,0
X,28179426,28179426,dup,HG03731,0,,0
X,1516734,1516734,dup,HG00596,0,,0
X,154658693,154658693,dup,HG00118,0,,0
X,200701,200701,dup,HG02660,0,,0
X,131303138,131303138,dup,NA20761,0,,0
X,47218338,47218338,dup,HG02976,0,,0
X,65067869,65067869,dup,HG02048,0,,0
X,8374863,8374863,dup,HG03817,0,,0
X,56284324,56284324,dup,NA18571,0,,0
X,212044,212044,dup,HG02660,0,,0
X,105462699,105462699,dup,HG03684,0,,0
X,152342861,152342861,dup,HG00581,0,,0
X,1184845,1184845,dup,HG00524,0,,0
X,75301385,75301385,dup,NA20803,0,,0
X,1913882,1913882,dup,NA20507,0,,0
X,44642003,44642003,dup,HG01354,0,,0
X,122114608,122114608,dup,NA19439,0,,0
X,114059856,114059856,dup,HG02278,0,,0
X,319523,319523,dup,HG00736,0,,0
X,89005208,89005208,dup,NA18566,0,,0
X,38590883,38590883,dup,HG00238,0,,0
X,33838634,33838634,dup,HG00732,0,,0
X,154762277,154762277,dup,HG01113,0,,0
X,105543271,105543271,dup,HG03085,0,,0
X,1395340,1395340,dup,HG02127,0,,0
X,134810690,134810690,dup,HG00766,0,,0
X,33599548,33599548,dup,HG03882,0,,0
X,130419609,130419609,dup,HG00629,0,,0
X,140334291,140334291,dup,HG00365,0,,0
X,19283463,19283463,dup,HG02309,0,,0
X,66661663,66661663,dup,HG01359,0,,0
X,93410378,93410378,dup,HG00449,0,,0
X,129570944,129570944,dup,NA20359,0,,0
X,49161314,49161314,dup,NA19346,0,,0
X,82907087,82907087,dup,HG03085,0,,0
X,74480626,74480626,dup,NA12828,0,,0
X,1561002,1561002,dup,HG01377,0,,0
X,14147644,14147644,dup,HG03817,0,,0
X,79318102,79318102,dup,NA12058,0,,0
X,152413932,152413932,dup,HG00581,0,,0
X,105268272,105268272,dup,HG03198,0,,0
X,1974095,1974095,dup,HG00313,0,,0
X,134512154,134512154,dup,HG00584,0,,0
X,63716412,63716412,dup,HG01051,0,,0
X,47862951,47862951,dup,HG00364,0,,0
X,927917,927917,dup,HG04180,0,,0
X,94310595,94310595,dup,HG00410,0,,0
X,65936095,65936095,dup,HG00479,0,,0
X,1986094,1986094,dup,HG00313,0,,0
X,148957595,148957595,dup,HG01770,0,,0
X,134903435,134903435,dup,HG01878,0,,0
X,121946120,121946120,dup,HG00734,0,,0
X,66150902,66150902,dup,HG02484,0,,0
X,1831916,1831916,dup,HG00313,0,,0
X,62294772,62294772,dup,HG02351,0,,0
X,57731363,57731363,dup,HG01342,0,,0
X,69419904,69419904,dup,HG02010,0,,0
X,111667087,111667087,dup,HG02946,0,,0
X,56263746,56263746,dup,NA18571,0,,0
X,62453551,62453551,dup,HG00108,0,,0
X,153820981,153820981,dup,HG00560,0,,0
X,134652695,134652695,dup,HG00584,0,,0
X,75345754,75345754,dup,NA19463,0,,0
X,149240944,149240944,dup,HG01372,0,,0
X,1742003,1742003,dup,HG00313,0,,0
X,19540241,19540241,dup,HG02309,0,,0
X,1214628,1214628,dup,HG00629,0,,0
X,37354638,37354638,dup,HG02696,0,,0
X,999045,999045,dup,HG00157,0,,0
X,1888296,1888296,dup,HG00313,0,,0
X,36591669,36591669,dup,HG04200,0,,0
X,57730485,57730485,dup,HG01051,0,,0
X,56471419,56471419,dup,HG01325,0,,0
X,65777788,65777788,dup,HG00233,0,,0
X,74889445,74889445,dup,HG00237,0,,0
X,347361,347361,dup,HG00736,0,,0
X,14110172,14110172,dup,HG00599,0,,0
X,111711651,111711651,dup,HG00262,0,,0
X,299979,299979,dup,HG00628,0,,0
X,62288913,62288913,dup,NA18627,0,,0
X,154386087,154386087,dup,HG00137,0,,0
X,44388485,44388485,dup,NA18597,0,,0
X,140292652,140292652,dup,HG03457,0,,0
X,904313,904313,dup,HG00157,0,,0
X,37813162,37813162,dup,NA18533,0,,0
X,94603608,94603608,dup,HG00171,0,,0
X,67578264,67578264,dup,HG02009,0,,0
X,48047631,48047631,dup,HG02188,0,,0
X,144365176,144365176,dup,NA20773,0,,0
X,94345404,94345404,dup,HG00344,0,,0
X,128046771,128046771,dup,HG00123,0,,0
X,119033750,119033750,dup,NA19921,0,,0
X,26810528,26810528,dup,HG00250,0,,0
X,2286639,2286639,dup,HG00701,0,,0
X,71064563,71064563,dup,HG03061,0,,0
X,148848506,148848506,dup,HG01770,0,,0
X,63538179,63538179,dup,HG02256,0,,0
X,56495410,56495410,dup,HG01325,0,,0
X,33666126,33666126,dup,NA19834,0,,0
X,134905005,134905005,dup,HG00171,0,,0
X,6172055,6172055,dup,HG03857,0,,0
X,299961,299961,dup,HG00596,0,,0
X,130838636,130838636,dup,HG00629,0,,0
X,470996,470996,dup,HG02053,0,,0
X,384022,384022,dup,HG04239,0,,0
X,106530047,106530047,dup,HG03198,0,,0
X,130489210,130489210,dup,HG03775,0,,0
X,67187590,67187590,dup,HG02274,0,,0
X,53820721,53820721,dup,HG02888,0,,0
X,908109,908109,dup,HG00157,0,,0
X,148579845,148579845,dup,HG00851,0,,0
X,103261177,103261177,dup,HG00096,0,,0
X,113318427,113318427,dup,HG00731,0,,0
X,42747825,42747825,dup,HG00111,0,,0
X,152414940,152414940,dup,HG00581,0,,0
X,118467590,118467590,dup,HG00407,0,,0
X,78863969,78863969,dup,HG01797,0,,0
X,52693577,52693577,dup,HG00693,0,,0
X,16666286,16666286,dup,HG01251,0,,0
X,112436185,112436185,dup,HG02330,0,,0
X,75212778,75212778,dup,HG02784,0,,0
X,55507944,55507944,dup,HG00513,0,,0
X,152103859,152103859,dup,HG00326,0,,0
X,90405133,90405133,dup,HG00323,0,,0
X,130789467,130789467,dup,HG00629,0,,0
X,62205645,62205645,dup,HG01491,0,,0
X,56454806,56454806,dup,HG01248,0,,0
X,42060699,42060699,dup,HG04035,0,,0
X,69462122,69462122,dup,HG00148,0,,0
X,1754859,1754859,dup,HG00313,0,,0
X,23475469,23475469,dup,HG00560,0,,0
X,58009791,58009791,dup,HG02053,0,,0
X,48952964,48952964,dup,NA19017,0,,0
X,22735316,22735316,dup,HG03888,0,,0
X,95180925,95180925,dup,HG02153,0,,0
X,35308066,35308066,dup,HG00253,0,,0
X,129511736,129511736,dup,HG02252,0,,0
X,38584427,38584427,dup,HG00106,0,,0
X,2121282,2121282,dup,HG00537,0,,0
X,48169696,48169696,dup,HG03652,0,,0
X,3484352,3484352,dup,HG03229,0,,0
X,95483886,95483886,dup,HG02756,0,,0
X,152350177,152350177,dup,HG00581,0,,0
X,154119649,154119649,dup,HG03267,0,,0
X,51762707,51762707,dup,NA20502,0,,0
X,113348190,113348190,dup,HG00146,0,,0
X,7501257,7501257,dup,HG01504,0,,0
X,119029253,119029253,dup,NA19921,0,,0
X,134815179,134815179,dup,HG00766,0,,0
X,78927122,78927122,dup,HG01797,0,,0
X,69427429,69427429,dup,NA19761,0,,0
X,10346677,10346677,dup,NA07347,0,,0
X,125103522,125103522,dup,HG02941,0,,0
X,56485624,56485624,dup,HG01325,0,,0
X,10688701,10688701,dup,HG03237,0,,0
X,115935706,115935706,dup,HG00235,0,,0
X,975867,975867,dup,HG00629,0,,0
X,112161029,112161029,dup,HG00458,0,,0
X,62637668,62637668,dup,HG01815,0,,0
X,51784227,51784227,dup,NA19399,0,,0
X,57740875,57740875,dup,HG01051,0,,0
X,62477056,62477056,dup,HG00108,0,,0
X,31531698,31531698,dup,HG00657,0,,0
X,23849563,23849563,dup,HG01131,0,,0
X,64100990,64100990,dup,HG02339,0,,0
X,348975,348975,dup,HG00626,0,,0
X,108131503,108131503,dup,HG03945,0,,0
X,19042771,19042771,dup,HG02309,0,,0
X,433455,433455,dup,HG00628,0,,0
X,105633238,105633238,dup,HG03684,0,,0
X,36644458,36644458,dup,HG00178,0,,0
X,38485618,38485618,dup,HG00238,0,,0
X,66636586,66636586,dup,HG02138,0,,0
X,13829184,13829184,dup,HG02895,0,,0
X,96763369,96763369,dup,NA18577,0,,0
X,70434539,70434539,dup,HG02136,0,,0
X,105330783,105330783,dup,HG01253,0,,0
X,56079467,56079467,dup,HG02151,0,,0
X,101832232,101832232,dup,NA19454,0,,0
X,19435029,19435029,dup,HG00479,0,,0
X,64104128,64104128,dup,HG02339,0,,0
X,35441649,35441649,dup,HG00732,0,,0
X,61935752,61935752,dup,NA20771,0,,0
X,103171518,103171518,dup,HG01464,0,,0
X,6289424,6289424,dup,HG03643,0,,0
X,78997248,78997248,dup,NA19900,0,,0
X,32767842,32767842,dup,HG00103,0,,0
X,57909647,57909647,dup,NA19663,0,,0
X,148771685,148771685,dup,HG00851,0,,0
X,57745725,57745725,dup,HG02970,0,,0
X,6304187,6304187,dup,NA18634,0,,0
X,73004974,73004974,dup,HG03789,0,,0
X,32761413,32761413,dup,HG01841,0,,0
X,44564146,44564146,dup,HG01354,0,,0
X,843037,843037,dup,HG00689,0,,0
X,15189176,15189176,dup,HG03858,0,,0
X,200157,200157,dup,HG00524,0,,0
X,18888689,18888689,dup,HG02309,0,,0
X,793147,793147,dup,HG01070,0,,0
X,142369685,142369685,dup,NA19355,0,,0
X,138500881,138500881,dup,HG01369,0,,0
X,134296467,134296467,dup,HG00309,0,,0
X,140039288,140039288,dup,HG00269,0,,0
X,90285432,90285432,dup,HG00271,0,,0
X,8644055,8644055,dup,HG00449,0,,0
X,1859132,1859132,dup,HG00313,0,,0
X,75493658,75493658,dup,HG03007,0,,0
X,79926527,79926527,dup,HG02896,0,,0
X,26182841,26182841,dup,NA19378,0,,0
X,152048325,152048325,dup,HG02164,0,,0
X,69011306,69011306,dup,NA18596,0,,0
X,440219,440219,dup,HG01578,0,,0
X,51259150,51259150,dup,HG03774,0,,0
X,37291685,37291685,dup,HG03866,0,,0
X,49368756,49368756,dup,HG00179,0,,0
X,80218748,80218748,dup,HG01880,0,,0
X,139023159,139023159,dup,HG01798,0,,0
X,1368106,1368106,dup,HG01971,0,,0
X,44429385,44429385,dup,HG01354,0,,0
X,154726219,154726219,dup,NA12234,0,,0
X,22035562,22035562,dup,HG02703,0,,0
X,65820729,65820729,dup,HG00233,0,,0
X,79263134,79263134,dup,NA19654,0,,0
X,65771494,65771494,dup,HG00233,0,,0
X,57273089,57273089,dup,NA20334,0,,0
X,72297660,72297660,dup,NA19725,0,,0
X,2947858,2947858,dup,HG03884,0,,0
X,44522080,44522080,dup,HG00513,0,,0
X,148640196,148640196,dup,HG00145,0,,0
X,1236397,1236397,dup,HG00157,0,,0
X,129511568,129511568,dup,HG03313,0,,0
X,1322793,1322793,dup,HG00179,0,,0
X,41339020,41339020,dup,HG02069,0,,0
X,33331251,33331251,dup,HG01869,0,,0
X,2172220,2172220,dup,HG00537,0,,0
X,1367606,1367606,dup,HG01971,0,,0
X,35879047,35879047,dup,HG01796,0,,0
X,1456196,1456196,dup,HG00626,0,,0
X,5449318,5449318,dup,HG02694,0,,0
X,81997188,81997188,dup,HG01064,0,,0
X,999263,999263,dup,HG00157,0,,0
X,6450536,6450536,dup,HG00449,0,,0
X,63722121,63722121,dup,HG01051,0,,0
X,140667978,140667978,dup,HG02003,0,,0
X,134891974,134891974,dup,HG01862,0,,0
X,134329722,134329722,dup,HG00584,0,,0
X,42040893,42040893,dup,HG02793,0,,0
X,148287176,148287176,dup,HG00851,0,,0
X,87574694,87574694,dup,HG03736,0,,0
X,137350678,137350678,dup,HG02082,0,,0
X,134748495,134748495,dup,HG00146,0,,0
X,90245430,90245430,dup,HG00271,0,,0
X,34858179,34858179,dup,HG02610,0,,0
X,101055330,101055330,dup,HG00101,0,,0
X,39642028,39642028,dup,HG01345,0,,0
X,67827481,67827481,dup,HG01871,0,,0
X,116072766,116072766,dup,HG02278,0,,0
X,154265886,154265886,dup,HG03770,0,,0
X,131905529,131905529,dup,HG01077,0,,0
X,13949683,13949683,dup,HG03817,0,,0
X,146119815,146119815,dup,NA19440,0,,0
X,20138974,20138974,dup,NA19455,0,,0
X,107651526,107651526,dup,HG02009,0,,0
X,8414134,8414134,dup,HG03643,0,,0
X,148762813,148762813,dup,HG00851,0,,0
X,83489877,83489877,dup,HG02069,0,,0
X,122131124,122131124,dup,HG03832,0,,0
X,148685833,148685833,dup,HG03616,0,,0
X,145882153,145882153,dup,NA20869,0,,0
X,23899994,23899994,dup,HG02555,0,,0
X,102333184,102333184,dup,HG03760,0,,0
X,37031097,37031097,dup,HG00734,0,,0
X,6338280,6338280,dup,HG02481,0,,0
X,30299183,30299183,dup,HG02111,0,,0
X,104186065,104186065,dup,NA18998,0,,0
X,809007,809007,dup,HG01070,0,,0
X,150826291,150826291,dup,HG01702,0,,0
X,3731706,3731706,dup,NA19332,0,,0
X,114716645,114716645,dup,HG03099,0,,0
X,469491,469491,dup,HG02009,0,,0
X,105522241,105522241,dup,HG03085,0,,0
X,399093,399093,dup,HG04239,0,,0
X,15522467,15522467,dup,HG03858,0,,0
X,155064470,155064470,dup,HG00284,0,,0
X,154402183,154402183,dup,NA18916,0,,0
X,75801323,75801323,dup,HG00742,0,,0
X,105614764,105614764,dup,HG03684,0,,0
X,67766474,67766474,dup,HG00464,0,,0
X,3735212,3735212,dup,HG02780,0,,0
X,517818,517818,dup,HG01670,0,,0
X,47999721,47999721,dup,HG02188,0,,0
X,105347808,105347808,dup,HG02345,0,,0
X,153819664,153819664,dup,HG02398,0,,0
X,56736234,56736234,dup,NA18571,0,,0
X,2161730,2161730,dup,HG02271,0,,0
X,106923102,106923102,dup,NA20289,0,,0
X,125092337,125092337,dup,HG02941,0,,0
X,140789921,140789921,dup,HG02286,0,,0
X,52651001,52651001,dup,HG00445,0,,0
X,48116282,48116282,dup,HG03652,0,,0
X,62257804,62257804,dup,HG01491,0,,0
X,111818173,111818173,dup,HG01362,0,,0
X,133347752,133347752,dup,HG00099,0,,0
X,56425378,56425378,dup,HG00699,0,,0
X,7487044,7487044,dup,NA19041,0,,0
X,28201364,28201364,dup,HG03731,0,,0
X,1336742,1336742,dup,HG00258,0,,0
X,33135645,33135645,dup,HG01869,0,,0
X,30904726,30904726,dup,HG02374,0,,0
X,57734979,57734979,dup,HG01342,0,,0
X,139113319,139113319,dup,HG01798,0,,0
X,62206160,62206160,dup,HG01491,0,,0
X,2162032,2162032,dup,HG00537,0,,0
X,44497023,44497023,dup,HG01354,0,,0
X,56468360,56468360,dup,HG00472,0,,0
X,15355982,15355982,dup,HG03858,0,,0
X,2054564,2054564,dup,HG00313,0,,0
X,2461854,2461854,dup,HG03212,0,,0
X,154298802,154298802,dup,NA18916,0,,0
X,77055184,77055184,dup,HG01098,0,,0
X,500631,500631,dup,HG00651,0,,0
